school,real_size,size,state,setting,status,meanprob,lowprob,highprob,meaNActive,lowactive,highactive,meanincub,lowincub,highincub,meantot,lowtot,hightot,instate,outstate
Abilene Christian University,3669,3508,Texas,Midsize City,private,100.0,99.95,100.0,14,5,33,6,2,14,20,7,47,18.022462758346965,1.8110699704329363
Adams State University,1956,1514,Colorado,Town,NA,94.74,61.43,99.99,2,1,6,1,0,3,3,1,9,1.2134755916229738,1.7255044445041852
Adelphi University,5269,4874,New York,Suburb,private,100.0,99.91,100.0,9,5,19,5,2,10,14,7,29,11.54175008587593,2.3496556489018254
Adrian College,1673,1606,Michigan,Town,private,99.56,84.92,100.0,4,1,10,2,1,5,6,2,15,4.521453723257158,0.8937443969690633
Agnes Scott College,923,913,Georgia,Suburb,private,95.95,59.53,100.0,2,1,7,1,0,4,3,1,11,1.5243037628929237,1.6721317347373863
Alabama A & M University,5032,4714,Alabama,Midsize City,public,100.0,99.89,100.0,13,5,32,6,2,17,19,7,49,13.741141110439871,5.424010267796573
Alabama State University,4212,3866,Alabama,Midsize City,NA,100.0,99.86,100.0,12,4,31,6,2,17,18,6,48,11.303744634113391,7.006080785899706
Alaska Pacific University,298,203,Alaska,Large City,private,43.19,22.73,71.95,0,0,1,0,0,0,0,0,1,8.039285080069362e-05,0.5632391147977621
Albany State University,6266,3927,Georgia,Small City,NA,100.0,95.23,100.0,11,2,46,6,1,26,17,3,72,14.614231742792027,2.0843266103075764
Albertus Magnus College,1130,1012,Connecticut,Midsize City,NA,56.62,38.3,81.03,1,0,1,0,0,1,1,0,2,0.3488156305990095,0.4854427193945339
Albion College,1565,1554,Michigan,Town,NA,99.38,82.66,100.0,3,1,9,2,1,5,5,2,14,4.647999704921693,0.4194752494544861
Albright College,2019,1993,Pennsylvania,Small City,NA,99.74,93.89,100.0,4,2,9,2,1,5,6,3,14,2.2119224839737726,3.7185016562573794
Alcorn State University,3169,2893,Mississippi,Rural,NA,100.0,100.0,100.0,24,10,52,12,5,27,36,15,79,33.46785990136034,2.6109382979200664
Alderson Broaddus University,950,903,West Virginia,Town,private,62.25,29.33,89.33,1,0,1,0,0,1,1,0,2,0.11259823433557843,0.859295771612138
Alfred University,1704,1600,New York,Town,NA,98.77,88.98,99.99,3,1,6,1,1,3,4,2,9,3.290921661473742,1.1026907529299674
Alice Lloyd College,598,584,Kentucky,Rural,private,77.75,38.97,98.54,1,0,3,1,0,1,2,0,4,1.1936796674069239,0.3066292870381514
Allegheny College,1800,1752,Pennsylvania,Town,NA,98.93,88.07,100.0,3,1,7,2,1,4,5,2,11,1.6843245800095366,2.846830946199239
Allen University,590,563,South CaroliNA,Midsize City,private,99.99,98.04,100.0,7,3,15,3,1,7,10,4,22,9.47305224132897,0.2673603090186816
Alma College,1427,1386,Michigan,Town,NA,99.22,80.64,100.0,3,1,9,2,1,5,5,2,14,4.647999704921693,0.1970612580284977
Alvernia University,2252,1670,Pennsylvania,Small City,NA,99.72,94.19,100.0,4,2,9,2,1,5,6,3,14,2.8374251536220934,3.0414472528008285
Alverno College,1312,1036,Wisconsin,Large City,NA,45.82,28.0,72.23,0,0,1,0,0,0,0,0,1,0.496458895970822,0.11612990959977934
American InterContinental University - Atlanta,1905,932,Georgia,Midsize City,private,99.46,64.61,100.0,3,1,14,2,0,8,5,1,22,4.144736074383006,1.0559943705455743
American InterNAtioNAl College,1374,1254,Massachusetts,Midsize City,private,98.98,88.24,100.0,3,1,6,2,1,4,5,2,10,3.236889181033735,1.3417566975545738
American Jewish University,68,63,California,Large City,NA,29.96,14.18,57.86,0,0,1,0,0,0,0,0,1,0.2956079480764481,0.05940685053272438
American Public University System,37910,2914,West Virginia,Town,NA,100.0,100.0,100.0,124,46,330,63,23,168,187,69,498,0.10869309326035606,186.83872899554262
American University,8124,7764,District of Columbia,Large City,NA,100.0,100.0,100.0,20,9,49,11,4,26,31,13,75,0.4273450269317575,30.5905168086446
Amherst College,1832,1836,Massachusetts,Suburb,private,99.95,96.21,100.0,5,2,11,3,1,6,8,3,17,0.9302373329108653,6.574216657899843
Amridge University,321,147,Alabama,Midsize City,NA,87.12,54.44,99.36,1,1,3,1,0,2,2,1,5,0.683659987262305,1.355383602717809
Anderson University IndiaNA,1565,1431,IndiaNA,Small City,NA,98.78,87.73,99.99,3,1,6,2,1,3,5,2,9,3.1811786471960706,1.2172123656455316
Anderson University South CaroliNA,2984,2550,South CaroliNA,Small City,private,100.0,100.0,100.0,34,14,76,16,6,38,50,20,114,47.247826674727555,2.100884125335601
Andrews University,1704,1344,Michigan,Town,NA,99.9,93.9,100.0,5,2,11,2,1,6,7,3,17,1.5322324266408525,5.35972728645817
Angelo State University,8721,5332,Texas,Midsize City,NA,100.0,100.0,100.0,35,13,81,15,6,34,50,19,115,48.90182318201263,0.5123802458954755
AnNA Maria College,1121,866,Massachusetts,Rural,NA,98.26,84.88,99.99,3,1,6,1,1,3,4,2,9,3.7335769877463236,0.3084949548768427
Antioch University - Seattle,90,17,Washington,Large City,NA,28.43,13.29,55.88,0,0,1,0,0,0,0,0,1,0.017266464663794612,0.3163969679961289
Appalachian State University,17014,16071,North CaroliNA,Town,public,100.0,100.0,100.0,18,7,47,9,3,25,27,10,72,15.268542468552875,12.620615902736391
AquiNAs College Michigan,1553,1317,Michigan,Midsize City,NA,99.41,82.55,100.0,3,1,9,2,1,5,5,2,14,4.87373037491789,0.2545011097058903
Arcadia University,2387,2177,Pennsylvania,Suburb,NA,99.83,94.94,100.0,4,2,10,2,1,5,6,3,15,2.5346456004879787,3.8567390400538053
ArizoNA Christian University,784,646,ArizoNA,Large City,NA,98.13,87.73,99.97,3,1,5,1,1,3,4,2,8,3.2936869452138025,0.6731408802994154
ArizoNA State University - Tempe,42429,38814,ArizoNA,Midsize City,NA,100.0,100.0,100.0,136,70,290,69,35,147,205,105,437,144.1418751439259,60.389437381118306
Arkansas Baptist College,597,496,Arkansas,Midsize City,NA,88.47,54.84,99.57,1,1,4,1,0,2,2,1,6,0.3999662433705141,1.7508307037027007
Arkansas State University - Main Campus,9608,6894,Arkansas,Small City,public,100.0,97.33,100.0,9,3,24,4,1,12,13,4,36,9.94003063959069,2.9879006616339794
Arkansas Tech University,10780,6729,Arkansas,Town,public,100.0,97.72,100.0,9,3,25,4,1,13,13,4,38,11.989712721559005,1.8480527031823375
Armstrong State University,6283,4513,Georgia,Midsize City,public,100.0,95.78,100.0,11,2,47,6,1,26,17,3,73,14.736567518305105,2.3224607602859204
Asbury University,1731,1325,Kentucky,Town,NA,99.41,85.13,100.0,3,1,9,2,1,5,5,2,14,2.1022293737733273,3.011207252558719
Ashford University,31543,31545,California,Large City,private,100.0,100.0,100.0,100,39,261,50,19,132,150,58,393,8.82685332956274,140.93201676671035
Ashland University,4812,3380,Ohio,Town,NA,99.99,97.95,100.0,6,3,15,3,1,8,9,4,23,8.694575289805307,1.150895472845188
Assumption College,2085,1937,Massachusetts,Midsize City,private,99.9,95.72,100.0,4,2,10,2,1,5,6,3,15,5.198385095678365,1.6519876911818292
Point University,1925,1119,Georgia,Town,NA,99.85,78.11,100.0,4,1,16,2,0,9,6,1,25,4.24749812581399,2.2140567322433027
Auburn University,23968,21762,Alabama,Small City,public,100.0,100.0,100.0,75,27,192,38,13,102,113,40,294,56.973081050300294,56.83216348577931
Auburn University at Montgomery,4312,3239,Alabama,Midsize City,NA,100.0,99.86,100.0,12,4,30,6,2,16,18,6,46,17.146702040777566,1.2968843359520497
Augsburg University,2428,2033,Minnesota,Large City,NA,82.71,50.35,98.95,1,0,3,1,0,2,2,0,5,0.6979479981954346,1.0521198998349477
AugustaNA College,2650,2637,Illinois,Small City,NA,96.31,78.59,99.98,2,1,6,1,1,3,3,2,9,2.6460130414612113,0.651296858023459
AugustaNA University,1746,1679,South Dakota,Midsize City,NA,95.38,72.14,99.93,2,1,5,1,0,3,3,1,8,2.0049304807178028,1.0643961445377073
Aurora University,3935,3461,Illinois,Suburb,private,99.6,93.04,100.0,4,2,9,2,1,5,6,3,14,3.9211176019584673,1.6048477629422437
Austin College,1218,1204,Texas,Small City,NA,99.87,91.79,100.0,5,2,11,2,1,5,7,3,16,6.237448357365258,0.3760237327103291
Austin Peay State University,9591,7065,Tennessee,Midsize City,NA,100.0,99.46,100.0,14,4,45,7,2,22,21,6,67,19.074140495776884,1.6509094195213616
Ave Maria University,1071,1035,Florida,Rural,NA,99.99,97.9,100.0,6,3,18,3,1,9,9,4,27,7.152990733709551,2.6502147344283458
Averett University,929,890,Virginia,Town,NA,99.85,88.17,100.0,4,1,9,2,1,5,6,2,14,4.197459496995725,2.2761937828437575
Averett University - Non - TraditioNAl Programs,344,87,Virginia,Town,NA,94.47,55.7,99.83,2,1,4,1,0,2,3,1,6,2.882087958017025,0.0
Avila University,1274,1077,Missouri,Large City,NA,89.48,53.43,99.87,2,1,4,1,0,2,3,1,6,0.9660113286367137,1.2816412086345044
Azusa Pacific University,5674,5075,California,Suburb,private,100.0,100.0,100.0,20,9,49,10,4,25,30,13,74,25.091202632728912,4.637021840012199
Bacone College,936,864,Oklahoma,Town,private,98.75,78.8,100.0,3,1,8,1,1,4,4,2,12,1.871113866747589,2.4981206257207274
Baker University,1774,1062,Kansas,Town,NA,95.42,67.58,99.96,2,1,5,1,0,3,3,1,8,0.6556895143350235,2.4175242907819676
Baldwin Wallace University,3191,2958,Ohio,Suburb,NA,99.89,93.67,100.0,4,2,10,2,1,6,6,3,16,5.209720831189445,1.5831669954898575
Ball State University,17000,15203,IndiaNA,Small City,NA,100.0,100.0,100.0,30,15,64,16,8,35,46,23,99,41.31411543625363,4.405318250343173
Bard College,1941,1862,New York,Town,NA,99.87,94.92,100.0,4,2,10,2,1,6,6,3,16,1.4065037650241425,5.249358468725822
BarNArd College,2549,2514,New York,Large City,NA,99.99,98.57,100.0,6,3,14,3,1,8,9,4,22,2.236043837705635,7.213664009678884
Barry University,3504,2991,Florida,Suburb,NA,100.0,100.0,100.0,24,10,56,13,5,31,37,15,87,32.811747950688414,4.24130958527068
Barton College,888,830,North CaroliNA,Town,private,79.76,43.18,98.19,1,0,3,1,0,1,2,0,4,0.7270734508834702,0.8665367069507677
Bates College,1788,1787,Maine,Small City,NA,99.47,89.72,100.0,3,2,8,2,1,4,5,3,12,0.14735624532297342,5.071897815008022
Bay Path University,1946,1367,Massachusetts,Suburb,NA,99.71,93.57,100.0,4,2,8,2,1,4,6,3,12,5.168920564771686,0.6506709138955972
Baylor University,14311,14100,Texas,Midsize City,private,100.0,100.0,100.0,52,20,124,23,9,54,75,29,178,65.17962488244939,9.846806018611987
Beacon College,349,344,Florida,Suburb,private,92.86,67.16,99.79,2,1,4,1,0,2,3,1,6,1.4691827440606753,1.1518114025195902
Becker College,1885,1530,Massachusetts,Midsize City,private,99.78,93.99,100.0,4,2,9,2,1,5,6,3,14,5.1899666582764565,0.9200257583806282
Belhaven University,2479,1248,Mississippi,Midsize City,private,100.0,99.97,100.0,13,5,30,7,3,16,20,8,46,9.790840700478997,9.627742822550948
Bellarmine University,2539,2410,Kentucky,Large City,NA,99.78,89.28,100.0,4,1,11,2,1,6,6,2,17,4.066726478230471,2.026123452269851
Bellevue University,5743,4919,Nebraska,Suburb,NA,99.84,90.98,100.0,4,2,11,2,1,6,6,3,17,0.5455681523712322,5.861690912909325
Belmont Abbey College,1552,1381,North CaroliNA,Suburb,private,99.39,86.39,100.0,3,1,8,2,1,4,5,2,12,0.8976215443005805,4.167668128554976
Belmont University,6496,6161,Tennessee,Large City,NA,100.0,99.96,100.0,15,5,39,7,3,20,22,8,59,4.103231457764655,17.891815169255786
Beloit College,1407,1346,Wisconsin,Small City,NA,93.1,68.66,99.85,2,1,4,1,0,2,3,1,6,0.11711953020889762,2.5501109917395204
Bemidji State University,4819,3333,Minnesota,Town,NA,96.45,67.11,100.0,2,1,7,1,0,3,3,1,10,1.4776346481871796,1.8468648096954168
Benedict College,2089,2077,South CaroliNA,Midsize City,NA,100.0,99.99,100.0,16,7,37,8,3,19,24,10,56,20.10087737984474,3.4868445730067017
Benedictine College,2080,1821,Kansas,Town,NA,98.48,78.94,100.0,3,1,8,1,1,4,4,2,12,0.34272078454335003,3.8313524305499898
Benedictine University,2883,2473,Illinois,Suburb,private,97.53,84.09,99.99,2,1,6,1,1,3,3,2,9,3.071428069247863,0.627822576986893
Bennett College,490,400,North CaroliNA,Large City,private,73.35,40.9,95.81,1,0,2,0,0,1,1,0,3,0.17553487977433574,1.1437922089039319
Bennington College,775,724,Vermont,Town,NA,93.09,69.96,99.8,2,1,4,1,0,2,3,1,6,3.645842632766558e-05,2.6651494149692008
Bentley University,4270,4171,Massachusetts,Small City,private,100.0,99.88,100.0,10,4,21,5,2,12,15,6,33,7.892285064289016,6.7257814374176625
Berea College,1668,1615,Kentucky,Town,NA,99.4,82.86,100.0,3,1,9,2,1,5,5,2,14,1.8920064363959948,3.2165616973483857
Berry College,1976,1945,Georgia,Suburb,private,99.92,86.15,100.0,5,1,16,2,1,9,7,2,25,3.5012498951842277,3.6567802297896215
Bethany College Kansas,777,710,Kansas,Town,NA,65.87,32.57,92.2,1,0,2,0,0,1,1,0,3,0.29923701221397675,0.7735613436794799
Bethany College West Virginia,598,594,West Virginia,Rural,private,78.34,47.27,96.93,1,0,2,1,0,1,2,0,3,0.022617275393996245,1.5017931245991702
Bethany Lutheran College,651,522,Minnesota,Small City,NA,39.14,18.49,72.06,0,0,1,0,0,0,0,0,1,0.16147554069148679,0.33441393473420633
Bethel College - Mishawaka,1330,1044,IndiaNA,Small City,NA,97.69,82.21,99.99,2,1,6,1,1,3,3,2,9,2.672959260554211,1.0881251501640112
Bethel College - North Newton,502,489,Kansas,Town,NA,45.62,19.5,78.3,0,0,1,0,0,1,0,0,2,0.20712007346359385,0.4010714132339328
Bethel University Minnesota,2898,2407,Minnesota,Suburb,NA,92.08,58.34,99.99,2,1,6,1,0,3,3,1,9,0.7296425774633917,1.7978462776876543
Bethel University Tennessee,4830,3454,Tennessee,Town,NA,100.0,98.84,100.0,10,3,35,5,1,16,15,4,51,8.759306088373625,6.438886446730431
Bethune - Cookman University,3988,3755,Florida,Small City,private,100.0,100.0,100.0,31,13,73,16,7,40,47,20,113,40.0389398330879,7.329690793287503
Biola University,4047,3882,California,Suburb,private,100.0,99.99,100.0,14,6,36,7,3,18,21,9,54,18.15032801189391,3.453187567103103
Birmingham Southern College,1287,1272,Alabama,Midsize City,NA,99.71,87.45,100.0,4,1,10,2,1,5,6,2,15,3.0658541043688463,2.7640593562920017
Black Hills State University,3951,2195,South Dakota,Town,NA,100.0,98.9,100.0,8,3,26,4,1,11,12,4,37,8.49263631592188,2.973112601634337
Blackburn College,557,546,Illinois,Town,private,50.89,28.86,83.24,0,0,1,0,0,1,0,0,2,0.581666659976387,0.1288221247162018
Bloomfield College,1839,1700,New Jersey,Suburb,NA,100.0,98.88,100.0,7,3,16,3,1,9,10,4,25,10.14413370873133,0.017333673160508798
Bloomsburg University of Pennsylvania,8578,7863,Pennsylvania,Small City,public,100.0,99.99,100.0,13,6,28,7,3,15,20,9,43,13.431083410883366,5.910309498730553
Blue Mountain College,590,531,Mississippi,Rural,NA,99.73,91.81,100.0,4,2,9,2,1,4,6,3,13,5.288681264801674,0.5837859927628943
Bluefield College,949,829,Virginia,Town,NA,99.85,85.26,100.0,4,1,9,2,1,5,6,2,14,5.6971506146848165,0.7662768303416143
Bluefield State College,1380,1099,West Virginia,Town,NA,68.15,27.31,92.24,1,0,2,0,0,1,1,0,3,0.20632162014091537,0.9337605272498811
Bluffton University,735,660,Ohio,Town,NA,79.72,46.8,97.9,1,0,2,1,0,1,2,0,3,1.1609677507706817,0.4324635185476464
Boise State University,20744,12477,Idaho,Midsize City,public,100.0,100.0,100.0,87,18,314,50,9,181,137,27,495,106.51355493160773,30.205969048865494
Boston College,9924,9681,Massachusetts,Small City,private,100.0,100.0,100.0,24,11,55,13,6,29,37,17,84,10.880830341966456,25.736154240661502
Boston University,18086,16840,Massachusetts,Large City,private,100.0,100.0,100.0,45,20,105,23,10,56,68,30,161,16.9715698022471,51.70060851825696
Bowdoin College,1819,1813,Maine,Town,private,99.78,92.38,100.0,4,2,10,2,1,5,6,3,15,0.16082428925034198,5.938301888628074
Bowie State University,5185,4389,Maryland,Suburb,NA,100.0,99.73,100.0,9,4,21,5,2,11,14,6,32,11.545047719106869,1.9596221997409704
Bowling Green State University - Main Campus,14679,13104,Ohio,Town,public,100.0,100.0,100.0,21,8,50,11,4,26,32,12,76,24.813490565631525,6.429787903287197
Bradley University,4645,4512,Illinois,Midsize City,NA,99.78,94.65,100.0,4,2,10,2,1,5,6,3,15,4.522173150600734,1.5984096688274223
Brandeis University,3630,3620,Massachusetts,Small City,NA,100.0,99.78,100.0,9,4,21,5,2,11,14,6,32,3.6199280828205618,9.903423234611571
BreNAu University,1737,1080,Georgia,Small City,NA,99.41,65.89,100.0,3,1,13,2,0,7,5,1,20,3.9367652560107773,1.1841559128057224
Brescia University,1177,715,Kentucky,Small City,NA,94.48,63.87,99.97,2,1,5,1,0,3,3,1,8,2.2617088435078556,0.6318404674638103
Brevard College,673,656,North CaroliNA,Town,NA,96.82,73.35,99.98,2,1,6,1,0,3,3,1,9,0.3600459749916773,3.0634352094321056
Brewton - Parker College,782,438,Georgia,Rural,NA,96.83,64.25,100.0,2,1,7,1,0,4,3,1,11,1.5365373404442313,1.89796208665132
Briar Cliff University,943,720,Iowa,Small City,NA,91.02,52.59,99.95,2,1,5,1,0,3,3,1,8,1.0919843411157324,1.3131235820116187
Bridgewater College,1880,1876,Virginia,Suburb,private,100.0,98.04,100.0,8,3,18,5,1,11,13,4,29,12.55886584031256,0.8564285178654008
Bridgewater State University,9562,7858,Massachusetts,Suburb,NA,100.0,100.0,100.0,26,12,55,14,6,31,40,18,86,38.901599234218175,0.6602096502311204
Brigham Young University - Hawaii,3138,2702,Hawaii,Town,private,100.0,99.37,100.0,10,3,30,5,2,16,15,5,46,3.432883624760225e-05,14.982331273406253
Brigham Young University - Idaho,51883,17230,Idaho,Town,NA,100.0,100.0,100.0,185,56,640,97,28,321,282,84,961,75.07815422343643,206.6189865733948
Brigham Young University - Provo,31232,28156,Utah,Midsize City,NA,100.0,100.0,100.0,115,34,374,60,17,198,175,51,572,73.69533793111619,100.72405217918286
Brown University,6986,6666,Rhode Island,Midsize City,NA,100.0,100.0,100.0,18,8,43,9,4,23,27,12,66,0.14715240698344145,27.541646128604164
Bryan College - Dayton,1238,833,Tennessee,Town,NA,98.06,70.96,100.0,3,1,7,1,0,4,4,1,11,1.5702427761015354,2.3585754569287833
Bryant University,3476,3418,Rhode Island,Suburb,private,99.99,98.85,100.0,6,3,13,3,2,7,9,5,20,0.12737126374960178,9.346882118979728
Bryn Athyn College of the New Church,329,313,Pennsylvania,Suburb,private,54.96,31.08,84.13,1,0,1,0,0,1,1,0,2,0.4133756773328034,0.38293505199555655
Bryn Mawr College,1340,1325,Pennsylvania,Suburb,NA,99.58,90.74,100.0,4,2,8,2,1,4,6,3,12,0.34085362867792557,5.1260125148111895
Bucknell University,3608,3585,Pennsylvania,Town,private,100.0,99.42,100.0,8,3,18,4,2,9,12,5,27,1.573728455810848,9.804273398557847
BueNA Vista University,1805,1522,Iowa,Town,private,98.74,61.26,100.0,3,1,11,1,0,6,4,1,17,3.6819472014543284,0.6880563081605071
Butler University,4288,4182,IndiaNA,Large City,NA,100.0,99.29,100.0,7,3,16,4,2,8,11,5,24,6.241483494325969,4.312619925699223
Cabrini University,1687,1479,Pennsylvania,Suburb,private,99.31,90.29,100.0,3,2,8,2,1,4,5,3,12,1.64081135081661,3.321063523042232
Caldwell University,1605,1440,New Jersey,Suburb,NA,99.98,97.53,100.0,6,2,13,3,1,7,9,3,20,7.818513535332226,0.48896248140635457
California Baptist University,7421,6367,California,Large City,NA,100.0,100.0,100.0,29,13,70,14,6,37,43,19,107,40.51602536335797,2.4601633644913576
California Institute of Technology,962,961,California,Midsize City,NA,99.0,85.89,100.0,3,1,7,2,1,4,5,2,11,1.9037151856123256,2.6879445512588664
California Lutheran University,2968,2858,California,Midsize City,private,100.0,99.94,100.0,11,5,27,6,2,14,17,7,41,14.549823204322774,2.120754782145458
California State University Maritime Academy,1050,1007,California,Midsize City,NA,99.63,92.17,100.0,4,2,9,2,1,5,6,3,14,5.190875568222428,0.40531799933265134
California Polytechnic State University - San Luis Obispo,21348,20584,California,Suburb,NA,100.0,100.0,100.0,81,36,200,41,18,104,122,54,304,112.88676321143399,9.189523412196117
California State Polytechnic University - PomoNA,24318,21668,California,Suburb,NA,100.0,100.0,100.0,95,43,229,48,21,121,143,64,350,142.7727267619629,0.790727153932183
California State University - Bakersfield,8816,7502,California,Large City,NA,100.0,100.0,100.0,35,16,83,18,8,44,53,24,127,51.548113985571014,0.48639370153063466
California State University - Channel Islands,7054,5858,California,Suburb,NA,100.0,100.0,100.0,28,12,67,14,6,35,42,18,102,41.704369314625296,0.0
California State University - Chico,16709,15446,California,Small City,NA,100.0,100.0,100.0,65,29,157,33,15,83,98,44,240,96.91210969738273,1.328498130078279
California State University - Dominguez Hills,13279,10084,California,Small City,NA,100.0,100.0,100.0,52,23,125,26,12,66,78,35,191,78.1232685176437,0.3785444222625269
California State University - East Bay,13473,11539,California,Midsize City,NA,100.0,100.0,100.0,52,24,126,27,12,67,79,36,193,78.37749135298944,0.5997518897224334
California State University - Fresno,22260,19432,California,Large City,NA,100.0,100.0,100.0,87,39,210,44,19,111,131,58,321,130.58185498329016,0.7244573840456533
California State University - Fullerton,35161,28475,California,Suburb,public,100.0,100.0,100.0,138,62,332,70,31,175,208,93,507,207.02607035585964,0.7607250861324973
California State University - Long Beach,31564,27507,California,Large City,public,100.0,100.0,100.0,123,56,296,62,28,156,185,84,452,184.53030550724193,1.103949503403858
California State University - Los Angeles,24820,21004,California,Large City,public,100.0,100.0,100.0,97,44,234,49,22,124,146,66,358,145.91208317053477,0.8018268471016599
California State University - Monterey Bay,6762,6109,California,Suburb,NA,100.0,100.0,100.0,26,12,65,13,6,34,39,18,99,39.2153503918216,0.5956498377402799
California State University - Northridge,35836,29739,California,Large City,NA,100.0,100.0,100.0,140,63,337,71,31,178,211,94,515,210.50241982523866,0.6898568750640709
California State University - Sacramento,28449,23491,California,Large City,public,100.0,100.0,100.0,111,50,270,57,25,142,168,75,412,166.79974078161658,1.2326171081675115
California State University - San BerNArdino,18324,16381,California,Midsize City,public,100.0,100.0,100.0,72,32,173,36,16,91,108,48,264,107.86142809413437,0.24766692804810297
California State University - San Marcos,14616,11634,California,Suburb,NA,100.0,100.0,100.0,57,26,138,29,13,73,86,39,211,86.05738584401556,0.34218255221190885
California State University - Stanislaus,9058,7621,California,Suburb,NA,100.0,100.0,100.0,36,16,86,18,8,45,54,24,131,53.33949815091429,0.2725912129463074
California University of Pennsylvania,5553,4534,Pennsylvania,Suburb,public,100.0,99.59,100.0,7,4,16,4,2,8,11,6,24,9.395231403239418,1.4773481079608801
Calumet College of Saint Joseph,624,427,IndiaNA,Suburb,private,76.84,52.41,95.82,1,0,2,1,0,1,2,0,3,1.2856576916129197,0.17523792031648988
Calvin College,3737,3524,Michigan,Midsize City,NA,100.0,99.01,100.0,8,3,22,4,2,12,12,5,34,7.278104026544049,5.009772811990757
Cambridge College,750,221,Massachusetts,Large City,private,95.71,76.96,99.89,2,1,4,1,1,2,3,2,6,3.14007715091179,0.0014671530203954133
Cameron University,4149,2814,Oklahoma,Small City,NA,100.0,98.74,100.0,10,3,28,5,1,16,15,4,44,13.221393579532046,1.427769542203589
Campbell University,4382,3634,North CaroliNA,Town,NA,99.98,95.95,100.0,6,2,14,3,1,7,9,3,21,3.6882271898039405,4.860270748722151
Campbellsville University,3704,2128,Kentucky,Town,private,99.99,96.81,100.0,6,2,18,3,1,10,9,3,28,7.655014547257358,2.1739288849588725
Canisius College,2397,2303,New York,Large City,private,99.78,95.67,100.0,4,2,8,2,1,4,6,3,12,5.583918996706763,0.5242228443438439
Capella University,9208,1382,Minnesota,Large City,NA,100.0,100.0,100.0,25,9,66,13,5,35,38,14,101,0.10075539935708472,37.870504272462405
Capital University,2703,2493,Ohio,Suburb,NA,99.65,89.09,100.0,4,1,9,2,1,5,6,2,14,4.743382524577356,0.9060759648273279
CardiNAl Stritch University,1542,901,Wisconsin,Suburb,NA,56.52,34.07,84.69,1,0,1,0,0,1,1,0,2,0.5340330797238472,0.2981229868352576
Carleton College,2068,2055,Minnesota,Town,NA,99.64,90.79,100.0,4,2,11,2,1,5,6,3,16,0.15013221758506,5.472037113074785
Carlos Albizu University - Miami,376,291,Florida,Suburb,NA,99.64,90.48,100.0,4,2,8,2,1,5,6,3,13,5.579926381482969,0.0
Carlow University,1365,1075,Pennsylvania,Large City,NA,92.36,73.15,99.61,2,1,4,1,0,2,3,1,6,2.2826314814122783,0.2858815630802302
Carnegie Mellon University,6530,6298,Pennsylvania,Large City,NA,100.0,100.0,100.0,16,7,38,9,4,20,25,11,58,2.3315838642543207,22.673253229515783
Carroll College,1360,1287,MontaNA,Town,NA,100.0,75.07,100.0,12,1,121,4,0,34,16,1,155,12.913902279269745,3.636691840557006
Carroll University,2983,2737,Wisconsin,Small City,NA,84.62,62.24,98.49,1,1,3,1,0,1,2,1,4,0.8730001842192232,0.9977656964373461
Carson - Newman University,1688,1608,Tennessee,Suburb,NA,99.73,84.11,100.0,4,1,11,2,1,6,6,2,17,2.5140700939992455,3.3815566927563596
Carthage College,2740,2596,Wisconsin,Suburb,NA,94.22,74.34,99.92,2,1,5,1,0,2,3,1,7,0.34496298488149707,2.5038196519303084
Case Western Reserve University,5147,4978,Ohio,Large City,private,100.0,99.74,100.0,9,4,23,5,2,12,14,6,35,4.062411524545477,10.231203720978415
Castleton University,1857,1590,Vermont,Town,NA,84.06,57.61,98.3,1,1,3,1,0,1,2,1,4,0.002440435912308115,1.8299054167381423
Catawba College,1322,1268,North CaroliNA,Suburb,NA,94.15,66.19,99.91,2,1,5,1,0,2,3,1,7,1.1220269303757255,1.7038132073423573
Catholic University of America,3308,3194,District of Columbia,Large City,NA,100.0,99.49,100.0,8,3,19,4,2,10,12,5,29,0.06876816525338628,12.375406289187135
Cazenovia College,897,713,New York,Town,NA,92.07,70.39,99.81,2,1,4,1,0,2,3,1,6,1.703652447775722,0.826192404470603
Cedar Crest College,1432,931,Pennsylvania,Midsize City,NA,95.9,79.28,99.92,2,1,5,1,1,2,3,2,7,1.798546806640969,1.390844610267705
Cedarville University,3536,3109,Ohio,Town,private,99.99,97.57,100.0,6,2,15,3,1,8,9,3,23,2.3882765158711163,6.997851606045138
CenteNAry University,1366,1125,New Jersey,Suburb,private,99.91,95.46,100.0,5,2,11,2,1,6,7,3,17,6.2791744681775805,0.6828709722542113
CenteNAry College of LouisiaNA,536,524,LouisiaNA,Midsize City,NA,95.03,67.11,99.96,2,1,5,1,0,3,3,1,8,2.0452014926957705,0.9474867615320971
Central Baptist College,745,599,Arkansas,Small City,private,76.4,37.52,97.59,1,0,2,0,0,1,1,0,3,0.7350104298461042,0.7050698119042904
Central Christian College of Kansas,869,730,Kansas,Town,NA,90.18,58.68,99.66,2,1,4,1,0,2,3,1,6,0.17507939911563455,2.1382383576705584
Central College,1232,1198,Iowa,Town,NA,97.05,54.98,100.0,2,1,8,1,0,5,3,1,13,2.791559969467654,0.7261035715056477
Central Connecticut State University,9550,7605,Connecticut,Suburb,NA,99.33,95.63,99.99,3,2,6,2,1,3,5,3,9,3.3403406391852575,1.6637564899331352
Central Methodist University - College of Liberal Arts & Sciences,1058,1034,Missouri,Town,NA,77.19,37.47,98.93,1,0,3,0,0,2,1,0,5,1.1158698879717648,0.3603051695417454
Central Michigan University,17801,15585,Michigan,Town,NA,100.0,100.0,100.0,39,14,110,21,7,62,60,21,172,58.33769754735049,1.6336842871709414
Central Penn College,1197,316,Pennsylvania,Suburb,NA,91.83,71.7,99.59,2,1,4,1,0,2,3,1,6,1.769537987179018,0.7323973164868268
Central State University,1788,1710,Ohio,Rural,public,98.42,80.19,100.0,3,1,7,1,1,4,4,2,11,1.7853537679918885,2.358696628491302
Central Washington University,12080,10446,Washington,Town,NA,100.0,100.0,100.0,44,24,93,25,13,54,69,37,147,66.99963838374435,1.7552311372920895
Centre College,1447,1449,Kentucky,Town,NA,98.51,76.41,100.0,3,1,8,1,0,4,4,1,12,1.9113372812123013,2.2840786556494868
Chadron State College,2151,1616,Nebraska,Town,NA,83.09,52.2,99.46,1,0,3,1,0,2,2,0,5,0.16384965627291817,1.608494456905377
ChamiNAde University of Honolulu,1813,1524,Hawaii,Large City,NA,97.35,79.8,99.98,2,1,6,1,1,3,3,2,9,9.041412975342516e-05,3.618032998398237
Champlain College,3933,2603,Vermont,Small City,NA,99.99,98.34,100.0,6,3,14,3,1,8,9,4,22,0.001522139299180038,9.204441752597411
Chapman University,7023,6515,California,Midsize City,NA,100.0,100.0,100.0,24,11,58,12,5,31,36,16,89,27.94086325218587,8.511044796419121
Charleston Southern University,3062,2804,South CaroliNA,Midsize City,private,100.0,100.0,100.0,34,14,77,16,6,38,50,20,115,46.230060731444276,3.5046833620907947
Chatham University,1207,951,Pennsylvania,Large City,NA,94.38,73.84,99.83,2,1,4,1,0,2,3,1,6,1.4431887682320679,1.430214744843987
Chestnut Hill College,1363,1118,Pennsylvania,Large City,NA,98.44,85.61,99.99,3,1,6,1,1,3,4,2,9,1.372479770793562,2.7794010574816546
Cheyney University of Pennsylvania,718,671,Pennsylvania,Suburb,public,80.83,55.58,97.49,1,1,2,1,0,1,2,1,3,0.9319083252151795,0.7172034028372632
Chicago State University,2032,1297,Illinois,Large City,NA,92.52,71.88,99.84,2,1,4,1,0,2,3,1,6,2.2285816737134514,0.36060899685262016
Chowan University,1500,1440,North CaroliNA,Town,private,99.92,89.83,100.0,5,1,10,3,1,6,8,2,16,0.6602505136966492,6.477010865192911
Christian Brothers University,1789,1426,Tennessee,Large City,NA,99.63,83.01,100.0,4,1,11,2,1,5,6,2,16,3.157302074570959,2.4185512186518108
Christopher Newport University,4951,4867,Virginia,Midsize City,NA,100.0,100.0,100.0,25,7,55,15,4,33,40,11,88,39.4443898440237,0.5635339441065559
Citadel Military College of South CaroliNA,2837,2559,South CaroliNA,Midsize City,NA,100.0,100.0,100.0,24,10,56,12,4,28,36,14,84,29.417350245283973,6.4777593111321305
City University of Seattle,929,235,Washington,Large City,NA,99.68,95.31,100.0,4,2,7,2,1,4,6,3,11,4.897920476296405,0.8353270908372585
Claflin University,2040,1955,South CaroliNA,Town,private,100.0,100.0,100.0,21,9,48,10,4,24,31,13,72,28.712743053780166,2.053574431984424
Claremont McKenNA College,1341,1337,California,Suburb,NA,99.86,94.19,100.0,4,2,12,2,1,6,6,3,18,3.695099350955601,2.8779245477288553
Clarion University of Pennsylvania,4319,3483,Pennsylvania,Town,public,99.98,98.57,100.0,6,3,12,3,1,6,9,4,18,7.360987938470095,1.0388753002262163
Clark Atlanta University,3305,3187,Georgia,Large City,NA,100.0,99.45,100.0,9,4,25,5,2,13,14,6,38,2.104175338824903,11.80212139651176
Clark University,2240,2199,Massachusetts,Midsize City,private,99.87,95.15,100.0,4,2,10,2,1,5,6,3,15,3.603091208016745,3.0175033034930654
Clarke University,765,708,Iowa,Small City,NA,83.58,39.66,99.9,1,0,4,1,0,2,2,0,6,1.0191853850413501,0.7836792561073938
Clarkson University,3086,3021,New York,Town,private,99.93,97.3,100.0,5,2,10,2,1,5,7,3,15,5.393248591941166,1.8729959006450347
Clayton State University,6553,3743,Georgia,Suburb,NA,100.0,94.05,100.0,11,2,47,6,1,27,17,3,74,15.539090205670881,1.0814233826871236
Clemson University,19409,18642,South CaroliNA,Suburb,public,100.0,100.0,100.0,175,72,401,84,32,200,259,104,601,229.52579263236538,29.251351493979097
Cleveland State University,12077,9268,Ohio,Large City,NA,100.0,99.99,100.0,16,6,37,8,3,20,24,9,57,22.68667569447179,1.3794546138484929
Coastal CaroliNA University,9899,9021,South CaroliNA,Small City,NA,100.0,100.0,100.0,73,31,167,35,14,84,108,45,251,91.40321067563283,17.234586772786344
Coe College,1393,1369,Iowa,Midsize City,private,96.05,57.37,100.0,2,1,7,1,0,4,3,1,11,2.0523705693277736,1.1735088328944072
Cogswell College,606,436,California,Large City,NA,96.35,77.16,99.97,2,1,5,1,0,3,3,1,8,3.1570928854564655,0.14393264019246857
Coker College,1025,909,South CaroliNA,Town,private,100.0,99.92,100.0,12,5,27,6,2,14,18,7,41,16.088530872670276,1.60791438936322
Colby College,1923,1917,Maine,Town,NA,99.58,90.97,100.0,4,2,8,2,1,4,6,3,12,0.167162192274986,5.284930820132419
Colby - Sawyer College,983,920,New Hampshire,Rural,NA,84.66,54.85,98.63,1,1,3,1,0,2,2,1,5,0.14300036963737145,1.727963742241733
Colgate University,2882,2854,New York,Town,private,99.99,98.71,100.0,6,3,14,3,1,8,9,4,22,2.0008011305273015,7.606582175688596
College of Charleston,9901,9083,South CaroliNA,Midsize City,public,100.0,100.0,100.0,78,32,179,37,14,90,115,46,269,97.2749372714979,17.846439144482844
College of Mount Saint Vincent,1693,1613,New York,Large City,NA,98.79,89.39,99.99,3,1,6,1,1,3,4,2,9,3.7415971636469707,0.6620336647620153
Mount St. Joseph University,1315,1000,Ohio,Suburb,NA,95.09,70.03,99.93,2,1,5,1,0,3,3,1,8,2.068278682045248,0.9397216755976457
Notre Dame of Maryland University,817,528,Maryland,Large City,NA,89.65,62.21,99.52,1,1,3,1,0,2,2,1,5,1.7065496300950547,0.5574357366650158
College of Our Lady of the Elms,1174,973,Massachusetts,Suburb,private,98.14,84.55,99.98,3,1,6,1,1,3,4,2,9,3.7251585503444153,0.250072654894501
College of Saint Benedict,1940,1916,Minnesota,Suburb,NA,75.92,41.75,97.98,1,0,3,0,0,1,1,0,4,0.5368060846541368,0.8840112086688237
College of Saint Elizabeth,757,587,New Jersey,Suburb,NA,98.47,84.18,100.0,3,1,7,1,1,4,4,2,11,4.152893166784114,0.01764526943968299
College of Saint Mary,833,761,Nebraska,Large City,NA,54.59,19.98,93.1,1,0,2,0,0,1,1,0,3,0.08179682059249586,0.705565323489988
Northeast Catholic College,69,70,New Hampshire,Rural,NA,13.71,4.62,31.44,0,0,0,0,0,0,0,0,0,0.012434814751075777,0.13460769324601643
College of the Atlantic,352,330,Maine,Town,private,60.27,31.32,88.88,1,0,1,0,0,1,1,0,2,0.06496350600260119,0.8556004708856286
College of the Holy Cross,2852,2827,Massachusetts,Midsize City,private,99.99,98.61,100.0,6,3,14,3,1,7,9,4,21,4.56279307183429,4.838155232261365
College of the Ozarks,1510,1477,Missouri,Town,private,84.69,43.38,99.72,1,0,4,1,0,2,2,0,6,1.4328783788728343,0.442327793595469
College of William and Mary,6287,6199,Virginia,Suburb,NA,100.0,100.0,100.0,27,9,58,15,5,34,42,14,92,33.78913004268215,7.909539495236095
Colorado Christian University,6541,1840,Colorado,Midsize City,NA,100.0,99.62,100.0,11,4,34,5,2,16,16,6,50,2.4098927404244104,13.513475698026859
Colorado College,2106,2091,Colorado,Large City,private,99.68,90.43,100.0,4,2,10,2,1,5,6,3,15,0.3372919376076636,5.393039588363361
Colorado School of Mines,4790,4584,Colorado,Suburb,public,99.99,96.33,100.0,7,2,21,3,1,10,10,3,31,2.457191150065945,7.196909061827779
Colorado State University - Fort Collins,25523,22154,Colorado,Midsize City,public,100.0,100.0,100.0,23,7,79,11,4,38,34,11,117,16.16907764352324,18.244569580505452
Colorado State University - Pueblo,4627,3292,Colorado,Midsize City,NA,99.69,84.78,100.0,4,1,12,2,1,6,6,2,18,3.1472827005735784,2.609039219309614
Colorado Technical University - Colorado Springs,22305,14445,Colorado,Large City,NA,100.0,99.52,100.0,12,4,41,6,2,22,18,6,63,16.829704610975494,1.6771555555381823
Columbia College Chicago,7029,6436,Illinois,Large City,NA,100.0,99.81,100.0,9,4,23,5,2,12,14,6,35,4.329424786804637,9.994352031592054
Columbia College Missouri,12747,5163,Missouri,Midsize City,private,100.0,100.0,100.0,28,10,74,14,5,40,42,15,114,8.182277339693787,33.62873360588167
Columbia College South CaroliNA,1383,804,South CaroliNA,Midsize City,NA,100.0,99.99,100.0,16,7,37,8,3,18,24,10,55,23.17374763168079,0.838388014702251
Columbia InterNAtioNAl University,497,454,South CaroliNA,Midsize City,NA,99.87,93.01,100.0,4,2,10,2,1,5,6,3,15,5.656429954016679,0.9257819810052428
Columbia Southern University,15049,8567,Alabama,Town,private,100.0,100.0,100.0,56,21,153,28,10,76,84,31,229,3.847179804097195,80.61027875493913
Columbia University in the City of New York,8157,7592,New York,Large City,NA,100.0,100.0,100.0,23,10,54,12,5,29,35,15,83,4.957430523905517,29.97338731815666
Columbus State University,6798,4693,Georgia,Midsize City,NA,100.0,96.22,100.0,11,2,48,6,1,27,17,3,75,15.03751352606727,2.343392274561245
Concord University,1853,1696,West Virginia,Town,public,96.35,63.15,99.94,2,1,5,1,0,3,3,1,8,0.23137960870692562,3.0652601855788264
Concordia College at Moorhead,2032,1997,Minnesota,Suburb,NA,99.98,73.9,100.0,6,1,32,3,0,13,9,1,45,0.4707479089167104,7.831921477035718
Concordia College - New York,1131,1024,New York,Suburb,NA,95.36,78.51,99.85,2,1,4,1,1,2,3,2,6,2.2558537498890736,0.8090754813490206
Concordia University - Ann Arbor,906,780,Michigan,Midsize City,NA,95.56,66.46,99.98,2,1,6,1,0,3,3,1,9,2.5685414116233933,0.540675441246556
Concordia University - Chicago,1458,1299,Illinois,Suburb,private,95.26,72.97,99.98,2,1,6,1,0,3,3,1,9,1.1359607712480029,1.9023754325689288
Concordia University - Irvine,1851,1645,California,Large City,private,100.0,98.9,100.0,7,3,17,3,1,9,10,4,26,8.779556057870508,1.5418899194630058
Concordia University - Portland,1378,1124,Oregon,Large City,NA,99.12,89.1,100.0,3,1,9,2,1,4,5,2,13,1.3920509119128033,3.3232385664683313
Concordia University - Saint Paul,2867,1417,Minnesota,Large City,NA,90.36,58.15,99.82,2,1,4,1,0,2,3,1,6,0.6705905718799348,1.661932883669709
Concordia University - Nebraska,1682,1231,Nebraska,Town,NA,89.65,57.05,99.76,2,1,4,1,0,2,3,1,6,0.10227802762661065,2.159938612362253
Concordia University - Texas,1725,1347,Texas,Large City,NA,99.99,97.43,100.0,7,3,17,3,1,7,10,4,24,9.116709253589622,0.6502053688310302
Concordia University - Wisconsin,3713,2616,Wisconsin,Suburb,NA,99.28,88.26,100.0,3,1,8,2,1,4,5,2,12,1.0296925249765196,3.8862877934867948
Connecticut College,1815,1766,Connecticut,Small City,private,99.54,91.15,100.0,4,2,8,2,1,4,6,3,12,0.11480472384594109,5.24974166421224
Converse College,920,860,South CaroliNA,Small City,NA,100.0,99.66,100.0,10,4,22,5,2,11,15,6,33,12.976515776861794,1.1676730637629429
Cooper Union for the Advancement of Science and Art,864,859,New York,Large City,NA,97.55,81.03,99.98,2,1,6,1,1,3,3,2,9,1.0697352579056858,2.6262366670637602
Coppin State University,2509,1854,Maryland,Large City,NA,99.89,94.92,100.0,4,2,10,2,1,6,6,3,16,5.2154374958148715,1.6183442968216726
Corban University,1021,936,Oregon,Midsize City,private,98.41,82.58,100.0,3,1,9,1,1,4,4,2,13,0.8215685090201558,3.3082434095234827
Cornell College,1006,1002,Iowa,Town,private,92.76,62.28,99.96,2,1,5,1,0,3,3,1,8,0.3891944190130431,2.2291004516079322
Cornell University,14907,14898,New York,Small City,NA,100.0,100.0,100.0,37,17,84,19,8,45,56,25,129,13.26273620681216,42.81024132461335
Cornerstone University,1757,1260,Michigan,Midsize City,NA,99.56,84.97,100.0,4,1,10,2,1,6,6,2,16,4.6548400282549105,0.7671523435265715
CoveNAnt College,1033,983,Georgia,Rural,private,99.04,80.96,100.0,3,1,9,2,1,5,5,2,14,0.6239124551166862,3.998584854322616
Creighton University,4256,4011,Nebraska,Large City,NA,99.83,89.5,100.0,4,2,12,2,1,6,6,3,18,0.15079288678867,6.234337196260481
Crown College,1055,698,Minnesota,Rural,NA,87.3,35.88,100.0,1,0,10,1,0,3,2,0,13,0.22820097072929124,1.8224096795112155
Culver - Stockton College,1092,969,Missouri,Rural,NA,80.97,46.36,99.12,1,0,3,1,0,2,2,0,5,0.6490028377356442,1.0072031077224177
Cumberland University,1974,1578,Tennessee,Town,NA,98.87,68.47,100.0,3,1,10,1,0,5,4,1,15,3.5587965461042828,0.9178069431431706
CUNY BerNArd M Baruch College,15253,11598,New York,Large City,NA,100.0,100.0,100.0,25,13,51,13,7,27,38,20,78,37.41844787549264,0.786281106244459
CUNY Brooklyn College,14691,10786,New York,Large City,NA,100.0,100.0,100.0,25,13,50,13,6,26,38,19,76,35.382979398644316,1.6630910455161279
CUNY City College,13211,10225,New York,Large City,public,100.0,100.0,100.0,22,11,44,11,6,23,33,17,67,32.46596982963298,0.4194895861345449
College of Staten Island CUNY,12509,9710,New York,Large City,public,100.0,100.0,100.0,21,11,41,10,5,22,31,16,63,30.962892742714576,0.02768595444522743
CUNY Graduate School and University Center,2066,418,New York,Large City,NA,99.4,93.03,100.0,3,2,7,2,1,4,5,3,11,5.115909821373026,0.0
CUNY Hunter College,16846,12612,New York,Large City,NA,100.0,100.0,100.0,28,15,57,14,7,30,42,22,87,40.51374665415492,2.1115470272740042
CUNY John Jay College of CrimiNAl Justice,12916,10276,New York,Large City,public,100.0,100.0,100.0,21,11,43,11,6,23,32,17,66,31.93357843970307,0.11074381778090972
CUNY Lehman College,11978,7216,New York,Large City,NA,100.0,100.0,100.0,20,10,40,10,5,21,30,15,61,29.61334247521782,0.10520662689186423
CUNY Queens College,16680,12149,New York,Large City,NA,100.0,100.0,100.0,27,14,55,14,7,29,41,21,84,41.30366690246954,0.0
CUNY York College,8393,5056,New York,Large City,NA,100.0,100.0,100.0,14,7,28,7,4,15,21,11,43,20.78307411945005,0.0
Curry College,2561,2059,Massachusetts,Suburb,private,99.98,98.14,100.0,6,3,12,3,1,7,9,4,19,6.957838512677196,1.613389718357914
Daemen College,1799,1560,New York,Suburb,NA,99.07,90.56,100.0,3,2,7,2,1,3,5,3,10,4.226940012141217,0.43798758136664157
Dakota State University,2963,1397,South Dakota,Town,public,99.99,98.1,100.0,6,3,15,3,1,8,9,4,23,6.473546721639685,2.796698250633326
Dakota Wesleyan University,793,668,South Dakota,Town,NA,92.72,66.87,99.76,2,1,4,1,0,2,3,1,6,1.6651117551724124,0.9465892012368545
Dallas Baptist University,3159,2423,Texas,Large City,NA,100.0,99.87,100.0,12,5,29,5,2,12,17,7,41,16.44314539546746,0.9754389530924741
Dartmouth College,4415,4360,New Hampshire,Town,NA,100.0,99.92,100.0,11,5,28,6,2,14,17,7,42,0.05500014216821979,16.781637022399813
Davenport University,5597,2621,Michigan,Suburb,NA,100.0,99.83,100.0,12,4,35,7,2,20,19,6,55,18.66724237635217,0.24523332279465324
Davidson College,1812,1810,North CaroliNA,Suburb,private,99.94,94.63,100.0,5,2,12,2,1,6,7,3,18,0.3949534794922554,6.942389507234265
Davis & Elkins College,839,785,West Virginia,Town,NA,83.44,43.24,99.27,1,0,3,1,0,2,2,0,5,0.09258438632506377,1.6979562901020915
Defiance College,583,525,Ohio,Town,NA,82.48,49.33,98.63,1,0,3,1,0,2,2,0,5,0.8038969971723039,0.932714802900979
Delaware State University,4054,3571,Delaware,Small City,NA,99.99,98.76,100.0,6,3,14,3,1,8,9,4,22,0.6782927681364614,9.026922781568643
Delaware Valley University,1991,1756,Pennsylvania,Suburb,private,99.75,93.8,100.0,4,2,9,2,1,5,6,3,14,1.9454039551670965,4.020748311467388
Delta State University,3034,2198,Mississippi,Town,NA,100.0,100.0,100.0,23,10,51,12,5,26,35,15,77,31.854134079536237,3.022472025076557
Denison University,2344,2319,Ohio,Suburb,NA,99.79,91.78,100.0,4,2,10,2,1,5,6,3,15,1.2682840974805765,4.894687376131082
DePaul University,14822,12886,Illinois,Large City,NA,100.0,100.0,100.0,17,8,41,8,4,21,25,12,62,11.86942143210639,13.005295534589525
DePauw University,2156,2140,IndiaNA,Town,NA,99.59,91.81,100.0,4,2,8,2,1,5,6,3,13,2.4586829786187248,3.0268577878199605
DeSales University,2350,1811,Pennsylvania,Suburb,private,99.84,95.38,100.0,4,2,10,2,1,5,6,3,15,2.7340812342888925,3.709007347957275
Dickinson College,2386,2346,Pennsylvania,Small City,private,99.96,96.52,100.0,5,2,12,3,1,6,8,3,18,0.8956473008877407,6.819989163215955
Dickinson State University,1426,922,North Dakota,Town,public,100.0,93.8,100.0,13,2,69,6,1,29,19,3,98,13.79751092864895,5.242570080936988
DigiPen Institute of Technology,1024,964,Washington,Small City,NA,98.77,88.27,100.0,3,1,6,2,1,4,5,2,10,2.7741453226496677,1.6087216938743854
Dillard University,1292,1200,LouisiaNA,Large City,NA,99.92,93.31,100.0,5,2,12,2,1,6,7,3,18,4.896796716797302,2.2479791899381687
Doane University,1066,1062,Nebraska,Town,NA,42.02,20.87,74.38,0,0,1,0,0,0,0,0,1,0.11495077447896915,0.42914199191926433
Dominican College of Blauvelt,1420,1271,New York,Suburb,private,98.86,88.43,99.99,3,1,6,2,1,3,5,2,9,2.684243100855934,1.7765380442166183
Dominican University,2171,2014,Illinois,Suburb,NA,93.03,73.43,99.86,2,1,4,1,0,2,3,1,6,2.273062065358704,0.3880452757818925
Dominican University of California,1304,1135,California,Small City,private,99.94,96.32,100.0,5,2,13,3,1,6,8,3,19,6.858104395373595,0.6191839500630754
Dordt College,1445,1341,Iowa,Town,NA,99.46,78.64,100.0,4,1,16,2,1,6,6,2,22,1.495178559373849,3.7134055327875384
Drake University,3100,2955,Iowa,Midsize City,NA,99.48,78.84,100.0,3,1,11,2,1,6,5,2,17,2.6403621376208606,2.6037635121160716
Drew University,1534,1507,New Jersey,Suburb,private,99.92,95.68,100.0,5,2,11,2,1,6,7,3,17,5.3544635897069845,1.731049700988648
Drexel University,15528,13572,Pennsylvania,Large City,private,100.0,100.0,100.0,34,16,78,18,8,41,52,24,119,12.468353214989863,39.01613363142458
Drury University,3277,2478,Missouri,Midsize City,NA,98.56,72.94,100.0,3,1,9,1,0,4,4,1,13,3.4144696365417015,0.8238386676846107
Duke University,6699,6669,North CaroliNA,Large City,NA,100.0,100.0,100.0,22,9,51,11,4,27,33,13,78,0.8966241870291354,31.830669027243644
Duquesne University,5941,5826,Pennsylvania,Large City,NA,100.0,99.79,100.0,8,4,18,4,2,10,12,6,28,7.86864227905424,4.880566691320477
D'Youville College,1734,1295,New York,Large City,private,98.6,89.01,99.98,3,1,6,1,1,3,4,2,9,4.088270626857147,0.17564048845479385
Earlham College,1061,1051,IndiaNA,Town,private,95.85,74.13,99.98,2,1,5,1,0,3,3,1,8,0.7032657458395458,2.4702832076401884
East CaroliNA University,23267,19999,North CaroliNA,Small City,public,100.0,100.0,100.0,24,9,59,13,4,32,37,13,91,20.042891726960516,16.59530289862582
East Central University,3082,2551,Oklahoma,Town,NA,100.0,96.1,100.0,7,2,21,4,1,12,11,3,33,9.976985131685309,0.9329042792801883
East Stroudsburg University of Pennsylvania,6051,5552,Pennsylvania,Small City,public,100.0,99.97,100.0,11,5,25,6,3,13,17,8,38,7.538666957674546,8.95573483401232
East Tennessee State University,11319,9641,Tennessee,Small City,NA,100.0,99.93,100.0,19,5,56,9,2,29,28,7,85,20.79993610378138,7.068695124123806
East Texas Baptist University,1421,1216,Texas,Town,NA,99.97,95.29,100.0,6,2,13,2,1,6,8,3,19,7.468973810007759,0.5574299765256256
Eastern Connecticut State University,5069,4210,Connecticut,Town,public,94.57,83.49,99.58,2,1,4,1,1,2,3,2,6,1.7239047989646106,1.1866228056768713
Eastern Illinois University,5569,4319,Illinois,Town,NA,99.89,96.71,100.0,5,2,11,2,1,6,7,3,17,6.213568555983051,0.5694375279943555
Eastern Kentucky University,14138,10744,Kentucky,Town,NA,100.0,100.0,100.0,23,8,63,12,4,33,35,12,96,29.320058875132823,4.9649713971512845
Eastern Mennonite University,1102,942,Virginia,Small City,NA,99.82,86.46,100.0,4,1,9,2,1,5,6,2,14,4.8844688358253645,1.3953995436919195
Eastern Michigan University,17218,12410,Michigan,Suburb,NA,100.0,100.0,100.0,37,13,105,20,6,58,57,19,163,51.14167740080506,5.687864119092268
Eastern Nazarene College,694,571,Massachusetts,Suburb,private,91.14,66.59,99.56,2,1,3,1,0,2,3,1,5,1.5237371697453994,0.8933922488746608
Eastern New Mexico University - Main Campus,4600,2590,New Mexico,Town,NA,100.0,98.71,100.0,13,3,47,6,1,25,19,4,72,14.49908651359179,4.754860164598003
Eastern Oregon University,2736,1668,Oregon,Town,public,99.97,96.09,100.0,5,2,19,3,1,8,8,3,27,3.6536720884289626,4.511320579623095
Eastern University,1882,1462,Pennsylvania,Suburb,NA,99.43,90.79,100.0,3,2,8,2,1,4,5,3,12,1.706081194606,3.4481720668476488
Eastern Washington University,11474,10060,Washington,Town,NA,100.0,100.0,100.0,41,22,90,24,13,52,65,35,142,61.73912214950827,3.6294579491239203
Eckerd College,2036,1915,Florida,Large City,private,100.0,98.71,100.0,7,3,17,4,1,9,11,4,26,5.490885003055049,5.121879745240317
Edgewood College,1566,1361,Wisconsin,Large City,NA,54.13,33.68,81.49,1,0,1,0,0,1,1,0,2,0.5772034185039187,0.20165979481149693
Edinboro University of Pennsylvania,4294,3888,Pennsylvania,Town,public,99.98,98.63,100.0,6,3,12,3,1,6,9,4,18,6.693785090845219,1.7589085670482003
Edward Waters College,3443,853,Florida,Large City,private,100.0,100.0,100.0,29,12,67,15,6,37,44,18,104,40.751270860511255,3.0199612370777884
Elizabeth City State University,1365,1179,North CaroliNA,Town,NA,86.14,51.27,99.3,1,0,3,1,0,2,2,0,5,1.2207653002487895,0.7520373017798025
Elizabethtown College,1674,1636,Pennsylvania,Suburb,private,98.6,87.07,99.99,3,1,6,1,1,3,4,2,9,1.8493122406993836,2.4109741168639536
Elmhurst College,2874,2732,Illinois,Suburb,private,99.06,88.51,100.0,3,1,8,2,1,4,5,2,12,2.8091078108271392,1.8470878252823282
Elmira College,936,833,New York,Small City,NA,89.91,66.7,99.33,2,1,3,1,0,2,3,1,5,1.1440224285935807,1.1454456340659829
Elon University,6049,5885,North CaroliNA,Suburb,NA,100.0,99.97,100.0,13,5,31,7,3,17,20,8,48,1.527951339853877,18.714392966109717
Embry Riddle AeroNAutical University - DaytoNA Beach,5733,5378,Florida,Small City,NA,100.0,100.0,100.0,25,11,60,13,5,32,38,16,92,24.41217791898799,14.083820477314136
Embry Riddle AeroNAutical University - Prescott,2607,2471,ArizoNA,Rural,NA,100.0,99.39,100.0,8,3,22,4,2,10,12,5,32,2.2853120189098846,9.44123917654018
Emerson College,3814,3748,Massachusetts,Large City,NA,100.0,99.83,100.0,10,4,23,5,2,12,15,6,35,2.9464530906678994,11.67484236908355
Emmanuel College Georgia,954,822,Georgia,Town,NA,99.2,77.95,100.0,3,1,10,2,0,5,5,1,15,1.6833402710599221,3.110729735691729
Emmanuel College Massachusetts,1947,1804,Massachusetts,Large City,NA,99.83,94.74,100.0,4,2,9,2,1,5,6,3,14,5.2951971258003105,1.074744385243683
Emory and Henry College,999,966,Virginia,Rural,NA,99.8,84.49,100.0,4,1,9,2,1,5,6,2,14,4.7085274197836275,1.4944125538139816
Emory University,6938,6794,Georgia,Large City,NA,100.0,100.0,100.0,21,8,56,11,4,30,32,12,86,4.511743400922233,27.532037368472793
Emporia State University,3605,3340,Kansas,Town,NA,94.45,66.53,99.81,2,1,4,1,0,2,3,1,6,1.8795288434472535,1.0092971182400332
Endicott College,3348,2946,Massachusetts,Suburb,NA,99.99,98.37,100.0,6,3,13,3,1,7,9,4,20,6.629519454002773,2.3218673016820266
Erskine College,573,568,South CaroliNA,Rural,NA,99.99,97.46,100.0,6,3,14,3,1,7,9,4,21,8.592293251949211,0.5171969818380833
Eureka College,615,593,Illinois,Town,private,51.3,30.72,82.72,0,0,1,0,0,1,0,0,2,0.6843137176192787,0.03482948261146763
Evangel University,1632,1461,Missouri,Midsize City,NA,98.73,80.1,100.0,3,1,8,1,1,4,4,2,12,0.6443918051407196,3.7040042104387743
Everglades University,2101,2099,Florida,Small City,NA,100.0,100.0,100.0,16,7,38,9,4,21,25,11,59,23.239799769687046,1.8506617856668024
Fairfield University,4118,3879,Connecticut,Suburb,private,100.0,99.55,100.0,8,4,17,4,2,9,12,6,26,0.4203393403432859,11.004200358326303
Fairleigh Dickinson University - Florham Campus,2747,2640,New Jersey,Suburb,NA,100.0,99.79,100.0,9,4,22,5,2,12,14,6,34,12.37562163701666,1.4948256526230093
Fairleigh Dickinson University - Metropolitan Campus,5471,2374,New Jersey,Suburb,NA,100.0,100.0,100.0,19,8,46,10,4,24,29,12,70,26.024797178513783,2.4896232864044356
Fairmont State University,3661,3108,West Virginia,Town,public,83.25,45.16,98.42,1,0,3,1,0,1,2,0,4,0.5511130342407574,1.230792403394706
Farmingdale State College,9552,7407,New York,Suburb,NA,100.0,100.0,100.0,16,8,32,8,4,17,24,12,49,23.544080630016808,0.10405478354218965
Faulkner University,2673,1744,Alabama,Midsize City,NA,100.0,98.88,100.0,8,3,20,4,1,11,12,4,31,8.900318840383799,3.543928916499129
Fayetteville State University,5394,3905,North CaroliNA,Midsize City,NA,99.89,92.41,100.0,5,2,12,2,1,6,7,3,18,5.080537940741285,1.7096833845590733
Felician University,1626,1430,New Jersey,Suburb,NA,99.99,97.99,100.0,6,3,14,3,1,7,9,4,21,8.444216105794366,0.37027027802284396
Ferris State University,12513,8469,Michigan,Town,public,100.0,100.0,100.0,27,9,77,14,5,43,41,14,120,40.395529444319436,1.4090451580110128
Ferrum College,1137,1118,Virginia,Rural,NA,99.97,90.92,100.0,5,2,11,3,1,7,8,3,18,7.615749865806615,0.59577750281381
Finlandia University,399,336,Michigan,Town,NA,77.26,39.86,98.88,1,0,3,1,0,2,2,0,5,1.0841912483150673,0.3927794755842164
Fisk University,663,639,Tennessee,Large City,NA,86.85,50.6,99.66,1,0,4,1,0,2,2,0,6,0.5044956710366378,1.5188954225977138
Fitchburg State University,4119,3386,Massachusetts,Suburb,public,100.0,99.95,100.0,11,5,23,6,3,13,17,8,36,15.952938876616198,0.2705417987174487
Five Towns College,626,591,New York,Suburb,NA,80.83,56.77,96.92,1,1,2,1,0,1,2,1,3,1.3619314626114056,0.28732498770819437
Flagler College - St Augustine,2681,2591,Florida,Suburb,NA,100.0,100.0,100.0,18,7,41,9,4,23,27,11,64,22.86879402623738,4.135194426297504
Florida Agricultural and Mechanical University,8027,6875,Florida,Midsize City,NA,100.0,100.0,100.0,67,28,154,35,14,85,102,42,239,96.43181283743705,5.576482897816014
Florida Atlantic University,25033,16325,Florida,Small City,public,100.0,100.0,100.0,227,97,520,121,50,288,348,147,808,340.92459777076664,7.025955417958736
Florida Gulf Coast University,13857,10973,Florida,Suburb,NA,100.0,100.0,100.0,125,53,287,67,27,159,192,80,446,188.60447974007195,3.412179993424327
Florida Institute of Technology,3634,3269,Florida,Small City,private,100.0,100.0,100.0,21,9,47,11,4,26,32,13,73,24.990946878769467,6.5397716763367955
Florida InterNAtioNAl University,47621,26655,Florida,Suburb,public,100.0,100.0,100.0,447,190,1025,239,98,568,686,288,1593,679.1334334994817,6.353540132348952
Florida Memorial University,1173,1129,Florida,Suburb,private,100.0,99.84,100.0,10,4,23,5,2,13,15,6,36,14.691827440606753,0.5574354475208994
Florida Southern College,2615,2356,Florida,Midsize City,NA,100.0,100.0,100.0,17,7,40,9,4,22,26,11,62,23.714687121302617,2.604523837543359
Florida State University,33009,29286,Florida,Midsize City,NA,100.0,100.0,100.0,299,127,688,160,65,381,459,192,1069,449.4511978446628,9.489335218773311
Fontbonne University,892,765,Missouri,Suburb,NA,71.81,34.49,97.82,1,0,3,0,0,1,1,0,4,0.861110337102178,0.40329205742601026
Fordham University,9595,9132,New York,Large City,NA,100.0,100.0,100.0,21,10,48,11,5,25,32,15,73,10.197152296425033,21.858062063374483
Fort Hays State University,12499,5889,Kansas,Town,NA,100.0,99.42,100.0,9,3,19,4,2,10,13,5,29,5.5996799972049525,7.368769615956096
Fort Lewis College,3303,2921,Colorado,Town,public,99.85,88.77,100.0,4,1,13,2,1,7,6,2,20,1.6554443374537053,4.800298719772461
Fort Valley State University,2345,2115,Georgia,Town,NA,99.85,72.14,100.0,4,1,17,2,0,10,6,1,27,5.289798933185395,1.1757059598253181
Framingham State University,4128,3558,Massachusetts,Small City,public,100.0,99.96,100.0,11,5,24,6,3,13,17,8,37,16.693761367984127,0.16938674144627994
Francis Marion University,3462,3006,South CaroliNA,Suburb,public,100.0,100.0,100.0,44,18,101,21,8,50,65,26,151,64.8238616183503,0.5278571233887198
Franciscan University of Steubenville,2201,2011,Ohio,Small City,NA,99.95,95.35,100.0,5,2,12,3,1,6,8,3,18,0.7512144269692645,6.926779245819421
Franklin and Marshall College,2281,2263,Pennsylvania,Small City,NA,99.91,95.95,100.0,5,2,10,2,1,6,7,3,16,1.1549136248289287,5.790255634926505
Franklin College,1017,962,IndiaNA,Suburb,private,94.08,75.53,99.79,2,1,4,1,0,2,3,1,6,2.598786701422697,0.22431793197885827
Franklin Pierce University,1712,1563,New Hampshire,Rural,NA,98.62,85.4,99.99,3,1,6,1,1,3,4,2,9,0.16356564018722752,4.10968518601386
Welch College,344,222,Tennessee,Rural,private,64.27,28.98,94.58,1,0,2,0,0,1,1,0,3,0.31951392498987063,0.7053573627275789
Freed - Hardeman University,1469,1261,Tennessee,Town,NA,99.32,81.25,100.0,3,1,9,2,1,5,5,2,14,1.8414091992837283,3.1311505186385626
Fresno Pacific University,2803,2342,California,Large City,private,100.0,99.94,100.0,11,5,26,6,2,14,17,7,40,16.21705203147394,0.21806341966349793
Friends University,1149,906,Kansas,Large City,NA,80.62,46.21,97.89,1,0,3,1,0,1,2,0,4,0.5143672542645604,1.1224212322563625
Frostburg State University,4726,3849,Maryland,Suburb,public,100.0,99.49,100.0,8,4,18,4,2,10,12,6,28,11.0988744775606,0.9717170727366592
Full Sail University,16908,16908,Florida,Suburb,NA,100.0,100.0,100.0,73,30,174,38,15,93,111,45,267,62.18056260216394,48.079300800671994
Furman University,2732,2658,South CaroliNA,Suburb,NA,100.0,99.99,100.0,16,6,38,8,3,19,24,9,57,14.972902819455914,8.350006199519159
Gallaudet University,1125,1074,District of Columbia,Large City,NA,99.17,85.49,100.0,3,1,7,2,1,4,5,2,11,0.05894414164575966,4.712965430874699
Gannon University,3074,2530,Pennsylvania,Small City,private,99.8,95.49,100.0,4,2,9,2,1,5,6,3,14,4.063047775889528,2.1514903052465733
Gardner - Webb University,2218,1781,North CaroliNA,Town,NA,99.98,96.17,100.0,6,2,14,3,1,7,9,3,21,1.5070068371535301,6.8555208186884125
Geneva College,1412,1247,Pennsylvania,Suburb,NA,96.8,80.36,99.96,2,1,5,1,1,3,3,2,8,1.7894815505591093,1.6448550837588598
George Fox University,2700,2494,Oregon,Town,private,99.99,98.75,100.0,6,3,15,3,2,8,9,5,23,2.9004137700464376,6.033825941436814
George Mason University,25006,20221,Virginia,Suburb,NA,100.0,100.0,100.0,117,36,254,67,19,151,184,55,405,165.1084517111672,18.760617921152527
George Washington University,11996,10893,District of Columbia,Large City,NA,100.0,100.0,100.0,31,14,73,16,7,39,47,21,112,0.33647280856121137,47.200100656762835
Georgetown College,1059,976,Kentucky,Town,private,92.63,59.52,99.94,2,1,5,1,0,3,3,1,8,2.1626382638242854,0.4414666054138431
Georgetown University,7465,6987,District of Columbia,Large City,private,100.0,100.0,100.0,19,8,46,10,4,24,29,12,70,0.2726166551116384,29.10958491322509
Georgia College & State University,5987,5442,Georgia,Town,NA,100.0,89.25,100.0,10,2,43,5,1,24,15,3,67,14.611785027281767,0.06333726453977957
Georgia Gwinnett College,12290,8289,Georgia,Suburb,public,100.0,99.25,100.0,20,3,89,10,2,50,30,5,139,29.75450732029028,0.9816544326876385
Georgia Institute of Technology - Main Campus,15576,13974,Georgia,Large City,NA,100.0,100.0,100.0,38,11,127,20,5,70,58,16,197,26.380486631639652,31.525587418548465
Georgia Southern University,17763,15755,Georgia,Town,NA,100.0,99.98,100.0,31,6,131,16,3,74,47,9,205,41.7947943462872,5.569240902846851
Georgia Southwestern State University,2604,1779,Georgia,Town,public,99.86,65.55,100.0,4,1,19,2,0,11,6,1,30,6.256251559738693,0.28855939919381035
Georgia State University,25771,19882,Georgia,Large City,NA,100.0,100.0,100.0,43,7,185,22,3,105,65,10,290,60.793540283467856,4.243749764407726
Georgian Court University,1612,1343,New Jersey,Small City,private,99.98,97.57,100.0,6,2,13,3,1,7,9,3,20,7.951406116669317,0.40300793139094643
Gettysburg College,2411,2404,Pennsylvania,Small City,NA,99.9,95.62,100.0,5,2,10,2,1,5,7,3,15,1.2038660076709713,5.649311770327193
Glenville State College,1655,1037,West Virginia,Town,NA,69.21,30.75,93.12,1,0,2,0,0,1,1,0,3,0.23935260506883796,0.9350642846550302
Goddard College,189,173,Vermont,Rural,NA,49.83,23.55,79.68,0,0,1,0,0,1,0,0,2,0.0,0.6877927789050156
Gonzaga University,5194,5106,Washington,Midsize City,private,100.0,100.0,100.0,18,8,60,9,4,27,27,12,87,14.141234559647787,12.944522730583683
Gordon College,1593,1528,Massachusetts,Suburb,NA,99.09,87.81,100.0,3,1,7,2,1,4,5,2,11,2.163538412290429,2.5285838587280796
Goshen College,888,816,IndiaNA,Small City,private,90.89,66.98,99.58,2,1,4,1,0,2,3,1,6,1.4394970735153203,0.9525531388838758
Goucher College,1534,1447,Maryland,Small City,NA,99.39,89.17,100.0,3,1,8,2,1,4,5,2,12,0.7184145414728074,4.362910354263882
Grace Bible College,873,822,Michigan,Small City,NA,94.71,65.16,99.97,2,1,5,1,0,3,3,1,8,2.404373651626159,0.5290460941350068
Grace College and Theological SemiNAry,1761,1439,IndiaNA,Town,private,99.22,89.3,100.0,3,1,7,2,1,4,5,2,11,2.5823039105045824,2.267666578559608
Graceland University - Lamoni,1405,1061,Iowa,Rural,private,99.99,97.23,100.0,6,2,15,3,1,8,9,3,23,1.0079855456452913,8.03456636499231
Grambling State University,4075,3734,LouisiaNA,Town,NA,100.0,99.97,100.0,14,6,37,7,3,19,21,9,56,12.984107762200004,8.715325704186993
Grand Canyon University,49564,15998,ArizoNA,Large City,NA,100.0,100.0,100.0,166,72,410,83,35,206,249,107,616,77.43204647663401,171.52963544187637
Grand Valley State University,21935,19373,Michigan,Suburb,NA,100.0,100.0,100.0,48,17,135,25,8,76,73,25,211,71.6147651371268,1.7766467162517885
Grand View University,1787,1574,Iowa,Midsize City,NA,99.56,70.93,100.0,4,1,13,2,0,7,6,1,20,4.071141620467372,1.337816820963171
Granite State College,1758,807,New Hampshire,Town,NA,56.27,0.0,93.49,1,0,2,0,0,1,1,0,3,0.8269151809465392,6.608089771889387e-05
Grantham University,7817,3296,Kansas,Suburb,NA,100.0,100.0,100.0,24,9,61,12,4,31,36,13,92,0.11900821900670586,36.0385487784074
Greensboro College,944,772,North CaroliNA,Large City,NA,97.61,75.47,99.99,2,1,6,1,0,3,3,1,9,0.5206204956943367,3.1957359291450387
Greenville University,988,887,Illinois,Town,NA,80.99,52.63,98.48,1,0,3,1,0,1,2,0,4,0.7071241748732547,0.9501730585229252
Grinnell College,1717,1662,Iowa,Town,private,99.53,87.4,100.0,4,1,10,2,1,5,6,2,15,0.8091883963652478,4.536141517679536
Grove City College,2376,2315,Pennsylvania,Town,NA,99.85,93.71,100.0,4,2,10,2,1,5,6,3,15,1.8529383431321274,4.657169163996169
Guilford College,1669,1429,North CaroliNA,Large City,NA,99.15,83.49,100.0,3,1,7,2,1,4,5,2,11,0.8078593898705224,3.948854923097533
Gustavus Adolphus College,2184,2150,Minnesota,Town,private,86.07,49.24,99.9,1,0,5,1,0,2,2,0,7,0.6035315146919413,1.360840369341873
Gwynedd Mercy University,2081,1934,Pennsylvania,Suburb,private,99.18,90.68,100.0,3,2,7,2,1,4,5,3,11,3.0985045287796535,1.7022054065817982
Hamilton College,1894,1886,New York,Suburb,private,99.85,94.76,100.0,4,2,10,2,1,5,6,3,15,1.4807909357120375,5.000744569322999
Hamline University,2166,2082,Minnesota,Large City,NA,88.03,57.33,99.6,1,1,4,1,0,2,2,1,6,0.5745059526254963,1.5412748452167595
Hampden - Sydney College,1044,1039,Virginia,Rural,NA,99.92,87.84,100.0,5,1,10,3,1,6,8,2,16,5.973629982750404,1.11430676594193
Hampshire College,1264,1268,Massachusetts,Suburb,private,98.67,84.48,100.0,3,1,7,1,1,4,4,2,11,0.9470742077146819,3.3598909042538834
Hampton University,3796,3651,Virginia,Midsize City,NA,100.0,99.88,100.0,12,4,28,7,2,16,19,6,44,7.875472908534894,10.707791256167022
Hannibal - LaGrange University,913,706,Missouri,Town,NA,76.43,40.78,98.46,1,0,3,0,0,1,1,0,4,0.6893493729412349,0.7535989115255908
Hanover College,1096,1081,IndiaNA,Town,NA,95.49,75.42,99.93,2,1,5,1,0,3,3,1,8,1.8268426600910077,1.2660499231244844
Hardin - Simmons University,1741,1585,Texas,Midsize City,NA,99.99,97.58,100.0,7,3,16,3,1,7,10,4,23,9.441695136925839,0.3399320381613643
Harding University,4187,3945,Arkansas,Town,NA,100.0,99.4,100.0,10,3,25,5,2,12,15,5,37,1.2648207870064665,13.00389543772994
Harris - Stowe State University,1441,1163,Missouri,Large City,NA,81.78,42.11,99.53,1,0,4,1,0,2,2,0,6,1.4697666396322315,0.23203376311507676
Harrisburg University of Science and Technology,509,463,Pennsylvania,Small City,NA,62.89,39.61,88.47,1,0,1,0,0,1,1,0,2,0.8122469449346312,0.17789742429853506
Hartwick College,1198,1180,New York,Town,private,95.53,78.77,99.86,2,1,4,1,1,2,3,2,6,2.2731874230495825,0.8295341071708657
Harvard University,9964,7147,Massachusetts,Midsize City,NA,100.0,100.0,100.0,27,11,67,14,6,34,41,17,101,6.2506897709169005,34.23474957243075
Harvey Mudd College,867,844,California,Suburb,NA,97.67,80.79,99.99,2,1,6,1,1,3,3,2,9,2.1638501799195997,1.5863269055282365
Hastings College,1156,1073,Nebraska,Town,NA,49.72,24.6,84.01,0,0,1,0,0,1,0,0,2,0.10176599745075778,0.5844803171171097
Haverford College,1293,1294,Pennsylvania,Suburb,private,98.74,85.68,100.0,3,1,7,1,1,4,4,2,11,0.31909701408146224,4.042793958784968
Hawaii Pacific University,3565,2411,Hawaii,Large City,NA,99.95,95.68,100.0,5,2,13,3,1,7,8,3,20,0.00016611590111502078,7.575532545546457
Heidelberg University,1049,1031,Ohio,Town,NA,94.71,68.83,99.91,2,1,5,1,0,2,3,1,7,1.601940375433159,1.3285582002813865
Henderson State University,2838,2565,Arkansas,Town,public,99.27,78.16,100.0,3,1,9,2,0,4,5,1,13,2.848455246264792,2.06892699351839
Hendrix College,1240,1228,Arkansas,Small City,NA,97.02,72.08,99.99,2,1,6,1,0,3,3,1,9,0.6921154993976723,2.8131479684338316
Heritage University,812,734,Washington,Rural,private,99.08,92.48,99.99,3,2,6,2,1,4,5,3,10,4.673456435667075,0.0
Herzing University - Atlanta,593,365,Georgia,Large City,NA,76.61,19.68,99.88,1,0,4,0,0,2,1,0,6,1.4509022975850783,0.0
High Point University,4467,4418,North CaroliNA,Midsize City,NA,100.0,99.63,100.0,9,4,21,5,2,11,14,6,32,1.0552039931889046,12.563721209189781
Hilbert College,744,680,New York,Suburb,private,84.1,61.34,97.72,1,1,2,1,0,1,2,1,3,1.7828920965094766,0.05368908732163814
Hiram College,1209,853,Ohio,Town,NA,94.97,69.74,99.92,2,1,5,1,0,2,3,1,7,2.011693699234576,0.9710675213097923
Hobart and William Smith Colleges,2239,2220,New York,Town,private,99.83,95.03,100.0,4,2,9,2,1,5,6,3,14,2.3128072474164596,4.028536413218373
Hodges University,1076,573,Florida,Suburb,NA,100.0,99.83,100.0,10,4,23,5,2,13,15,6,36,14.914430886676552,0.21895710905241278
Hofstra University,6863,6494,New York,Suburb,NA,100.0,99.99,100.0,14,7,30,7,3,16,21,10,46,9.174465579955015,11.534307745571397
Hollins University,647,632,Virginia,Suburb,NA,98.31,71.58,100.0,3,1,7,1,0,4,4,1,11,2.6726338913006713,1.3928742476786473
Holy Cross College,555,526,IndiaNA,Suburb,NA,81.62,53.8,98.09,1,1,3,1,0,1,2,1,4,0.8268866777254035,0.8621580429329231
Holy Family University,2095,1630,Pennsylvania,Large City,private,99.24,90.94,100.0,3,2,7,2,1,4,5,3,11,3.073121811750446,1.7953253720823907
Holy Names University,591,543,California,Large City,private,95.68,75.3,99.96,2,1,5,1,0,3,3,1,8,3.0684105010335307,0.06387428255441363
Hood College,1132,1048,Maryland,Small City,NA,96.88,76.1,99.99,2,1,6,1,0,3,3,1,9,2.0594550188887144,1.3994949292656242
Hope College,3150,3019,Michigan,Small City,private,99.99,97.17,100.0,6,2,17,3,1,10,9,3,27,7.288364511543876,2.49454070667889
Hope InterNAtioNAl University,866,579,California,Suburb,NA,98.94,86.95,100.0,3,1,7,2,1,4,5,2,11,4.203545021647091,0.3312295206481227
Houghton College,1036,971,New York,Rural,private,93.25,72.54,99.72,2,1,4,1,0,2,3,1,6,1.5055533259413356,1.1855935066060517
Houston Baptist University,2320,2098,Texas,Large City,NA,100.0,99.33,100.0,9,4,22,4,1,9,13,5,31,12.891106705669879,0.2520036154363515
Howard Payne University,980,860,Texas,Town,private,99.61,87.78,100.0,4,1,9,2,1,4,6,2,13,5.3651178284101535,0.16992928759342654
Howard University,6354,6090,District of Columbia,Large City,NA,100.0,100.0,100.0,18,7,44,9,4,23,27,11,67,0.16946440723155903,27.399114938223253
Humboldt State University,7860,7270,California,Town,NA,100.0,100.0,100.0,29,13,74,15,6,38,44,19,112,41.361464094856615,2.7937891924579525
Humphreys University - Stockton and Modesto Campuses,324,208,California,Large City,NA,85.36,57.64,99.09,1,1,3,1,0,2,2,1,5,1.9155395035353835,0.0
Huntingdon College,1101,878,Alabama,Midsize City,private,99.84,91.1,100.0,4,2,10,2,1,5,6,3,15,3.5796606786467278,2.8004805690186023
Huntington University,1075,859,IndiaNA,Town,NA,94.53,74.44,99.87,2,1,4,1,0,2,3,1,6,1.922992273780008,0.9788131778444892
Huston - Tillotson University,1052,1003,Texas,Large City,NA,99.75,89.75,100.0,4,2,10,2,1,4,6,3,14,5.815536859700697,0.14703765320043455
Idaho State University,10565,6279,Idaho,Small City,public,100.0,100.0,100.0,48,7,186,28,4,109,76,11,295,72.50316574069006,3.997822433191066
Illinois College,956,950,Illinois,Town,NA,76.38,47.92,97.65,1,0,2,0,0,1,1,0,3,0.9340882245503155,0.5069613912937001
Illinois Institute of Technology,2895,2631,Illinois,Large City,NA,99.28,89.38,100.0,3,1,8,2,1,4,5,2,12,2.412205854607958,2.5170741073808345
Illinois State University,18336,17165,Illinois,Suburb,NA,100.0,100.0,100.0,14,7,35,7,4,18,21,11,53,20.676538977866507,0.7161040491127353
Illinois Wesleyan University,1650,1646,Illinois,Small City,NA,86.62,62.37,99.36,1,1,3,1,0,2,2,1,5,1.6377908308354738,0.3717387168968879
Immaculata University,1481,885,Pennsylvania,Suburb,NA,97.63,83.6,99.98,2,1,6,1,1,3,3,2,9,1.8166773188046885,1.9181004831029813
IndiaNA State University,11578,9369,IndiaNA,Small City,public,100.0,100.0,100.0,20,10,42,10,5,23,30,15,65,27.897123628908545,2.3563190160457546
IndiaNA University - Bloomington,33427,32212,IndiaNA,Small City,public,100.0,100.0,100.0,59,29,130,31,15,70,90,44,200,63.178537589132326,26.501400412135357
IndiaNA University - East,3292,1887,IndiaNA,Rural,public,99.98,98.59,100.0,6,3,12,3,1,7,9,4,19,7.604060876890089,1.0303602505028502
IndiaNA University - Kokomo,2877,2215,IndiaNA,Small City,NA,99.96,98.17,100.0,5,3,11,3,1,6,8,4,17,7.859544136120862,0.011891082391361473
IndiaNA University - Northwest,3700,2608,IndiaNA,Small City,NA,100.0,99.42,100.0,7,3,14,4,2,8,11,5,22,10.120433623722214,0.018248365803180767
IndiaNA University of Pennsylvania - Main Campus,10255,9526,Pennsylvania,Town,NA,100.0,100.0,100.0,14,7,30,7,4,16,21,11,46,16.981037692539633,4.096029025186308
IndiaNA University - Purdue University - Fort Wayne,9952,5913,IndiaNA,Large City,public,100.0,100.0,100.0,18,9,38,9,5,21,27,14,59,26.49883353268851,0.804988554758021
IndiaNA University - Purdue University - IndiaNApolis,21615,17521,IndiaNA,Large City,NA,100.0,100.0,100.0,39,20,83,21,10,45,60,30,128,57.25846851770958,2.3565719709429356
IndiaNA University - South Bend,4877,3767,IndiaNA,Midsize City,NA,100.0,99.88,100.0,9,4,19,5,2,10,14,6,29,13.125795834458398,0.29999716386505665
IndiaNA University - Southeast,4824,3218,IndiaNA,Suburb,NA,100.0,99.78,100.0,8,4,19,4,2,10,12,6,29,10.244054555608072,2.6393972940568378
IndiaNA Wesleyan University,2803,2634,IndiaNA,Town,private,99.93,96.43,100.0,5,2,11,2,1,6,7,3,17,4.475077734268047,2.7700006382889426
Institute of American Indian and Alaska Native Culture and Arts Development,612,264,New Mexico,Rural,NA,93.74,49.91,100.0,2,0,10,1,0,4,3,0,14,1.0317261236673811,1.7276677727231367
IoNA College,3177,2949,New York,Suburb,private,99.98,98.62,100.0,6,3,12,3,1,6,9,4,18,5.903353830664711,2.72390892974176
Iowa State University,30573,28743,Iowa,Small City,public,100.0,100.0,100.0,46,11,171,24,5,94,70,16,265,57.55597465634614,12.558329797911435
Iowa Wesleyan University,625,550,Iowa,Town,private,75.89,34.82,99.08,1,0,3,0,0,2,1,0,5,0.5739917690480132,0.8453574427526955
Ithaca College,6062,5936,New York,Suburb,NA,100.0,99.98,100.0,12,6,26,6,3,14,18,9,40,6.292123357264694,11.455313303825656
Jackson State University,6498,5935,Mississippi,Midsize City,NA,100.0,100.0,100.0,43,19,96,22,9,50,65,28,146,57.72799011348904,7.626582147876748
Jacksonville State University,7492,5523,Alabama,Small City,NA,100.0,100.0,100.0,20,7,53,10,3,28,30,10,81,25.027900403254822,5.160486802233582
Jacksonville University,2878,2180,Florida,Large City,NA,100.0,100.0,100.0,20,9,48,11,4,26,31,13,74,28.255797421126523,3.1258463263881873
James Madison University,19972,18905,Virginia,Small City,NA,100.0,100.0,100.0,87,27,190,50,15,113,137,42,303,117.64616019324147,19.565857179238062
University of Jamestown,916,871,North Dakota,Town,NA,99.98,78.36,100.0,6,1,25,3,1,12,9,2,37,6.414065384863739,2.0852172747545534
Jarvis Christian College,908,835,Texas,Rural,NA,99.33,85.22,100.0,3,1,8,2,1,4,5,2,12,4.663832501210951,0.3349965526836438
John Brown University,1972,1489,Arkansas,Town,NA,99.52,84.61,100.0,4,1,9,2,1,5,6,2,14,0.7489222991807308,4.567103539677627
John Carroll University,3079,2987,Ohio,Suburb,private,99.88,94.07,100.0,4,2,10,2,1,5,6,3,15,3.9980217165195406,2.7025026917138115
Johns Hopkins University,6106,5668,Maryland,Large City,NA,100.0,100.0,100.0,16,7,38,8,3,20,24,10,58,1.8174627522873477,22.147171018083668
Johnson & Wales University - Providence,7717,7267,Rhode Island,Midsize City,private,100.0,100.0,100.0,15,7,34,8,3,18,23,10,52,0.43422021732818794,22.092915468874423
Johnson C Smith University,1395,1329,North CaroliNA,Large City,NA,99.93,93.95,100.0,5,2,11,2,1,6,7,3,17,0.5605147865521403,6.647133219077171
Johnson State College,1377,882,Vermont,Rural,NA,68.19,40.22,92.45,1,0,2,0,0,1,1,0,3,0.002057622435867626,1.140304501678872
Judson College,313,230,Alabama,Rural,NA,80.13,44.62,98.92,1,0,3,1,0,1,2,0,4,1.0488448251788158,0.5613699679134123
Judson University,1078,761,Illinois,Midsize City,private,76.99,49.81,97.58,1,0,2,0,0,1,1,0,3,0.9854117533717615,0.4821673605599744
Juniata College,1487,1400,Pennsylvania,Town,NA,97.49,82.36,99.97,2,1,5,1,1,3,3,2,8,1.6770723751440488,2.0021705400994514
Kalamazoo College,1434,1427,Michigan,Small City,NA,99.02,81.33,100.0,3,1,8,2,1,5,5,2,13,3.392800373276173,1.2248207202092902
Kansas State University,18484,16770,Kansas,Small City,NA,100.0,99.86,100.0,11,4,26,6,2,13,17,6,39,8.802603122202738,8.277927738860717
Kansas Wesleyan University,693,631,Kansas,Town,NA,81.87,48.32,98.28,1,0,3,1,0,1,2,0,4,0.22485687533478557,1.478721832012568
Kaplan University - Davenport Campus,25486,3127,Iowa,Midsize City,NA,100.0,100.0,100.0,78,30,205,39,15,103,117,45,308,2.0803701678179207,114.80530727738906
Kean University,11985,9516,New Jersey,Suburb,NA,100.0,100.0,100.0,43,19,105,22,9,55,65,28,160,63.84381095069445,1.2470543709352941
Keene State College,3778,3624,New Hampshire,Town,NA,99.57,89.0,100.0,4,1,8,2,1,4,6,2,12,0.821176035676812,4.610868849935842
Kent State University at Kent,23179,19108,Ohio,Suburb,public,100.0,100.0,100.0,31,13,73,16,6,39,47,19,112,39.05729658349031,8.2452973464396
Kentucky Christian University,589,439,Kentucky,Town,NA,83.75,49.41,99.13,1,0,3,1,0,2,2,0,5,0.7249066806114922,1.0865870819760963
Kentucky State University,1762,1122,Kentucky,Town,public,98.92,82.42,100.0,3,1,8,2,1,4,5,2,12,1.476393272845406,3.039899928436989
Kentucky Wesleyan College,716,673,Kentucky,Small City,private,86.11,52.47,99.51,1,0,3,1,0,2,2,0,5,1.1767651781926558,0.7934106406613114
Kenyon College,1678,1661,Ohio,Town,NA,99.28,87.98,100.0,3,1,8,2,1,4,5,2,12,0.49170398856170044,4.43138006549045
Kettering University,1891,1807,Michigan,Small City,NA,99.82,89.84,100.0,4,2,11,2,1,6,6,3,17,4.340185154926878,1.967038214361428
Keuka College,1645,1312,New York,Town,private,98.18,87.21,99.97,3,1,5,1,1,3,4,2,8,3.726739729509392,0.27676204128840226
Keystone College,1454,1065,Pennsylvania,Suburb,private,95.22,78.16,99.87,2,1,4,1,1,2,3,2,6,2.191978920593681,0.8447240587690285
King University,1798,1608,Tennessee,Small City,NA,99.93,88.29,100.0,5,1,12,3,1,7,8,2,19,2.2450057361130384,4.987560956515586
King's College,2198,2025,Pennsylvania,Small City,NA,99.62,93.4,100.0,4,2,8,2,1,4,6,3,12,2.585411034546393,2.9796706484982263
Knox College,1354,1334,Illinois,Town,private,92.55,65.86,99.9,2,1,4,1,0,2,3,1,6,0.8565326698867973,1.7353845669886987
Kutztown University of Pennsylvania,7489,7053,Pennsylvania,Town,NA,100.0,99.98,100.0,11,6,24,6,3,13,17,9,37,11.739506626008342,5.039989757694833
Kuyper College,182,146,Michigan,Suburb,NA,44.68,18.12,81.96,0,0,1,0,0,1,0,0,2,0.5472258666574472,0.04376563446009521
La Roche College,1379,1163,Pennsylvania,Suburb,NA,92.44,73.27,99.62,2,1,4,1,0,2,3,1,6,2.2028572278919127,0.3764211369109122
La Salle University,3822,3322,Pennsylvania,Large City,NA,100.0,99.4,100.0,7,3,16,4,2,9,11,5,25,4.197213565901052,6.560899892504754
La Sierra University,2027,1830,California,Large City,private,100.0,99.48,100.0,8,4,20,4,2,10,12,6,30,11.20354123209738,0.5991711711370512
Lafayette College,2590,2551,Pennsylvania,Suburb,NA,99.99,98.22,100.0,6,3,14,3,1,7,9,4,21,0.9754215544081062,7.919723629291702
LaGrange College,940,888,Georgia,Town,NA,96.72,58.69,100.0,2,1,8,1,0,4,3,1,12,1.9671592702502578,1.438523330257305
Lake Erie College,959,724,Ohio,Suburb,private,91.55,63.08,99.74,2,1,4,1,0,2,3,1,6,1.2975521920378206,1.1673031684545427
Lake Forest College,1505,1487,Illinois,Suburb,NA,95.83,76.01,99.96,2,1,5,1,0,3,3,1,8,0.9454934531773035,2.223628204873304
Lake Superior State University,1962,1706,Michigan,Town,public,99.87,89.61,100.0,4,2,12,2,1,7,6,3,19,6.2041732632288085,0.40803528787232163
Lakeland University,1997,779,Wisconsin,Rural,private,80.3,50.91,98.27,1,0,3,1,0,1,2,0,4,0.6607460185505385,0.9612597008760286
Lamar University,9270,5967,Texas,Midsize City,NA,100.0,100.0,100.0,37,14,86,16,6,36,53,20,122,51.74117353116062,0.8508724553971158
Lander University,2785,2600,South CaroliNA,Town,NA,100.0,100.0,100.0,36,15,81,17,6,40,53,21,121,51.55375951169527,0.82039833527583
Lane College,1416,1370,Tennessee,Small City,NA,96.6,63.28,100.0,2,1,7,1,0,3,3,1,10,1.9675331170428876,1.4068556062635262
Langston University,2028,1822,Oklahoma,Rural,NA,99.95,92.68,100.0,5,2,15,3,1,8,8,3,23,3.931055738396311,3.725361045406973
Lasell College,1733,1669,Massachusetts,Small City,NA,99.47,91.05,100.0,3,2,7,2,1,4,5,3,11,4.348122918085628,0.8731472825692534
Lawrence Technological University,2191,1672,Michigan,Small City,NA,99.94,92.15,100.0,5,2,13,3,1,8,8,3,21,6.898466081550445,0.48910996299203335
Lawrence University,1471,1434,Wisconsin,Small City,private,89.82,64.89,99.53,2,1,3,1,0,2,3,1,5,0.18867036948327534,2.091743107387674
Le Moyne College,2793,2410,New York,Suburb,NA,99.93,97.55,100.0,5,2,10,2,1,5,7,3,15,6.250027293874887,1.0102839516659314
Le Moyne - Owen College,867,770,Tennessee,Large City,private,85.97,40.34,99.82,1,0,4,1,0,2,2,0,6,1.658529518532947,0.3026552018223495
Lebanon Valley College,1756,1624,Pennsylvania,Suburb,private,98.41,86.7,99.99,3,1,6,1,1,3,4,2,9,2.337023017903437,1.7949935553284524
Lee University,4856,3854,Tennessee,Small City,NA,100.0,99.51,100.0,11,4,32,5,2,16,16,6,48,4.784300613664116,11.622078686990198
Lees - McRae College,920,891,North CaroliNA,Rural,NA,98.09,78.29,99.99,3,1,6,1,0,3,4,1,9,0.49468920663676436,3.437949331274774
Lehigh University,5065,5013,Pennsylvania,Small City,NA,100.0,99.95,100.0,11,5,27,6,3,14,17,8,41,2.1484656914007543,14.976888874749628
Lenoir - Rhyne University,1698,1441,North CaroliNA,Small City,private,98.73,81.21,100.0,3,1,7,1,1,4,4,2,11,1.28160409380694,3.066872404679436
Lesley University,2097,1645,Massachusetts,Midsize City,private,99.79,93.86,100.0,4,2,9,2,1,5,6,3,14,3.834598236569223,2.3073276947880283
LeTourneau University,2606,1301,Texas,Small City,NA,100.0,99.46,100.0,9,4,24,4,2,10,13,6,34,10.599101002140781,3.1076085729385086
Lewis & Clark College,2113,2067,Oregon,Large City,NA,99.98,97.26,100.0,5,2,14,3,1,7,8,3,21,0.5760210669984014,7.710128356562773
Lewis - Clark State College,3746,2215,Idaho,Small City,NA,100.0,99.19,100.0,17,3,64,10,2,37,27,5,101,22.65402972854912,3.931624823506007
Lewis University,4502,3687,Illinois,Suburb,private,99.71,94.37,100.0,4,2,9,2,1,5,6,3,14,4.803882297687337,1.0329091523533498
Liberty University,45756,26892,Virginia,Small City,NA,100.0,100.0,100.0,165,59,388,88,30,213,253,89,601,104.02326769400983,149.16209300534814
Life University,760,624,Georgia,Small City,NA,92.36,51.67,99.99,2,0,6,1,0,3,3,0,9,1.1279358502305583,1.4355665056762894
Limestone College,2599,1943,South CaroliNA,Town,private,100.0,100.0,100.0,25,11,58,12,5,29,37,16,87,34.408317851769276,3.09260969643564
Lincoln Memorial University,1923,1355,Tennessee,Town,NA,99.57,78.58,100.0,4,1,11,2,0,6,6,1,17,2.9512996755643317,2.4750501007158987
Lincoln University California,107,72,California,Large City,private,46.98,24.7,78.86,0,0,1,0,0,1,0,0,2,0.6326010088835988,0.0
Lincoln University Missouri,2513,1804,Missouri,Small City,NA,98.7,77.8,100.0,3,1,8,1,0,4,4,1,12,2.062284328080049,2.2671734770950476
Lincoln University of Pennsylvania,2002,1826,Pennsylvania,Suburb,NA,99.69,93.13,100.0,4,2,9,2,1,5,6,3,14,1.372479770793562,4.392152119295905
Lindenwood University,6931,6215,Missouri,Small City,private,100.0,98.45,100.0,8,3,26,4,1,12,12,4,38,5.640445621741575,6.408094264675047
Lindsey Wilson College,2071,1919,Kentucky,Town,NA,99.49,83.63,100.0,3,1,10,2,1,5,5,2,15,4.419514396128064,0.8414797220781294
Linfield College - McMinnville Campus,1536,1505,Oregon,Town,NA,99.54,91.86,100.0,3,2,10,2,1,5,5,3,15,1.5785192701398498,3.795396776750155
Lipscomb University,2994,2723,Tennessee,Large City,NA,99.97,92.15,100.0,5,2,16,3,1,8,8,3,24,4.141068633092402,4.000689253759898
Livingstone College,1153,1140,North CaroliNA,Suburb,private,98.25,80.03,99.99,3,1,6,1,1,3,4,2,9,0.6981500900115626,3.3258518539356317
Lock Haven University,3471,3176,Pennsylvania,Town,public,99.92,97.22,100.0,5,2,10,2,1,5,7,3,15,5.750998458331808,1.3133617188711393
LIU Brooklyn,3947,3396,New York,Large City,NA,100.0,99.59,100.0,7,4,16,4,2,8,11,6,24,7.842248985618767,3.4027079406364305
LIU Post,6317,2845,New York,Suburb,private,100.0,99.98,100.0,11,6,23,6,3,12,17,9,35,13.990750479553531,2.8706582063771915
Longwood University,4469,3959,Virginia,Town,NA,100.0,100.0,100.0,23,7,50,13,4,30,36,11,80,36.235553541929164,0.36571088452154543
Loras College,1395,1335,Iowa,Small City,NA,90.51,53.13,99.96,2,1,5,1,0,3,3,1,8,1.3159811290369081,1.0358225513469106
LouisiaNA College,985,866,LouisiaNA,Suburb,NA,99.69,88.08,100.0,4,1,10,2,1,5,6,2,15,5.364271343699191,0.4073608479560216
LouisiaNA State University - Alexandria,3372,1844,LouisiaNA,Rural,public,100.0,99.93,100.0,13,5,34,7,2,18,20,7,52,19.00284358356184,0.7509411470895564
LouisiaNA State University and Agricultural & Mechanical College,25448,22060,LouisiaNA,Midsize City,NA,100.0,100.0,100.0,98,37,252,50,18,131,148,55,383,108.94496179948554,39.37076242571229
LouisiaNA State University - Shreveport,2641,1641,LouisiaNA,Midsize City,public,100.0,99.65,100.0,10,4,26,5,2,14,15,6,40,13.948274180185154,1.3494389172368682
LouisiaNA Tech University,11323,8090,LouisiaNA,Town,NA,100.0,100.0,100.0,43,16,113,22,8,59,65,24,172,59.12385343741658,6.287232163769316
Lourdes University,1046,827,Ohio,Suburb,NA,89.03,57.56,99.54,1,1,3,1,0,2,2,1,5,1.7716953238651747,0.43614616725116395
Loyola Marymount University,6395,6164,California,Large City,NA,100.0,100.0,100.0,23,10,57,11,5,29,34,15,86,26.81164089053384,7.099003225123616
Loyola University Maryland,3927,3886,Maryland,Large City,private,100.0,99.76,100.0,9,4,21,5,2,11,14,6,32,1.6712590912156886,11.743680682842474
Loyola University Chicago,11426,10681,Illinois,Large City,private,100.0,99.99,100.0,14,6,35,7,3,18,21,9,53,7.684843048864501,12.970989034701894
Loyola University New Orleans,2607,2446,LouisiaNA,Large City,private,100.0,99.54,100.0,9,4,23,5,2,12,14,6,35,6.544644776626464,7.271130634947475
Lubbock Christian University,1482,1276,Texas,Large City,NA,99.97,95.34,100.0,6,2,14,2,1,6,8,3,20,7.640019011763662,0.4925069597216495
Luther College,2046,2014,Iowa,Town,NA,95.1,56.48,100.0,2,1,7,1,0,4,3,1,11,1.7107754677479807,1.2996243063340596
Lycoming College,1222,1199,Pennsylvania,Small City,private,95.81,77.96,99.93,2,1,5,1,1,2,3,2,7,1.3307795928170074,1.8350561092036304
University of Lynchburg,2051,1928,Virginia,Small City,private,100.0,98.2,100.0,8,3,18,5,1,11,13,4,29,11.075931047960776,1.957843232303942
Lyndon State College,1069,871,Vermont,Town,NA,52.41,27.35,81.29,0,0,1,0,0,1,0,0,2,0.0015380898606983918,0.7391016557867863
Lynn University,2205,1826,Florida,Small City,NA,100.0,99.85,100.0,10,4,25,5,2,13,15,6,38,10.239758519210767,5.319260049309616
Lyon College,670,652,Arkansas,Town,NA,69.79,30.64,96.0,1,0,2,0,0,1,1,0,3,0.6318307322809571,0.563058880036759
Macalester College,2138,2093,Minnesota,Large City,NA,99.57,89.91,100.0,4,2,9,2,1,5,6,3,14,0.11176509531332246,5.3271475054708075
MadonNA University,2455,1358,Michigan,Small City,NA,99.98,94.33,100.0,6,2,16,3,1,9,9,3,25,8.273371071527281,0.20666396197914638
Maharishi University of MaNAgement,325,261,Iowa,Town,NA,68.64,33.91,96.48,1,0,2,0,0,1,1,0,3,0.3023956636935874,0.853680021415862
Maine Maritime Academy,1021,989,Maine,Rural,NA,72.96,32.63,96.35,1,0,2,0,0,1,1,0,3,0.6226989721712748,0.68227229287119
Malone University,1334,1099,Ohio,Small City,NA,94.85,69.51,99.91,2,1,5,1,0,2,3,1,7,2.2068143296162033,0.7543977724022419
Manchester University,1264,1244,IndiaNA,Town,NA,97.21,82.54,99.98,2,1,5,1,1,3,3,2,8,3.1317302744417277,0.44269742395012124
Manhattan College,3666,3479,New York,Large City,NA,100.0,99.54,100.0,7,4,16,4,2,8,11,6,24,6.297075835310554,4.759983948038192
Manhattanville College,1731,1633,New York,Suburb,NA,99.28,90.6,100.0,3,2,7,2,1,4,5,3,11,2.409380569310723,2.508724673998041
Mansfield University of Pennsylvania,1827,1655,Pennsylvania,Town,NA,97.07,84.15,99.94,2,1,5,1,1,3,3,2,8,2.7685292073999594,0.7588284654789936
MaraNAtha Baptist University,933,591,Wisconsin,Town,NA,88.97,55.35,99.88,1,1,4,1,0,2,2,1,6,0.09913188905053451,2.0986444245502964
Marian University IndiaNA,2301,1961,IndiaNA,Large City,NA,99.82,95.72,100.0,4,2,9,2,1,5,6,3,14,5.601401780339195,0.7343375035437526
Marian University Wisconsin,1508,1254,Wisconsin,Small City,NA,52.9,33.0,80.42,0,0,1,0,0,1,0,0,2,0.5276374739786514,0.2249461724634664
Marietta College,1063,960,Ohio,Town,NA,91.31,63.67,99.67,2,1,4,1,0,2,3,1,6,1.35023476224086,1.0874353569449078
Marist College,5697,5085,New York,Suburb,private,100.0,99.97,100.0,11,5,26,6,3,13,17,8,39,7.369287332239169,9.846819989163386
Marquette University,8334,8026,Wisconsin,Large City,NA,100.0,99.28,100.0,7,3,17,4,2,9,11,5,26,1.1272255125907553,9.555981607704847
Mars Hill University,1265,1199,North CaroliNA,Suburb,private,98.96,82.19,100.0,3,1,7,2,1,4,5,2,11,0.8228197489421988,3.712058357586651
Marshall University,9492,7846,West Virginia,Small City,NA,99.99,96.85,100.0,6,2,15,3,1,8,9,3,23,1.1481114761153777,8.540603669007648
Martin Luther College,896,743,Minnesota,Town,private,76.68,47.5,96.76,1,0,2,0,0,1,1,0,3,0.03636535937060343,1.4143996787144735
Martin Methodist College,979,810,Tennessee,Town,NA,90.0,45.89,99.93,2,0,5,1,0,2,3,0,7,1.862429852243588,0.437415379754036
Martin University,263,159,IndiaNA,Large City,NA,51.49,30.74,78.65,0,0,1,0,0,1,0,0,2,0.7224956685773459,0.0
Mary Baldwin University,1133,720,Virginia,Small City,private,99.93,89.45,100.0,5,1,10,3,1,6,8,2,16,6.00714263342502,1.2858095347639278
Marymount Manhattan College,2149,1915,New York,Large City,private,99.98,97.59,100.0,6,2,13,3,1,7,9,3,20,1.8571792671973713,6.5922416891417175
Marymount University,2306,2069,Virginia,Midsize City,NA,100.0,98.75,100.0,9,3,19,5,2,11,14,5,30,10.39729987179979,3.291204772514025
Maryville College,1184,1158,Tennessee,Suburb,NA,98.67,74.6,100.0,3,1,9,1,0,4,4,1,13,1.7951637627720365,2.508316055177348
Maryville University of Saint Louis,3184,2375,Missouri,Suburb,private,99.04,80.07,100.0,3,1,9,2,1,5,5,2,14,2.7643140406573266,1.8706079358068095
Marywood University,1957,1756,Pennsylvania,Small City,NA,99.32,91.37,100.0,3,2,7,2,1,4,5,3,11,2.355153530067156,2.6296497778214185
Massachusetts College of Liberal Arts,1407,1201,Massachusetts,Town,public,99.51,91.86,100.0,3,2,7,2,1,4,5,3,11,4.646977445853373,0.6545512633801417
Massachusetts Institute of Technology,4551,4510,Massachusetts,Midsize City,private,100.0,99.98,100.0,13,6,32,7,3,17,20,9,49,2.054098726065621,18.283116167647343
Massachusetts Maritime Academy,1687,1607,Massachusetts,Suburb,NA,99.89,95.46,100.0,4,2,10,2,1,5,6,3,15,5.3078247819031725,1.494689188274414
Mayville State University,1097,600,North Dakota,Rural,NA,100.0,88.59,100.0,8,1,31,5,1,17,13,2,48,11.810281602859932,0.8617492238614949
McDaniel College,1588,1543,Maryland,Suburb,private,98.31,83.4,99.99,3,1,6,1,1,3,4,2,9,3.8113781989715254,0.26599181920116693
McKendree University,2103,1692,Illinois,Suburb,NA,94.45,74.95,99.93,2,1,5,1,0,2,3,1,7,2.105405204541981,0.7813662044815719
McMurry University,1106,956,Texas,Midsize City,private,99.82,90.44,100.0,4,2,11,2,1,5,6,3,16,6.055000142158962,0.24052370795795602
McNeese State University,6924,5567,LouisiaNA,Small City,NA,100.0,100.0,100.0,27,10,69,14,5,37,41,15,106,37.78948015218156,2.782565894670467
McPherson College,723,673,Kansas,Town,private,79.5,44.08,98.16,1,0,3,1,0,1,2,0,4,0.2013985244728868,1.37961847607308
Medaille College,1526,1426,New York,Large City,NA,97.93,86.38,99.97,3,1,5,1,1,3,4,2,8,3.6871199051425148,0.18684270693712862
Menlo College,746,728,California,Suburb,private,98.48,83.7,100.0,3,1,8,1,1,4,4,2,12,3.4527008335329135,0.7192495324807193
Mercer University,4746,4135,Georgia,Midsize City,NA,100.0,97.53,100.0,10,2,39,5,1,21,15,3,60,9.666972981043244,5.753526441585674
Mercy College,6862,5055,New York,Suburb,private,100.0,99.99,100.0,12,6,24,6,3,13,18,9,37,15.545828585953464,2.1920191256862513
Mercyhurst University,2452,2373,Pennsylvania,Small City,NA,99.53,92.53,100.0,4,2,8,2,1,4,6,3,12,2.552776112651698,2.791277674942034
Meredith College,1682,1600,North CaroliNA,Large City,NA,93.48,63.34,99.9,2,1,4,1,0,2,3,1,6,1.4880570489960734,1.2344780355714873
Merrimack College,3535,3323,Massachusetts,Suburb,NA,100.0,99.64,100.0,8,4,17,4,2,10,12,6,27,10.485163784076768,1.7195525179776245
Colorado Mesa University,9461,7145,Colorado,Small City,public,100.0,96.67,100.0,7,2,24,4,1,13,11,3,37,6.31394999526254,4.754517088916679
Messiah College,2760,2637,Pennsylvania,Suburb,private,99.92,96.37,100.0,5,2,10,2,1,6,7,3,16,2.8265468463238617,4.2967896538947015
Methodist University,1938,1755,North CaroliNA,Midsize City,NA,99.9,93.27,100.0,5,2,11,2,1,6,7,3,17,1.1549397203334135,5.715326887329794
Metropolitan College of New York,777,681,New York,Large City,NA,85.96,63.79,98.23,1,1,3,1,0,1,2,1,4,1.8943228525413187,0.06644629066854582
Metropolitan State University of Denver,19668,12759,Colorado,Large City,public,100.0,98.87,100.0,11,3,36,5,1,19,16,4,55,15.014531218011031,0.9817593105317797
Metropolitan State University,7317,2878,Minnesota,Large City,NA,91.3,66.94,99.68,2,1,4,1,0,2,3,1,6,2.441149857933076,0.0
Miami University - Oxford,17153,16619,Ohio,Town,NA,100.0,100.0,100.0,24,10,58,13,5,31,37,15,89,22.883747531157233,13.941590144087272
Michigan State University,38997,35404,Michigan,Small City,NA,100.0,100.0,100.0,86,30,239,45,15,134,131,45,373,118.79247516633197,12.64346343415524
Michigan Technological University,5886,5492,Michigan,Town,NA,100.0,99.68,100.0,11,4,30,6,2,17,17,6,47,15.650659786402992,0.9995521890018788
Mid - America Christian University,1622,1170,Oklahoma,Large City,private,99.81,86.79,100.0,4,1,13,2,1,6,6,2,19,3.230675502035745,3.022321694017648
Mid - Atlantic Christian University,192,166,North CaroliNA,Town,private,39.01,14.75,68.37,0,0,1,0,0,0,0,0,1,0.11469608621618528,0.3783796504518275
MidAmerica Nazarene University,1311,998,Kansas,Suburb,NA,90.25,52.63,99.96,2,1,5,1,0,2,3,1,7,0.34272078454335003,1.978369589313018
Middle Tennessee State University,19520,15812,Tennessee,Midsize City,public,100.0,100.0,100.0,29,8,94,14,3,47,43,11,141,39.01012776290802,4.485164140557968
Middlebury College,2547,2528,Vermont,Town,NA,99.98,97.03,100.0,6,2,18,3,1,8,9,3,26,0.0002825528040394083,8.542471602253226
Midland University,1660,1187,Nebraska,Town,NA,94.16,66.35,99.94,2,1,5,1,0,3,3,1,8,0.13876017765612758,2.6879747196289268
Midway University,1003,760,Kentucky,Rural,private,92.63,59.51,99.94,2,1,5,1,0,3,3,1,8,2.191634531048745,0.4116777656838195
Midwestern State University,5328,4199,Texas,Midsize City,public,100.0,100.0,100.0,21,8,50,9,3,21,30,11,71,29.174609912831833,0.8263510442480745
Miles College,1654,1555,Alabama,Suburb,private,99.9,91.55,100.0,5,2,12,2,1,6,7,3,18,3.787731109552647,3.0510389541517875
Millersville University of Pennsylvania,6756,5671,Pennsylvania,Suburb,NA,100.0,99.88,100.0,9,4,18,4,2,10,13,6,28,11.4965577630145,1.5788444746164823
Millikin University,1951,1840,Illinois,Small City,private,92.23,70.55,99.84,2,1,4,1,0,2,3,1,6,1.9331862522744625,0.6194652080831756
Mills College,764,739,California,Large City,private,98.35,84.04,100.0,3,1,7,1,1,3,4,2,10,3.5886804896480795,0.5034733493177388
Millsaps College,808,797,Mississippi,Midsize City,NA,99.88,93.63,100.0,4,2,10,2,1,5,6,3,15,4.095337799923348,2.6176431787879917
Milwaukee School of Engineering,2607,2508,Wisconsin,Large City,private,87.99,62.18,99.77,1,1,4,1,0,2,2,1,6,0.7171072941800762,1.3990065965373026
Minnesota State University - Mankato,12781,10832,Minnesota,Small City,NA,99.91,94.51,100.0,5,2,12,2,1,6,7,3,18,3.655219057470928,3.3573746056011964
Minnesota State University - Moorhead,5126,4157,Minnesota,Suburb,NA,100.0,98.23,100.0,13,3,49,8,1,28,21,4,77,1.1757020772661144,19.80206971482423
Minot State University,2959,1952,North Dakota,Town,public,100.0,99.92,100.0,29,5,127,16,2,65,45,7,192,39.7122738438163,5.101817934956074
Misericordia University,2148,1660,Pennsylvania,Suburb,private,99.37,91.85,100.0,3,2,7,2,1,4,5,3,11,2.8265468463238617,2.232227475182939
Mississippi College,3246,2793,Mississippi,Suburb,private,100.0,100.0,100.0,23,10,51,12,5,27,35,15,78,28.084253588216068,6.627677949053427
Mississippi State University,18312,16803,Mississippi,Town,public,100.0,100.0,100.0,123,52,274,63,26,143,186,78,417,163.23040098568654,22.260072097546818
Mississippi University for Women,2577,2113,Mississippi,Town,NA,100.0,100.0,100.0,20,9,43,10,4,22,30,13,65,27.528264019352303,2.316193323595348
Mississippi Valley State University,1974,1667,Mississippi,Town,public,100.0,99.99,100.0,15,6,32,8,3,17,23,9,49,20.775024865836322,1.4662507725806178
Missouri Baptist University,4507,1519,Missouri,Suburb,NA,99.92,91.22,100.0,5,2,14,2,1,7,7,3,21,4.26635790845403,2.8008329642774186
Missouri Southern State University,6025,4358,Missouri,Small City,NA,99.98,93.26,100.0,6,2,17,3,1,9,9,3,26,5.9090382703959365,2.5871868403681786
Missouri State University - Springfield,20365,15363,Missouri,Midsize City,NA,100.0,99.96,100.0,17,5,53,8,3,27,25,8,80,21.367525044880818,4.176903143252744
Missouri Valley College,1793,1296,Missouri,Town,NA,97.6,73.45,100.0,2,1,7,1,0,4,3,1,11,1.5573762589357998,2.1613847264460757
Missouri Western State University,5290,3498,Missouri,Small City,NA,99.8,84.39,100.0,4,1,13,2,1,7,6,2,20,5.703847319921789,0.48678160492617484
Mitchell College,706,575,Connecticut,Small City,NA,74.54,48.79,94.95,1,0,2,0,0,1,1,0,3,0.1258083714989067,1.2392061815580229
Molloy College,3534,2800,New York,Suburb,private,99.98,98.96,100.0,6,3,12,3,2,6,9,5,18,8.728742555827646,0.04983471800140937
Monmouth College,1035,1016,Illinois,Town,NA,71.75,45.92,95.96,1,0,2,0,0,1,1,0,3,1.1085882225432315,0.1543814451098773
Monmouth University,4708,4502,New Jersey,Suburb,NA,100.0,100.0,100.0,16,7,38,8,3,20,24,10,58,21.51198660394171,2.0136243521527564
MontaNA State University,14652,12403,MontaNA,Town,NA,100.0,99.96,100.0,153,5,1647,49,3,445,202,8,2092,182.34182467486465,19.352754622267025
MontaNA State University - Billings,4022,2400,MontaNA,Midsize City,public,100.0,37.36,100.0,58,0,666,18,0,177,76,0,843,74.96664677774162,1.195043827242295
MontaNA State University - Northern,1164,855,MontaNA,Town,NA,100.0,24.86,100.0,17,0,187,5,0,50,22,0,237,21.02119236833206,0.5876931439502168
MontaNA Tech of the University of MontaNA,1657,1529,MontaNA,Town,NA,100.0,43.8,100.0,23,0,252,7,0,68,30,0,320,28.097020614002226,1.8017237618811095
Montclair State University,16852,14944,New Jersey,Suburb,NA,100.0,100.0,100.0,61,27,149,31,13,77,92,40,226,90.83207934390215,1.3119051656051033
Montreat College,757,543,North CaroliNA,Suburb,NA,86.82,51.55,99.51,1,0,3,1,0,2,2,0,5,0.5415649983946835,1.4753392418581843
Moravian College,2083,1886,Pennsylvania,Small City,private,99.87,95.4,100.0,4,2,10,2,1,5,6,3,15,2.1720353572135895,4.434830525970872
Morehead State University,9660,5835,Kentucky,Town,NA,100.0,99.98,100.0,16,6,44,8,3,23,24,9,67,18.818577428674338,5.254360211144366
Morehouse College,2202,2090,Georgia,Large City,private,99.97,94.17,100.0,5,2,15,3,1,8,8,3,23,1.6172789522828612,6.465305453541275
Morgan State University,6436,5825,Maryland,Large City,public,100.0,99.97,100.0,12,6,29,7,3,16,19,9,45,11.308096958059698,7.748941871312943
Morningside College,1322,1252,Iowa,Small City,NA,93.46,47.78,100.0,2,0,6,1,0,4,3,0,10,2.161569003439347,0.561141502688995
Morris College,745,731,South CaroliNA,Small City,private,100.0,99.32,100.0,8,3,19,4,2,9,12,5,28,11.841315301661213,0.48711170266359355
Mount Aloysius College,1689,999,Pennsylvania,Town,NA,96.32,81.32,99.92,2,1,5,1,1,2,3,2,7,2.8664339730840447,0.4304892490063269
Mount Holyoke College,2213,2161,Massachusetts,Suburb,NA,99.98,97.69,100.0,6,2,14,3,1,7,9,3,21,1.96149591464463,6.640219690039906
Mount Marty College,875,457,South Dakota,Town,private,86.45,59.76,98.57,1,1,3,1,0,1,2,1,4,1.594316187350456,0.401695685934335
Mount Mary University,700,624,Wisconsin,Large City,private,25.36,15.02,44.46,0,0,0,0,0,0,0,0,0,0.2730124202480446,0.019388888665879567
Mount Mercy University,1517,1083,Iowa,Midsize City,NA,98.52,54.96,100.0,3,1,11,1,0,6,4,1,17,3.9927427446949597,0.2154812724557435
University of Mount Olive,3206,1472,North CaroliNA,Town,private,99.54,86.3,100.0,4,1,9,2,1,5,6,2,14,2.8374814372612795,2.5251988760381052
Mount Saint Mary College,2036,1737,New York,Suburb,private,99.42,92.62,100.0,3,2,7,2,1,4,5,3,11,4.001602261054603,1.1323806129239877
Mount Saint Mary's University,2603,2056,California,Large City,NA,100.0,99.89,100.0,10,5,24,5,2,13,15,7,37,14.945937854745214,0.1878917497900806
Mount St Mary's University,1815,1696,Maryland,Town,private,99.72,91.44,100.0,4,2,9,2,1,5,6,3,14,2.193054916074886,3.662446793395244
Mount Vernon Nazarene University,1829,1440,Ohio,Town,NA,97.48,76.34,99.99,2,1,6,1,0,3,3,1,9,3.137539736536565,0.5405150738663723
Muhlenberg College,2369,2279,Pennsylvania,Midsize City,NA,99.97,97.75,100.0,5,3,13,3,1,7,8,4,20,0.8376296619638385,7.366625327647435
Murray State University,8559,6584,Kentucky,Town,NA,100.0,99.9,100.0,13,5,37,7,2,19,20,7,56,13.889212000516192,5.8620999439279755
Muskingum University,1559,1363,Ohio,Town,NA,96.14,72.45,99.95,2,1,5,1,0,3,3,1,8,2.729737619038964,0.5207796144182856
Naropa University,391,368,Colorado,Midsize City,NA,75.8,38.4,99.57,1,0,4,0,0,2,1,0,6,0.04419687458307316,1.3679992728764885
NatioNAl Louis University,1883,1250,Illinois,Large City,NA,88.34,66.69,99.48,1,1,3,1,0,2,2,1,5,2.1476045504618364,0.0
NatioNAl University,7881,2899,California,Large City,private,100.0,100.0,100.0,32,14,78,16,7,40,48,21,118,42.159605554663024,5.289542123014117
Nazareth College,2195,2099,New York,Suburb,NA,99.58,93.99,100.0,4,2,7,2,1,4,6,3,11,5.110957343327166,0.3430181949355081
Nebraska Wesleyan University,1776,1566,Nebraska,Large City,NA,57.99,29.12,89.54,1,0,1,0,0,1,1,0,2,0.19482748191201676,0.6702736406500253
Neumann University,2085,1462,Pennsylvania,Suburb,private,99.39,91.62,100.0,3,2,8,2,1,4,5,3,12,2.5056367810260274,2.592085364270449
Nevada State College,4217,1708,Nevada,Rural,public,100.0,99.96,100.0,22,6,66,8,2,23,30,8,89,30.26759549223053,0.11544633657112573
New College of Florida,836,835,Florida,Small City,NA,100.0,98.72,100.0,7,3,16,4,1,9,11,4,25,9.83907231628513,0.6379407367744362
New England College,1841,1811,New Hampshire,Rural,NA,97.72,79.71,99.98,2,1,6,1,1,3,3,2,9,0.30417469929554597,3.4676651594288126
New Jersey City University,6508,5210,New Jersey,Large City,NA,100.0,100.0,100.0,24,11,58,12,5,30,36,16,88,35.80901347945716,0.08465019379747517
New Jersey Institute of Technology,8479,6380,New Jersey,Large City,public,100.0,100.0,100.0,31,14,74,15,7,39,46,21,113,44.740502383487524,1.1883312803795136
New Mexico Highlands University,1933,1315,New Mexico,Town,public,99.97,88.26,100.0,6,1,19,3,1,10,9,2,29,4.723187273367023,3.48684936552363
New Mexico Institute of Mining and Technology,1471,1294,New Mexico,Town,NA,99.65,68.95,100.0,4,1,15,2,0,8,6,1,23,4.625114447923355,1.0217368939703946
New Mexico State University - Main Campus,11711,9703,New Mexico,Suburb,public,100.0,100.0,100.0,33,8,118,16,4,62,49,12,180,35.98488111179045,12.75182330653066
New York Institute of Technology,3663,3234,New York,Suburb,NA,100.0,99.35,100.0,7,3,14,3,2,7,10,5,21,8.037871868430223,1.9418561887345036
New York University,26418,25347,New York,Large City,NA,100.0,100.0,100.0,71,32,165,36,16,87,107,48,252,19.334474291036102,88.0957104190354
Newberry College,1177,1158,South CaroliNA,Town,private,100.0,99.97,100.0,14,6,31,6,2,15,20,8,46,18.848242372726858,1.2187767924066295
Newman University,2811,1013,Kansas,Large City,private,95.48,67.18,99.94,2,1,5,1,0,2,3,1,7,1.2879206778081485,1.803829298386471
Niagara University,2998,2827,New York,Suburb,private,99.96,98.11,100.0,5,3,11,3,1,6,8,4,17,6.64622553754366,1.2267878417621323
Nicholls State University,5684,4662,LouisiaNA,Small City,public,100.0,100.0,100.0,22,8,57,11,4,30,33,12,87,32.05707253979713,1.1563328660469896
Nichols College,1339,1232,Massachusetts,Suburb,private,99.22,89.24,100.0,3,1,7,2,1,4,5,2,11,3.4978607404928916,1.34689500809025
Norfolk State University,4684,4011,Virginia,Midsize City,NA,100.0,100.0,100.0,21,6,46,12,3,28,33,9,74,30.27867988451607,3.3137758098782335
North CaroliNA A & T State University,10339,9347,North CaroliNA,Large City,NA,100.0,99.85,100.0,12,4,29,6,2,15,18,6,44,8.903408362190314,8.553620888792462
North CaroliNA Central University,6355,5363,North CaroliNA,Large City,NA,100.0,98.07,100.0,7,3,17,4,1,9,11,4,26,5.2810067523017485,5.2251319230466216
North CaroliNA State University,24149,21384,North CaroliNA,Large City,NA,100.0,100.0,100.0,23,9,59,12,4,31,35,13,90,21.76233566293185,13.267930542587854
North CaroliNA Wesleyan College,2090,1754,North CaroliNA,Small City,NA,99.96,92.8,100.0,5,2,11,3,1,6,8,3,17,1.2317362302346855,6.461250717233277
North Central College,2772,2634,Illinois,Midsize City,NA,96.76,81.51,99.98,2,1,6,1,1,3,3,2,9,2.9003496398430433,0.5273894949035505
North Central University,1081,912,Minnesota,Large City,NA,81.14,40.36,99.4,1,0,3,1,0,2,2,0,5,0.19817452721227924,1.4638398207126668
North Dakota State University - Main Campus,11981,10782,North Dakota,Midsize City,NA,100.0,100.0,100.0,48,9,179,27,4,102,75,13,281,69.03602365119083,5.330155738077894
North Greenville University,2359,2080,South CaroliNA,Rural,NA,100.0,100.0,100.0,26,11,59,12,5,29,38,16,88,36.248125518473664,1.5826028192185726
North Park University,2033,1812,Illinois,Large City,NA,97.23,79.88,99.99,2,1,6,1,1,3,3,2,9,1.4439019441766783,2.136016668718018
Northcentral University,90,14,California,Large City,NA,31.84,12.08,67.76,0,0,1,0,0,0,0,0,1,0.0,0.38186164766515834
Northeastern Illinois University,7113,4164,Illinois,Large City,NA,99.97,98.44,100.0,5,3,13,3,1,7,8,4,20,8.10455546233766,0.01922992273780008
Northeastern State University,6830,4753,Oklahoma,Town,NA,100.0,99.9,100.0,15,5,45,8,2,26,23,7,71,22.3194701793139,1.210546857650672
Northeastern University,13824,13786,Massachusetts,Large City,private,100.0,100.0,100.0,32,15,72,17,7,39,49,22,111,18.37323962966483,30.41760319497284
Northern ArizoNA University,27092,21990,ArizoNA,Small City,NA,100.0,100.0,100.0,90,46,194,45,23,98,135,69,292,93.51030597996233,42.15949083824399
Northern Illinois University,13456,11788,Illinois,Suburb,public,100.0,99.97,100.0,11,5,26,5,3,14,16,8,40,14.890666495395505,1.2437073247838932
Northern Kentucky University,12326,8962,Kentucky,Suburb,public,100.0,100.0,100.0,19,7,51,10,3,27,29,10,78,20.009840740479223,8.474729225294514
Northern Michigan University,7018,6207,Michigan,Town,NA,100.0,99.94,100.0,14,5,38,7,2,22,21,7,60,18.769847226350443,2.3597278416719423
Northern State University,3164,1346,South Dakota,Town,NA,100.0,98.31,100.0,7,3,20,4,1,10,11,4,30,5.960986810608722,4.810842002193549
Northland College,631,594,Wisconsin,Town,private,52.57,28.33,83.81,0,0,1,0,0,1,0,0,2,0.11352200197722499,0.6310716961460601
Northwest Christian University,604,444,Oregon,Midsize City,NA,82.0,56.02,97.96,1,1,3,1,0,1,2,1,4,0.8049525167028942,0.9066011077049332
Northwest Missouri State University,5478,4806,Missouri,Town,NA,99.92,85.82,100.0,5,1,16,2,1,8,7,2,24,4.666364986063743,2.4997956738799796
Northwest Nazarene University,1482,1125,Idaho,Suburb,NA,99.99,89.46,100.0,6,1,24,3,1,12,9,2,36,5.039934722640299,3.8986961698329123
Northwest University,946,929,Washington,Suburb,NA,99.66,90.86,100.0,4,2,15,2,1,6,6,3,21,3.8446661318049333,1.8083229823676692
Northwestern College - 2,1039,997,Iowa,Town,private,93.71,55.61,99.99,2,1,6,1,0,3,3,1,9,1.402779884356364,1.3567652931575316
University of Northwestern - St Paul,3325,2033,Minnesota,Suburb,NA,96.91,68.76,100.0,2,1,8,1,0,4,3,1,12,0.7593353938302146,2.703485471208576
Northwestern Oklahoma State University,1881,1329,Oklahoma,Town,NA,99.84,86.31,100.0,4,1,12,2,1,7,6,2,19,5.043424349086621,1.3877698894575143
Northwestern State University of LouisiaNA,9440,5471,LouisiaNA,Town,public,100.0,100.0,100.0,37,14,95,19,7,50,56,21,145,49.45881552622,6.2175830875242735
Northwestern University,8699,8205,Illinois,Small City,NA,100.0,100.0,100.0,19,8,45,10,4,24,29,12,69,2.806826765101742,25.57554628481034
Norwich University,3229,2542,Vermont,Town,private,100.0,98.67,100.0,7,3,15,3,1,8,10,4,23,0.0007587909979445399,10.133583418743711
Notre Dame College,1736,1216,Ohio,Suburb,NA,96.69,73.54,99.97,2,1,5,1,0,3,3,1,8,3.3092458912723965,0.0952706783905003
Notre Dame de Namur University,922,718,California,Suburb,private,99.41,89.87,100.0,3,2,8,2,1,4,5,3,12,4.78293659987693,0.329278876772356
Nova Southeastern University,4501,3154,Florida,Suburb,NA,100.0,100.0,100.0,38,16,86,20,8,47,58,24,133,50.47162133889249,7.175814772825566
Nyack College,1397,1131,New York,Suburb,NA,98.25,85.77,99.99,3,1,6,1,1,3,4,2,9,2.2409963157514947,1.7985564150731443
Oakland City University,1112,572,IndiaNA,Town,NA,94.95,77.52,99.85,2,1,4,1,1,2,3,2,6,2.807568719718812,0.17371237330469189
Oakland University,15902,12549,Michigan,Suburb,NA,100.0,100.0,100.0,36,12,100,19,6,57,55,18,157,53.78888253076046,0.8398183370091143
Oakwood University,1648,1521,Alabama,Midsize City,private,99.96,95.8,100.0,5,2,13,3,1,7,8,3,20,1.1040471843987536,6.703489362227674
Oberlin College,2828,2790,Ohio,Town,NA,100.0,98.57,100.0,7,3,17,3,1,9,10,4,26,0.3980460859785194,9.66052274141936
Occidental College,1976,1952,California,Large City,private,99.98,98.1,100.0,6,3,14,3,1,7,9,4,21,5.640199649298629,3.100093473183374
Oglethorpe University,1253,1166,Georgia,Suburb,NA,98.89,70.68,100.0,3,1,10,2,0,6,5,1,16,2.2020439592353633,2.2841785719525145
Ohio Christian University,3988,2429,Ohio,Town,NA,100.0,98.34,100.0,7,3,16,4,1,9,11,4,25,6.023373859880831,4.3384612019362105
Ohio Dominican University,1176,957,Ohio,Large City,NA,93.1,65.39,99.83,2,1,4,1,0,2,3,1,6,2.078034713564329,0.5909522826745709
Ohio Northern University,2315,2092,Ohio,Town,private,99.51,88.09,100.0,4,1,8,2,1,4,6,2,12,3.59021959902194,1.7201074680499986
Ohio State University - Lima Campus,1007,844,Ohio,Rural,public,86.05,53.77,99.05,1,1,3,1,0,2,2,1,5,1.9570599227277206,0.010773716374618776
Ohio State University - Main Campus,45943,42003,Ohio,Large City,NA,100.0,100.0,100.0,68,27,159,35,13,85,103,40,244,75.60143944766526,26.98576659686105
Ohio State University - Newark Campus,2605,2218,Ohio,Suburb,NA,99.39,86.38,100.0,3,1,8,2,1,4,5,2,12,5.045819501668879,0.04146062891696095
Ohio University - Main Campus,23167,17695,Ohio,Town,public,100.0,100.0,100.0,31,13,73,16,6,39,47,19,112,40.95191790449591,6.318672365321138
Ohio Valley University,528,435,West Virginia,Small City,NA,67.97,36.84,93.28,1,0,2,0,0,1,1,0,3,0.03628526915727455,1.097642788339783
Ohio Wesleyan University,1557,1545,Ohio,Suburb,private,98.48,81.24,100.0,3,1,7,1,1,4,4,2,11,1.4926728224194479,2.685620738129985
Oklahoma Baptist University,1962,1835,Oklahoma,Town,NA,99.92,89.97,100.0,5,2,13,2,1,7,7,3,20,4.2469134920491145,2.8798009312319968
Oklahoma Christian University,1976,1846,Oklahoma,Large City,NA,99.94,92.16,100.0,5,2,14,2,1,7,7,3,21,2.712256797670817,4.749928807211648
Oklahoma City University,1715,1579,Oklahoma,Large City,NA,99.85,88.88,100.0,4,1,12,2,1,6,6,2,18,2.9113845119301933,3.569409290533617
Oklahoma Panhandle State University,1136,852,Oklahoma,Rural,public,98.83,78.78,100.0,3,1,8,1,1,4,4,2,12,1.78871619188164,2.6432124922637583
Oklahoma State University - Main Campus,20992,18221,Oklahoma,Town,NA,100.0,100.0,100.0,53,17,146,27,8,78,80,25,224,50.47887556475193,29.180526876599878
Oklahoma Wesleyan University,1005,609,Oklahoma,Town,NA,97.31,71.67,99.99,2,1,6,1,0,3,3,1,9,1.8127488470508752,1.7951011814417759
Old Dominion University,19543,15036,Virginia,Midsize City,public,100.0,100.0,100.0,99,29,213,57,16,128,156,45,341,151.76203858000113,4.2500545381495884
Olivet College,1178,1032,Michigan,Rural,private,98.29,74.65,100.0,3,1,7,1,0,4,4,1,11,3.960547209933275,0.09941582604158981
Olivet Nazarene University,3377,3113,Illinois,Suburb,NA,99.85,94.19,100.0,4,2,11,2,1,6,6,3,17,2.3118398426904636,4.1641113802480785
Oral Roberts University,3384,2866,Oklahoma,Large City,private,100.0,99.12,100.0,9,3,28,5,2,13,14,5,41,3.6426638763654897,10.286505963749523
Oregon Institute of Technology,5380,2284,Oregon,Town,NA,100.0,99.65,100.0,8,4,22,4,2,10,12,6,32,8.869247454680513,2.793063136650516
Oregon State University,25835,18829,Oregon,Small City,NA,100.0,100.0,100.0,44,22,106,24,11,56,68,33,162,36.252402793527594,31.574995326377337
Ottawa University - Online,156,85,Kansas,Town,NA,29.26,12.93,54.31,0,0,1,0,0,0,0,0,1,0.029752054751676464,0.315551338975372
Ottawa University - Ottawa,669,646,Kansas,Town,NA,56.25,26.51,86.51,1,0,1,0,0,1,1,0,2,0.26090263397623975,0.5642891740646894
Otterbein University,2483,2294,Ohio,Suburb,private,99.51,87.83,100.0,4,1,8,2,1,4,6,2,12,4.3765557394598975,0.9266052613563688
Ouachita Baptist University,1542,1500,Arkansas,Town,private,98.97,79.86,100.0,3,1,8,1,0,4,4,1,12,0.9668749187565472,3.5988499399772023
University of Holy Cross,912,457,LouisiaNA,Large City,private,99.5,85.62,100.0,3,1,9,2,1,5,5,2,14,5.224028955628625,0.061562909998962814
Our Lady of the Lake University,1344,1221,Texas,Large City,NA,99.95,94.61,100.0,5,2,13,2,1,5,7,3,18,7.446167783106971,0.2006720634491252
Pace University - New York,8670,7878,New York,Large City,NA,100.0,100.0,100.0,18,9,39,9,4,21,27,13,60,13.245402533651653,13.434520166194366
Pacific Lutheran University,2764,2655,Washington,Suburb,NA,100.0,99.91,100.0,10,5,34,5,3,15,15,8,49,11.453421560317093,3.732653204763033
Pacific Union College,1227,1077,California,Rural,NA,99.91,95.37,100.0,5,2,11,2,1,6,7,3,17,6.184118273759293,0.8042260472792017
Pacific University,1876,1818,Oregon,Suburb,NA,99.68,91.39,100.0,4,2,13,2,1,6,6,3,19,1.4234366751787417,4.302595248249097
Paine College,425,328,Georgia,Midsize City,NA,81.81,39.77,99.68,1,0,4,1,0,2,2,0,6,0.7658219547118541,0.9304184939707157
Palm Beach Atlantic University,3005,2350,Florida,Midsize City,NA,100.0,100.0,100.0,19,8,45,10,4,25,29,12,70,26.311727325450278,3.5113311280442456
Park University,9864,4134,Missouri,Suburb,NA,100.0,98.75,100.0,9,3,27,4,1,14,13,4,41,9.375382023630541,4.025283062514953
Paul Quinn College,518,492,Texas,Large City,private,94.4,66.73,99.9,2,1,5,1,0,2,3,1,7,2.257796663177918,0.6145501741064874
Paul Smiths College of Arts and Science,768,760,New York,Rural,private,82.46,57.62,97.59,1,1,2,1,0,1,2,1,3,1.1861184919833878,0.5517393493604634
William Peace University,932,814,North CaroliNA,Large City,NA,72.91,38.51,96.4,1,0,2,0,0,1,1,0,3,0.8597219679856671,0.4437770634357361
Peirce College,1388,307,Pennsylvania,Large City,NA,92.75,74.01,99.66,2,1,4,1,0,2,3,1,6,2.320705556956089,0.30026758273765913
Pennsylvania State University - Brandywine,1439,1245,Pennsylvania,Suburb,NA,94.19,76.68,99.79,2,1,4,1,0,2,3,1,6,2.4367408348038935,0.40460220596400437
Pennsylvania State University - University Park,40833,39785,Pennsylvania,Small City,NA,100.0,100.0,100.0,72,34,162,37,17,86,109,51,248,47.64879901747108,61.73906703146938
Pennsylvania State University - Abington,3891,3312,Pennsylvania,Suburb,NA,99.97,98.27,100.0,5,3,11,3,1,6,8,4,17,6.487097252178818,1.5367303392523914
Pennsylvania State University - AltooNA,3478,3374,Pennsylvania,Small City,NA,99.97,98.11,100.0,5,3,12,3,1,6,8,4,18,5.129121891116231,2.908843601074542
Pennsylvania State University - Beaver,652,563,Pennsylvania,Suburb,NA,73.77,49.07,94.59,1,0,2,0,0,1,1,0,3,1.0370652957647524,0.29908485023848785
Pennsylvania State University - Berks,2718,2411,Pennsylvania,Suburb,public,99.64,94.2,100.0,4,2,8,2,1,4,6,3,12,4.441975480111265,1.1768070823515522
Pennsylvania State University - Erie - Behrend College,4341,4138,Pennsylvania,Suburb,NA,99.99,98.85,100.0,6,3,12,3,2,7,9,5,19,6.958490568435524,1.8533178082236348
Pennsylvania State University - Greater Allegheny,497,453,Pennsylvania,Suburb,public,63.52,39.73,88.75,1,0,1,0,0,1,1,0,2,0.8068077912855154,0.2002719837325695
Pennsylvania State University - Harrisburg,4288,3960,Pennsylvania,Suburb,public,100.0,99.41,100.0,7,3,16,4,2,9,11,5,25,5.564254183045498,5.4749580139525476
Pennsylvania State University - Lehigh Valley,899,739,Pennsylvania,Suburb,public,84.15,60.9,98.14,1,1,3,1,0,1,2,1,4,1.5664762509453602,0.27216496450654487
Pennsylvania State University - New Kensington,597,484,Pennsylvania,Rural,NA,67.62,43.62,91.34,1,0,2,0,0,1,1,0,3,1.0551958079284718,0.07120144042877974
Pennsylvania State University - Schuylkill,733,595,Pennsylvania,Town,NA,81.3,56.46,97.41,1,1,2,1,0,1,2,1,3,1.0008042714373135,0.673040890113656
Pennsylvania State University - SheNAngo,490,241,Pennsylvania,Suburb,NA,59.24,36.54,85.63,1,0,1,0,0,1,1,0,2,0.7796120230399362,0.1170723782289763
Pennsylvania State University - Wilkes - Barre,456,387,Pennsylvania,Rural,NA,58.57,36.57,84.97,1,0,1,0,0,1,1,0,2,0.7832381254726801,0.09689479810593929
Pennsylvania State University - Worthington Scranton,1030,904,Pennsylvania,Suburb,public,85.03,62.74,98.26,1,1,3,1,0,1,2,1,4,1.8402469846175238,0.057091637445080654
Pennsylvania State University - York,966,793,Pennsylvania,Suburb,NA,85.66,62.33,98.53,1,1,3,1,0,1,2,1,4,1.5501587899980127,0.3895875101057817
Pepperdine University,3603,3300,California,Suburb,NA,100.0,99.95,100.0,12,5,29,6,3,15,18,8,44,11.729723379673459,5.980409698666558
Peru State College,2046,1105,Nebraska,Rural,public,76.09,43.72,97.89,1,0,2,0,0,1,1,0,3,0.19405943664823747,1.233327555839039
Pfeiffer University,812,733,North CaroliNA,Rural,NA,91.58,61.49,99.76,2,1,4,1,0,2,3,1,6,0.591432861966938,1.8698395096946208
Cairn University,770,727,Pennsylvania,Suburb,private,87.25,61.68,99.08,1,1,3,1,0,2,2,1,5,0.7977425352036557,1.2575870835377787
Thomas Jefferson University,2690,2279,Pennsylvania,Large City,private,99.97,97.77,100.0,5,3,12,3,1,7,8,4,19,2.235492149786608,5.978577642179682
Philander Smith College,893,845,Arkansas,Midsize City,private,81.55,45.51,98.78,1,0,3,1,0,1,2,0,4,0.3872136964804398,1.2992511411364966
Piedmont College,1281,1160,Georgia,Town,NA,96.55,45.22,100.0,2,0,9,1,0,5,3,0,14,2.9972265000703557,0.3643244958091812
University of Pikeville,1562,1049,Kentucky,Town,NA,99.1,80.42,100.0,3,1,8,2,1,4,5,2,12,2.875463166425586,1.8239448142976613
Pine Manor College,419,417,Massachusetts,Suburb,NA,79.02,51.75,96.73,1,0,2,1,0,1,2,0,3,1.3722052965110503,0.1860598640380482
Pittsburg State University,5709,5109,Kansas,Town,NA,99.39,82.64,100.0,3,1,8,2,1,4,5,2,12,2.3927517879136726,2.705678128448811
Pitzer College,1070,1046,California,Suburb,NA,98.77,86.3,100.0,3,1,7,1,1,4,4,2,11,2.5244918765728666,1.8631309137646352
Platt College - Aurora,236,236,Colorado,Large City,private,16.73,4.86,47.39,0,0,0,0,0,0,0,0,0,0.1829905684492152,0.0
Plymouth State University,4148,3971,New Hampshire,Town,NA,99.88,92.81,100.0,4,2,10,2,1,6,6,3,16,1.0282635274928047,5.667713461798216
Point Loma Nazarene University,3097,2571,California,Large City,private,100.0,99.95,100.0,11,5,27,6,3,14,17,8,41,14.869079788245338,2.0288025812894404
Point Park University,3282,2758,Pennsylvania,Large City,private,99.98,98.13,100.0,6,3,13,3,1,7,9,4,20,3.86905129573773,4.849360912200608
PomoNA College,1600,1578,California,Suburb,private,99.87,94.61,100.0,4,2,11,2,1,6,6,3,17,3.0684105010335307,3.5773300119750364
Portland State University,21163,13990,Oregon,Large City,NA,100.0,100.0,100.0,34,16,94,18,9,45,52,25,139,30.861436397260505,21.385784534948844
Post University,7845,2617,Connecticut,Suburb,private,100.0,99.99,100.0,15,6,38,7,3,19,22,9,57,1.1869267934998895,20.79315336080069
University of the Potomac - VA Campus,37,37,Virginia,Suburb,NA,26.75,8.39,49.51,0,0,0,0,0,0,0,0,0,0.30999201874020327,0.0
Prairie View A & M University,7977,7341,Texas,Town,NA,100.0,100.0,100.0,31,12,73,13,5,31,44,17,104,41.64380512083715,2.8879627459952335
Pratt Institute - Main,3642,3537,New York,Large City,NA,100.0,99.79,100.0,9,4,23,5,2,12,14,6,35,2.4316667205170917,11.80928943141577
Presbyterian College,1014,975,South CaroliNA,Town,NA,100.0,99.7,100.0,10,4,23,5,2,11,15,6,34,13.250529684668829,1.270829944362593
Prescott College,386,291,ArizoNA,Small City,NA,76.03,44.14,98.93,1,0,3,0,0,1,1,0,4,0.21282284876766108,1.2107251923758826
Presentation College,762,475,South Dakota,Town,private,86.33,51.63,99.46,1,0,3,1,0,2,2,0,5,1.1412245532899357,0.840996715235202
Princeton University,5397,5260,New Jersey,Suburb,private,100.0,99.99,100.0,16,7,40,8,3,20,24,10,60,4.67338911035439,18.960075604483922
Principia College,456,441,Illinois,Rural,private,82.03,52.35,98.4,1,0,3,1,0,1,2,0,4,0.041058823057156725,1.6689995334048229
Providence Christian College,165,161,California,Midsize City,private,55.06,29.03,86.81,1,0,1,0,0,1,1,0,2,0.614864531999012,0.18272054514480593
Providence College,4076,3826,Rhode Island,Midsize City,private,100.0,99.51,100.0,7,4,16,4,2,9,11,6,25,0.20263610141982102,11.124201173215493
Purdue University - Main Campus,32130,30277,IndiaNA,Small City,NA,100.0,100.0,100.0,59,29,132,31,15,71,90,44,203,61.1044530652696,29.13839046449653
Queens University of Charlotte,1717,1449,North CaroliNA,Large City,private,99.39,86.03,100.0,3,1,8,2,1,4,5,2,12,1.0452304204744538,4.030262871507948
Quincy University,992,874,Illinois,Town,NA,95.98,74.58,99.96,2,1,5,1,0,3,3,1,8,0.7162483577748451,2.480435188187811
Quinnipiac University,7311,6959,Connecticut,Suburb,private,100.0,99.99,100.0,14,6,30,7,3,16,21,9,46,0.6041002561478115,20.132813149840125
Radford University,8419,8049,Virginia,Small City,NA,100.0,100.0,100.0,43,12,92,25,7,55,68,19,147,65.85235857562155,1.4224770629976466
Ramapo College of New Jersey,5616,4910,New Jersey,Suburb,NA,100.0,100.0,100.0,20,9,50,10,4,26,30,13,76,30.338268881080214,0.2860240008784967
Randolph College,666,645,Virginia,Small City,NA,98.63,73.72,99.99,3,1,6,2,0,3,5,1,9,3.3847777181362733,0.8877835657535413
Randolph - Macon College,1452,1428,Virginia,Suburb,private,100.0,94.89,100.0,6,2,14,4,1,8,10,3,22,8.788692639418196,1.1477675661230216
Reed College,1446,1408,Oregon,Large City,NA,99.82,93.25,100.0,4,2,11,2,1,6,6,3,17,0.18462213685846196,6.105210508723105
Regent University,4280,2263,Virginia,Large City,NA,100.0,99.97,100.0,16,5,37,9,3,21,25,8,58,15.935265395780178,8.989667920180484
Regis University,4084,2378,Colorado,Large City,NA,99.93,92.49,100.0,5,2,15,2,1,7,7,3,22,2.0128962529413674,5.266334266069905
Reinhardt University,1408,1260,Georgia,Rural,NA,97.6,48.81,100.0,2,0,10,1,0,6,3,0,16,3.3324265249761833,0.39236249647005395
Rensselaer Polytechnic Institute,6366,6340,New York,Small City,NA,100.0,99.98,100.0,13,6,28,6,3,15,19,9,43,5.234769294473657,13.768218007312914
Rhode Island College,7079,5461,Rhode Island,Suburb,public,99.89,97.37,100.0,4,2,9,2,1,5,6,3,14,2.751026310228142,4.01532947053899
Rhodes College,1984,1979,Tennessee,Large City,NA,99.98,95.3,100.0,6,2,14,3,1,7,9,3,21,1.1140946068725752,7.264798422963711
Rice University,4004,3916,Texas,Large City,NA,100.0,99.97,100.0,14,6,34,7,3,16,21,9,50,12.041582203615562,8.801193920854752
Rider University,4092,3711,New Jersey,Suburb,private,100.0,99.98,100.0,13,6,31,6,3,16,19,9,47,16.60603547624741,2.689314175936381
Ripon College,759,739,Wisconsin,Town,NA,50.79,27.3,82.01,0,0,1,0,0,1,0,0,2,0.22064839820925422,0.48686093466182195
Rivier University,1427,908,New Hampshire,Small City,private,94.61,69.98,99.88,2,1,4,1,0,2,3,1,6,0.34243566776039447,2.5721909415340707
Roanoke College,2036,1973,Virginia,Suburb,NA,100.0,97.57,100.0,7,2,16,4,1,9,11,3,25,8.587616735370496,2.917850458929586
Robert Morris University,4245,3840,Pennsylvania,Suburb,NA,99.98,98.49,100.0,5,3,12,3,1,6,8,4,18,6.572310659348299,1.7550361156564946
Roberts Wesleyan College,1322,1248,New York,Suburb,NA,96.26,81.16,99.9,2,1,5,1,1,2,3,2,7,2.731291642291601,0.5514082768866194
Rochester College,1152,762,Michigan,Suburb,NA,97.97,73.43,100.0,3,1,7,1,0,4,4,1,11,3.7142955699374234,0.1749059507829476
Rochester Institute of Technology,13510,12447,New York,Suburb,private,100.0,100.0,100.0,25,12,55,13,6,29,38,18,84,17.35100683366931,20.573982712152883
Rockford University,1059,918,Illinois,Midsize City,NA,78.73,49.94,98.15,1,0,3,1,0,1,2,0,4,0.9318071788249179,0.6135605250385822
Rockhurst University,2208,1445,Missouri,Large City,NA,91.6,55.3,99.94,2,1,5,1,0,2,3,1,7,1.7268317067992807,0.7476248481325664
Rocky Mountain College,898,868,MontaNA,Midsize City,private,100.0,46.56,100.0,9,0,94,3,0,26,12,0,120,10.23210148645015,1.7162237331739456
Roger Williams University,4704,4042,Rhode Island,Suburb,private,100.0,99.66,100.0,8,4,17,4,2,9,12,6,26,0.19009196180811783,11.904232911735328
Rollins College,2614,2453,Florida,Suburb,private,100.0,99.99,100.0,15,6,36,8,3,20,23,9,56,19.989789457067978,3.5288350811829146
Roosevelt University,2576,2117,Illinois,Large City,NA,98.87,86.89,100.0,3,1,7,2,1,4,5,2,11,2.003898669761788,2.473201406487914
Rosemont College,634,520,Pennsylvania,Suburb,NA,79.67,54.06,97.25,1,1,2,1,0,1,2,1,3,0.8883950960222529,0.7015060541896139
Rowan University,15399,13634,New Jersey,Suburb,NA,100.0,100.0,100.0,56,25,136,28,12,70,84,37,206,82.61488806455864,1.1659343214749391
Rust College,862,792,Mississippi,Town,NA,99.52,88.83,100.0,4,1,8,2,1,4,6,2,12,4.041094915156151,1.2652746885751438
Rutgers University - Camden,5489,4493,New Jersey,Small City,NA,100.0,100.0,100.0,20,9,49,10,4,25,30,13,74,28.953971158818845,1.2140614116959783
Rutgers University - New Brunswick,35638,33677,New Jersey,Small City,NA,100.0,100.0,100.0,128,57,310,65,28,161,193,85,471,182.60548113894203,9.6420921573997
Rutgers University - Newark,8549,7162,New Jersey,Large City,NA,100.0,100.0,100.0,31,14,76,16,7,39,47,21,115,45.28314709061398,1.440308643138975
Sacred Heart University,5605,4982,Connecticut,Suburb,NA,100.0,99.91,100.0,10,5,21,5,2,11,15,7,32,0.5718228896991123,14.034983486612704
SagiNAw Valley State University,7850,6559,Michigan,Suburb,public,100.0,99.99,100.0,17,6,49,9,3,28,26,9,77,26.526773886219758,0.18371334170299608
Saint Ambrose University,2369,2215,Iowa,Midsize City,private,98.2,73.75,100.0,3,1,9,1,0,5,4,1,14,2.060770448874818,1.9497365140952378
Saint Anselm College,1965,1926,New Hampshire,Suburb,NA,99.46,90.19,100.0,3,2,7,2,1,4,5,3,11,0.21234837497990944,4.998060272366135
Saint Augustine's University,972,961,North CaroliNA,Large City,private,95.82,69.34,99.95,2,1,5,1,0,3,3,1,8,0.502668064808325,2.6583587613751676
St. BoNAventure University,1621,1586,New York,Town,NA,98.61,88.22,99.99,3,1,6,1,1,3,4,2,9,3.144823559120882,1.1231558894930689
Saint Cloud State University,13133,8373,Minnesota,Small City,NA,99.97,94.72,100.0,5,2,16,3,1,8,8,3,24,3.8473882959798047,4.337985952655498
Saint Edward's University,3941,3528,Texas,Large City,NA,100.0,99.98,100.0,15,6,36,7,3,15,22,9,51,20.662260372113067,1.1446723450094283
Saint Francis University,2119,1526,Pennsylvania,Town,private,98.68,88.63,99.99,3,1,6,1,1,3,4,2,9,3.3468925454226097,0.975448219536613
St. John Fisher College,2746,2624,New York,Suburb,NA,99.89,97.11,100.0,5,2,9,2,1,5,7,3,14,6.64374929852073,0.18834394460445147
Saint Johns University,1724,1703,Minnesota,Rural,NA,73.43,38.96,98.65,1,0,3,0,0,1,1,0,4,0.49109916507824075,0.8305996446332798
University of Saint Joseph,808,654,Connecticut,Small City,NA,48.02,31.03,72.59,0,0,1,0,0,0,0,0,1,0.2560182020589996,0.3974053151688456
St. Joseph's College - New York,928,798,New York,Large City,NA,91.11,71.14,99.32,2,1,3,1,0,2,3,1,5,2.250901271843214,0.16546627676762563
Saint Joseph's College of Maine,1537,960,Maine,Rural,private,91.99,61.02,99.74,2,1,4,1,0,2,3,1,6,0.6623108660752999,1.8583725269424594
Saint Joseph's University,5143,4481,Pennsylvania,Large City,NA,100.0,99.95,100.0,11,5,25,6,3,13,17,8,38,3.471993079352274,13.0685996357127
Saint Leo University,9672,6732,Florida,Suburb,private,100.0,100.0,100.0,72,31,165,38,16,91,110,47,256,102.1453012865619,8.555998079685969
Saint Louis University,9900,6625,Missouri,Large City,NA,100.0,99.87,100.0,11,4,29,6,2,15,17,6,44,3.9332108034707245,12.660231064118262
Saint Martin's University,1318,1121,Washington,Suburb,NA,99.91,97.56,100.0,4,2,10,3,1,6,7,3,16,6.365569972718947,0.5762022461687486
Saint Mary - of - the - Woods College,662,491,IndiaNA,Rural,private,83.66,57.96,98.32,1,1,3,1,0,1,2,1,4,1.3488417234656913,0.45945310885059515
Saint Mary's College,1533,1486,IndiaNA,Suburb,NA,99.06,86.27,100.0,3,1,7,2,1,4,5,2,11,1.1950023415632907,3.4557680828030635
Saint Mary's College of California,2776,2614,California,Suburb,NA,100.0,99.91,100.0,10,5,25,5,2,13,15,7,38,14.526174568476659,1.151506177870775
Saint Mary's University of Minnesota,1501,1129,Minnesota,Town,NA,64.81,37.08,92.71,1,0,2,0,0,1,1,0,3,0.3319590144380772,0.7111728596719149
Saint Michael's College,1790,1766,Vermont,Suburb,private,97.71,81.87,99.98,2,1,5,1,1,3,3,2,8,0.0008180359407269965,3.768793374245644
Saint Norbert College,2068,2021,Wisconsin,Suburb,private,86.25,60.37,99.08,1,1,3,1,0,2,2,1,5,0.5608146787818544,1.4186805753988945
Saint Peter's University,2633,2387,New Jersey,Large City,NA,100.0,99.65,100.0,8,4,20,4,2,10,12,6,30,10.819670997194878,1.7985433997494433
St. Thomas AquiNAs College,1777,1091,New York,Suburb,NA,99.66,93.71,100.0,4,2,8,2,1,4,6,3,12,3.263683032221514,2.4083337621444003
St. Thomas University,2907,935,Florida,Suburb,NA,100.0,100.0,100.0,26,11,60,14,6,33,40,17,93,39.267247886712596,0.8442704401622938
Saint Vincent College,1667,1617,Pennsylvania,Suburb,NA,98.5,86.11,99.99,3,1,6,1,1,3,4,2,9,2.4367408348038935,1.7509499486279814
Saint Xavier University,2942,2638,Illinois,Large City,NA,97.04,82.89,99.98,2,1,6,1,1,3,3,2,9,3.129594735245502,0.3890072979701936
Salem College,817,673,North CaroliNA,Midsize City,private,88.6,53.75,99.63,1,1,4,1,0,2,2,1,6,0.5365782120374581,1.62703728758243
Salem InterNAtioNAl University,892,892,West Virginia,Rural,private,97.01,75.4,99.98,2,1,5,1,0,3,3,1,8,0.024407131720139832,3.469606555339777
Salem State University,7110,5792,Massachusetts,Suburb,NA,100.0,100.0,100.0,19,9,41,10,5,23,29,14,64,28.53850279246908,0.5250128414490643
Salisbury University,7783,7191,Maryland,Suburb,public,100.0,99.99,100.0,14,6,32,7,3,18,21,9,50,16.19835734562898,4.791879758824191
Salve RegiNA University,2180,2087,Rhode Island,Suburb,NA,99.29,90.39,100.0,3,2,7,2,1,4,5,3,11,0.14859980770786876,4.786660409317548
Sam Houston State University,18416,14808,Texas,Town,public,100.0,100.0,100.0,73,28,171,31,12,72,104,40,243,103.77312390530626,0.8425012568403776
Samford University,3375,3266,Alabama,Suburb,private,100.0,99.49,100.0,10,4,27,5,2,14,15,6,41,4.81534425810841,10.296175924454191
San Diego Christian College,656,504,California,Suburb,private,97.19,80.12,99.98,2,1,6,1,1,3,3,2,9,3.1334442496103496,0.42844443005298544
San Diego State University,30267,27060,California,Large City,NA,100.0,100.0,100.0,115,52,279,58,26,146,173,78,425,163.4357223325066,10.094477741149996
San Francisco State University,26676,22263,California,Large City,public,100.0,100.0,100.0,104,47,250,53,23,132,157,70,382,156.3293072607488,0.4836153950070883
San Jose State University,27777,23097,California,Large City,NA,100.0,100.0,100.0,109,49,262,55,24,138,164,73,400,163.80818834708293,0.20914382849863383
Santa Clara University,5498,5411,California,Midsize City,private,100.0,100.0,100.0,18,8,45,9,4,23,27,12,68,19.9239757003526,7.348700541580116
Sarah Lawrence College,1401,1384,New York,Suburb,NA,99.64,90.97,100.0,4,2,9,2,1,5,6,3,14,0.6834419703286326,4.921207523164563
SavanNAh State University,4237,3687,Georgia,Midsize City,NA,100.0,92.93,100.0,8,2,33,4,1,18,12,3,51,9.561764214102,2.9439872395283464
Schreiner University,1249,1137,Texas,Town,NA,99.91,93.16,100.0,5,2,12,2,1,5,7,3,17,6.921629164388869,0.11443359036405099
Scripps College,1064,1060,California,Suburb,NA,99.18,88.48,100.0,3,1,8,2,1,4,5,2,12,2.554052671380511,2.240376115125141
Seattle Pacific University,2898,2783,Washington,Large City,private,100.0,99.91,100.0,9,5,26,5,2,13,14,7,39,9.692242164610041,4.812894109403026
Seattle University,4563,4325,Washington,Large City,private,100.0,100.0,100.0,14,7,39,8,4,20,22,11,59,11.205935566802703,10.56770824098433
Seton Hall University,5972,5554,New Jersey,Suburb,NA,100.0,100.0,100.0,18,8,44,9,4,23,27,12,67,22.65264792708508,5.114205119070377
Seton Hill University,2091,1551,Pennsylvania,Suburb,NA,99.07,89.53,100.0,3,1,7,2,1,4,5,2,11,2.908134151060599,1.7580408613486274
Sewanee - The University of the South,1700,1687,Tennessee,Rural,NA,99.97,94.62,100.0,5,2,13,3,1,7,8,3,20,0.8639488366502424,7.283876463754836
Shaw University,1545,1466,North CaroliNA,Large City,private,98.5,79.57,100.0,3,1,7,1,1,4,4,2,11,0.9883810560020836,3.1965824148987823
Shawnee State University,3408,2832,Ohio,Town,public,99.9,93.02,100.0,5,2,11,2,1,6,7,3,17,6.031178685096096,0.8317416070238808
SheNAndoah University,2060,1991,Virginia,Small City,NA,100.0,98.37,100.0,8,3,18,5,1,11,13,4,29,10.606753938516144,2.501596477356297
Shepherd University,3419,2614,West Virginia,Town,NA,99.77,87.57,100.0,4,1,9,2,1,5,6,2,14,0.3343777045659157,5.726445526521048
Shippensburg University of Pennsylvania,5573,5160,Pennsylvania,Town,NA,100.0,99.6,100.0,7,4,15,4,2,8,11,6,23,9.366222583777466,1.4992816299891922
Shorter University,1402,1140,Georgia,Small City,NA,98.71,63.24,100.0,3,1,11,1,0,6,4,1,17,2.9580790519061715,1.3824041561512468
Shorter University - College of Adult & ProfessioNAl Programs,113,56,Georgia,Small City,NA,24.18,4.09,72.22,0,0,1,0,0,0,0,0,1,0.2764788526595512,0.0
SieNA College,3161,3039,New York,Suburb,NA,99.97,98.36,100.0,5,3,11,3,1,6,8,4,17,6.240122337783168,1.9145080933366592
SieNA Heights University,2301,1290,Michigan,Town,NA,99.96,92.91,100.0,5,2,14,3,1,8,8,3,22,7.233641924878131,0.514879804937378
Sierra Nevada College,452,410,Nevada,Town,private,90.62,58.91,99.94,2,1,5,1,0,2,3,1,7,0.3847883331945834,1.9719027405640228
Silver Lake College of the Holy Family,393,267,Wisconsin,Town,NA,21.22,11.44,39.69,0,0,0,0,0,0,0,0,0,0.1415027771124565,0.09681551380696424
Simmons College,1743,1553,Massachusetts,Large City,NA,99.66,92.38,100.0,4,2,8,2,1,4,6,3,12,4.453353385609482,1.2103797264047993
Simpson College,1433,1280,Iowa,Town,NA,97.89,53.59,100.0,3,1,10,1,0,5,4,1,15,3.5139496105134462,0.3401109138874603
Simpson University,779,619,California,Small City,NA,98.49,85.08,100.0,3,1,7,1,1,3,4,2,10,3.5768561717250216,0.6050943106754121
Skidmore College,2682,2636,New York,Suburb,private,99.97,97.74,100.0,5,3,12,3,1,6,8,4,18,2.122136842650863,5.980657153474444
Slippery Rock University of Pennsylvania,7613,7125,Pennsylvania,Town,NA,100.0,99.94,100.0,10,5,21,5,3,11,15,8,32,11.80296341858136,3.131641573873366
Smith College,2526,2505,Massachusetts,Suburb,private,99.99,98.22,100.0,6,3,15,3,1,8,9,4,23,2.2982334107209614,6.866001580247753
Soka University of America,409,412,California,Suburb,NA,87.34,59.7,99.37,1,1,3,1,0,2,2,1,5,1.6554045092281091,0.40468840687717156
Sonoma State University,8670,7887,California,Suburb,NA,100.0,100.0,100.0,34,15,82,17,8,43,51,23,125,50.98054672526423,0.1737731018690684
South CaroliNA State University,2523,2281,South CaroliNA,Town,NA,100.0,100.0,100.0,26,11,60,12,5,30,38,16,90,35.58266317094229,2.7915359792590775
South College,1410,1410,Tennessee,Midsize City,NA,94.85,51.18,99.99,2,1,7,1,0,3,3,1,10,2.9639120673402473,0.0
South Dakota State University,10886,8425,South Dakota,Town,NA,100.0,100.0,100.0,17,7,37,9,4,20,26,11,57,19.54240854157282,5.909579639423118
South University - Columbia,806,556,South CaroliNA,Suburb,NA,100.0,99.83,100.0,11,4,24,5,2,12,16,6,36,15.775372120890808,0.0
South University - SavanNAh,499,396,Georgia,Midsize City,NA,92.9,63.03,99.92,2,1,5,1,0,2,3,1,7,0.17127008571830604,2.459528623343513
South University - Tampa,543,424,Florida,Large City,private,99.97,96.65,100.0,5,2,12,3,1,7,8,3,19,8.058244747726734,0.0
South University - West Palm Beach,699,535,Florida,Suburb,NA,100.0,98.67,100.0,7,3,15,4,1,9,11,4,24,10.239758519210767,0.01891858766387392
Southeast Missouri State University,10462,7779,Missouri,Small City,NA,100.0,98.32,100.0,8,3,26,4,1,13,12,4,39,10.13850791809057,2.33817598045297
Southeastern LouisiaNA University,13317,8998,LouisiaNA,Small City,NA,100.0,100.0,100.0,51,19,134,27,10,71,78,29,205,76.02306119991992,2.027129141902507
Southeastern Oklahoma State University,3122,2374,Oklahoma,Town,NA,100.0,98.08,100.0,8,3,23,4,1,12,12,4,35,8.006307407808032,4.303733192481831
Southeastern University,6241,4288,Florida,Midsize City,private,100.0,100.0,100.0,45,19,110,24,10,59,69,29,169,60.91914307443508,8.40811239950436
Southern Adventist University,2596,2173,Tennessee,Suburb,NA,100.0,98.81,100.0,8,3,21,4,1,11,12,4,32,1.3011784182153285,10.4940303757507
Southern Arkansas University Main Campus,3478,2924,Arkansas,Town,public,99.96,92.34,100.0,5,2,13,2,1,6,7,3,19,3.079160412730683,4.670255235974026
Southern Connecticut State University,7944,6814,Connecticut,Midsize City,NA,99.42,95.37,100.0,3,2,7,2,1,3,5,3,10,2.6955268867214732,2.453914948835974
Southern Illinois University Carbondale,10990,9455,Illinois,Small City,NA,100.0,99.93,100.0,10,5,25,5,2,13,15,7,38,11.35618614389193,3.8141644601611007
Southern Illinois University Edwardsville,11408,9550,Illinois,Suburb,NA,100.0,99.86,100.0,9,4,22,4,2,11,13,6,33,11.988035809827066,1.4273437697464006
Southern Methodist University,6454,6240,Texas,Suburb,NA,100.0,100.0,100.0,23,9,55,11,4,26,34,13,81,18.10228385249972,16.07083354603148
Southern Nazarene University,1517,1483,Oklahoma,Suburb,NA,99.73,85.66,100.0,4,1,11,2,1,6,6,2,17,3.2375419749412413,2.651730550906123
Southern New Hampshire University,70662,19935,New Hampshire,Suburb,NA,100.0,100.0,100.0,109,48,245,58,25,134,167,73,379,11.15259404539754,156.17886152709212
Southern Oregon University,5522,3640,Oregon,Suburb,public,100.0,99.94,100.0,11,5,31,6,3,14,17,8,45,6.58177917900417,9.633860207413962
Southern University and A & M College,5152,4530,LouisiaNA,Midsize City,NA,100.0,100.0,100.0,20,7,51,10,4,27,30,11,78,24.495670449659055,5.260655934848739
Southern University at New Orleans,2108,1520,LouisiaNA,Large City,NA,100.0,98.9,100.0,8,3,21,4,1,11,12,4,32,11.93228985167075,0.3466104538618415
Southern Utah University,8549,6279,Utah,Town,public,100.0,100.0,100.0,39,8,136,20,4,76,59,12,212,48.65905486181226,10.36075110240999
Southern Virginia University,908,853,Virginia,Town,NA,99.36,77.97,100.0,3,1,10,2,1,5,5,2,15,1.2064554242861965,3.821405442546127
Southern Wesleyan University,1360,820,South CaroliNA,Suburb,NA,100.0,99.96,100.0,13,6,31,6,2,15,19,8,46,17.987055805333316,1.9324362450740333
Southwest Baptist University,2827,1835,Missouri,Town,private,99.25,80.35,100.0,3,1,9,2,1,5,5,2,14,2.2870721670826253,2.6010662251482257
Southwest Minnesota State University,6711,1932,Minnesota,Town,public,99.35,86.86,100.0,3,1,8,2,1,4,5,2,12,1.841288241893214,3.185345072801683
Southwestern Adventist University,802,652,Texas,Town,private,98.18,78.37,99.99,3,1,7,1,0,3,4,1,10,2.970485003827513,1.0245963014003396
Southwestern Assemblies of God University,1788,1492,Texas,Suburb,private,99.98,95.76,100.0,6,2,14,3,1,7,9,3,21,6.117716716136126,2.358018309167597
Southwestern Christian University,620,539,Oklahoma,Suburb,NA,90.85,52.84,99.91,2,1,4,1,0,2,3,1,6,1.8848468125585804,0.5011732483986984
Southwestern College - Winfield,1148,577,Kansas,Town,NA,90.86,55.83,99.82,2,1,4,1,0,2,3,1,6,0.35359172762569335,2.0338157188191035
Southwestern Oklahoma State University,4626,3713,Oklahoma,Town,public,100.0,99.28,100.0,11,3,31,6,2,18,17,5,49,14.481391357690514,1.9131383710436487
Southwestern University,1398,1367,Texas,Suburb,NA,99.95,94.61,100.0,5,2,13,2,1,5,7,3,18,7.18389847374792,0.4411082436044343
Spalding University,1250,916,Kentucky,Large City,NA,95.19,66.54,99.98,2,1,6,1,0,3,3,1,9,2.624162183813602,0.4073941154913354
Spelman College,2139,2086,Georgia,Large City,NA,99.99,96.44,100.0,6,2,16,3,1,9,9,3,25,1.3089927979899105,7.848443079601081
Spring Arbor University,1958,1380,Michigan,Suburb,NA,99.83,88.94,100.0,4,1,12,2,1,7,6,2,19,5.800594186568941,0.580802920334784
Spring Hill College,1376,1363,Alabama,Midsize City,NA,99.96,95.11,100.0,5,2,13,3,1,7,8,3,20,2.543554859441744,5.292305418813395
Springfield College,2230,2188,Massachusetts,Midsize City,private,99.69,93.57,100.0,4,2,8,2,1,4,6,3,12,3.447350116081442,2.3315460375971067
St. Andrews University,641,567,North CaroliNA,Town,NA,95.7,68.4,99.99,2,1,6,1,0,3,3,1,9,0.24634724604693709,2.880929064956821
St Catherine University,3157,2124,Minnesota,Large City,private,87.75,57.25,99.84,1,1,4,1,0,2,2,1,6,0.9294852404266161,1.1652652758803803
St. Francis College,2286,2097,New York,Large City,NA,99.73,95.12,100.0,4,2,8,2,1,4,6,3,12,5.3288663773449905,0.5732577686385697
St John's College MD,466,458,Maryland,Suburb,NA,84.32,52.05,98.78,1,0,3,1,0,2,2,0,5,0.22686774993878128,1.618697146176996
St. John's College,319,309,New Mexico,Rural,NA,72.34,38.83,96.83,1,0,2,0,0,1,1,0,3,0.1255332165678943,1.155347721388403
St John's University - New York,16760,11526,New York,Large City,NA,100.0,100.0,100.0,34,17,76,18,8,40,52,25,116,28.850660856155432,23.030203095630846
St Lawrence University,2411,2372,New York,Town,private,99.68,93.4,100.0,4,2,8,2,1,4,6,3,12,2.5901460179846008,3.129789953194356
St Mary's College of Maryland,1574,1516,Maryland,Suburb,NA,98.62,84.38,100.0,3,1,7,1,1,4,4,2,11,3.408057754635914,0.8672765948858495
St. Mary's University,2323,2228,Texas,Large City,NA,100.0,99.33,100.0,9,3,21,4,2,9,13,5,30,12.315254526425006,0.6668007922040058
St Olaf College,3039,3003,Minnesota,Town,NA,99.41,84.94,100.0,3,1,10,2,1,5,5,2,15,0.5221264900458198,4.590692241821065
Stanford University,7064,7064,California,Suburb,NA,100.0,100.0,100.0,23,10,60,11,5,30,34,15,90,17.529551320933372,16.7033331081965
SUNY New Paltz,6733,6235,New York,Suburb,NA,100.0,99.99,100.0,11,6,23,6,3,12,17,9,35,15.788500010200586,1.3360702518531873
Stephen F Austin State University,10988,9567,Texas,Town,NA,100.0,100.0,100.0,44,17,102,19,7,43,63,24,145,61.519257564873065,0.853130795326975
Stephens College,654,542,Missouri,Midsize City,NA,70.78,33.3,98.66,1,0,3,0,0,1,1,0,4,0.5141301343340983,0.7124398692807656
Sterling College Kansas,698,599,Kansas,Rural,private,78.74,45.52,97.8,1,0,3,1,0,1,2,0,4,0.20769222836266454,1.3371747374776797
Sterling College Vermont,155,120,Vermont,Rural,private,36.74,17.6,68.36,0,0,1,0,0,0,0,0,1,2.278651645479099e-05,0.45686117211803606
Stetson University,3068,3028,Florida,Suburb,private,100.0,100.0,100.0,26,11,61,14,6,33,40,17,94,38.792360535097025,1.6268493314501786
Stevens Institute of Technology,3125,3113,New Jersey,Suburb,NA,100.0,99.85,100.0,10,4,23,5,2,12,15,6,35,11.484133903880338,3.124148170939391
Stevenson University,3401,2926,Maryland,Rural,NA,99.99,98.09,100.0,6,3,14,3,1,7,9,4,21,7.350515098016513,1.6256814415855532
Stillman College,675,552,Alabama,Midsize City,NA,93.43,60.41,99.93,2,1,5,1,0,2,3,1,7,1.8174315189333328,0.8977122624179031
Stonehill College,2494,2482,Massachusetts,Suburb,private,99.95,97.09,100.0,5,2,11,3,1,6,8,3,17,5.556168685259467,2.050393099026287
Stony Brook University,17369,16212,New York,Suburb,NA,100.0,100.0,100.0,30,15,63,15,8,33,45,23,96,38.2702740993805,7.090796000836313
Stratford University,1979,471,Virginia,Suburb,NA,100.0,98.27,100.0,9,3,19,5,1,11,14,4,30,11.746184061453107,1.6935984915905407
Strayer University - District of Columbia,691,107,District of Columbia,Large City,NA,83.07,54.28,97.77,1,1,2,1,0,1,2,1,3,0.8792501128825816,0.8945332465908007
Suffolk University,5028,4762,Massachusetts,Large City,private,100.0,99.97,100.0,12,5,28,6,3,15,18,8,43,13.473709061754208,4.624416578273351
Sul Ross State University,2292,1378,Texas,Town,NA,100.0,99.28,100.0,9,3,21,4,1,9,13,4,30,12.708658490463582,0.23883978812635562
Sullivan University,2596,1321,Kentucky,Large City,NA,99.73,87.87,100.0,4,1,11,2,1,6,6,2,17,4.4074326181178725,1.4900989664789654
Summit Christian College,32,17,Nebraska,Town,NA,0.99,0.36,2.94,0,0,0,0,0,0,0,0,0,0.0010240603517057386,0.008873241190922233
University at Albany,13510,12740,New York,Small City,public,100.0,100.0,100.0,23,12,46,12,6,24,35,18,70,31.75528923005212,2.62270171372679
Binghamton University,13739,13345,New York,Suburb,public,100.0,100.0,100.0,25,13,52,13,6,28,38,19,80,29.090856041379624,8.654443005627718
SUNY Fredonia,4393,4281,New York,Town,NA,100.0,99.66,100.0,7,4,15,4,2,8,11,6,23,10.714686252217367,0.19029823766380974
SUNY Geneseo,5558,5452,New York,Town,NA,100.0,99.92,100.0,9,5,19,5,2,10,14,7,29,13.470740284738268,0.4070973714092196
Purchase College,4062,3712,New York,Suburb,public,100.0,99.57,100.0,7,4,15,4,2,8,11,6,23,7.9512035026276795,3.0129234827529476
The College at Brockport,7182,6419,New York,Town,NA,100.0,99.99,100.0,12,6,24,6,3,13,18,9,37,17.43767519947185,0.5268831639706699
Buffalo State,8527,7665,New York,Large City,NA,100.0,100.0,100.0,14,7,29,7,4,15,21,11,44,20.62459482198254,0.8234483386297172
SUNY Cortland,6345,6196,New York,Town,public,100.0,99.97,100.0,11,5,22,5,3,12,16,8,34,15.02829463016113,1.0060342900796524
SUNY Old Westbury,4634,4056,New York,Suburb,public,100.0,99.73,100.0,8,4,15,4,2,8,12,6,23,11.299078661628807,0.057563560800730926
SUNY Oneonta,5940,5828,New York,Town,NA,100.0,99.95,100.0,10,5,20,5,3,10,15,8,30,14.523141869483444,0.22117852083406966
SUNY Oswego,7123,6836,New York,Town,NA,100.0,99.99,100.0,12,6,24,6,3,13,18,9,37,17.36338802878396,0.3619208194948397
SUNY Plattsburgh,5353,4894,New York,Town,public,100.0,99.88,100.0,9,4,17,4,2,9,13,6,26,12.613961582804546,0.34498336344310293
SUNY Potsdam,3323,3196,New York,Town,public,99.98,98.63,100.0,6,3,11,3,1,6,9,4,17,7.946251024581819,0.3715186336864877
SUNY College of Environmental Science and Forestry,1791,1737,New York,Midsize City,NA,99.16,90.92,100.0,3,2,7,2,1,3,5,3,10,3.7415971636469707,1.0361860544434236
SUNY Empire State College,9810,3772,New York,Suburb,NA,100.0,100.0,100.0,16,8,34,8,4,18,24,12,52,22.80120892313786,1.9677333777602852
SUNY Polytechnic Institute,2179,1859,New York,Suburb,NA,99.55,93.98,100.0,4,2,7,2,1,4,6,3,11,5.395724830964096,0.0
SUNY Maritime College,1640,1581,New York,Large City,public,99.49,91.85,100.0,3,2,7,2,1,4,5,3,11,2.986344261653373,2.2837424146356615
SusquehanNA University,2354,2283,Pennsylvania,Town,NA,99.93,96.33,100.0,5,2,11,2,1,6,7,3,17,2.0342434647693217,5.186721258917137
Swarthmore College,1581,1573,Pennsylvania,Suburb,NA,99.62,90.45,100.0,4,2,9,2,1,5,6,3,14,0.38074075543810837,5.179960822682678
Sweet Briar College,320,314,Virginia,Suburb,NA,87.41,47.5,99.63,1,0,4,1,0,2,2,0,6,1.3321278643160086,0.7301434658670196
Syracuse University,15248,14675,New York,Midsize City,NA,100.0,100.0,100.0,33,15,75,17,8,39,50,23,114,15.743927707787849,34.260906842203276
Tabor College,712,554,Kansas,Town,private,87.54,56.04,99.41,1,1,3,1,0,2,2,1,5,0.18022879320727087,1.8951213791629054
Talladega College,782,762,Alabama,Town,NA,97.26,73.25,99.99,2,1,6,1,0,3,3,1,9,1.8938655547763235,1.6895384214026492
Tarleton State University,11290,8429,Texas,Town,NA,100.0,100.0,100.0,45,17,105,19,7,44,64,24,149,63.48057587834075,0.5695998857246202
Taylor University,2111,1840,IndiaNA,Town,NA,99.6,91.26,100.0,4,2,8,2,1,5,6,3,13,2.085073051141466,3.412016285826486
Temple University,29583,26643,Pennsylvania,Large City,NA,100.0,100.0,100.0,45,22,100,24,11,53,69,33,153,40.7519521903922,28.295719919012992
Tennessee State University,6504,5431,Tennessee,Large City,NA,100.0,98.97,100.0,11,3,32,5,1,16,16,4,48,9.90493167468599,5.925725493505976
Tennessee Technological University,9365,8259,Tennessee,Town,NA,100.0,99.37,100.0,14,4,44,7,2,22,21,6,66,19.212876805311957,1.0817510266374784
Tennessee Wesleyan University,931,863,Tennessee,Town,NA,91.51,50.5,99.95,2,0,5,1,0,3,3,0,8,1.7678369139242185,0.6917437635287882
Texas A&M InterNAtioNAl University,6800,5191,Texas,Large City,public,100.0,100.0,100.0,27,10,63,12,4,27,39,14,90,38.49657340852854,0.1348491034310943
Texas A&M University - College Station,53069,46724,Texas,Midsize City,public,100.0,100.0,100.0,209,80,491,90,34,208,299,114,699,292.1680106259829,6.954759140267797
Texas A&M University - Commerce,8490,6068,Texas,Town,NA,100.0,100.0,100.0,34,13,81,15,5,34,49,18,115,47.1913711644536,1.1321052174892148
Texas A&M University - Corpus Christi,10174,8355,Texas,Large City,NA,100.0,100.0,100.0,40,15,94,17,7,40,57,22,134,57.08348533266999,0.47846260426947906
Texas A&M University - Kingsville,6782,5020,Texas,Town,NA,100.0,100.0,100.0,27,10,63,12,4,27,39,14,90,38.28561765969626,0.2958753614541243
Texas A&M University - TexarkaNA,1611,1166,Texas,Rural,NA,99.96,94.56,100.0,5,2,13,2,1,5,7,3,18,7.36064518222902,0.4050918923796436
Texas Christian University,9009,8738,Texas,Large City,NA,100.0,100.0,100.0,31,12,74,14,5,33,45,17,107,33.43933694327901,11.79285816703962
Texas College,993,940,Texas,Midsize City,NA,99.66,88.91,100.0,4,2,9,2,1,4,6,3,13,4.122189362317259,1.5480426666304132
Texas Lutheran University,1359,1305,Texas,Town,private,99.96,94.73,100.0,5,2,13,2,1,5,7,3,18,7.611511478137678,0.14229668443963098
Texas Southern University,7971,6695,Texas,Large City,NA,100.0,100.0,100.0,31,12,72,13,5,32,44,17,104,36.8089274178703,7.160918212569827
Texas State University,34177,28019,Texas,Suburb,NA,100.0,100.0,100.0,136,52,318,58,22,134,194,74,452,192.54558361661987,1.289156349978458
Texas Tech University,30737,27318,Texas,Large City,public,100.0,100.0,100.0,120,46,285,52,20,122,172,66,407,166.10199542515727,6.287600348731882
Texas Wesleyan University,1675,1497,Texas,Large City,NA,99.99,97.42,100.0,7,3,16,3,1,7,10,4,23,9.230739388093559,0.38878747633773847
Texas Woman's University,10311,6968,Texas,Midsize City,NA,100.0,100.0,100.0,41,16,96,18,7,40,59,23,136,57.92730832799911,0.45722059702540807
The College of Idaho,938,896,Idaho,Suburb,NA,99.86,66.14,100.0,4,1,15,2,0,9,6,1,24,5.780885824513182,0.7659181850369895
The College of New Jersey,6956,6728,New Jersey,Suburb,NA,100.0,100.0,100.0,25,11,60,12,5,31,37,16,91,36.340583804805526,0.8326346494849101
The College of Saint Rose,2504,2426,New York,Small City,NA,99.8,95.94,100.0,4,2,8,2,1,4,6,3,12,5.687921035669816,0.5258057715781234
The College of Saint Scholastica,2678,2179,Minnesota,Small City,NA,80.95,46.31,99.54,1,0,4,1,0,2,2,0,6,0.7413195277200074,0.9123365807916615
The College of Wooster,1979,1962,Ohio,Town,NA,99.45,88.38,100.0,3,1,8,2,1,4,5,2,12,1.4107221576591644,3.783498610183939
The Evergreen State College,3615,3330,Washington,Suburb,NA,100.0,99.99,100.0,11,6,26,6,3,15,17,9,41,11.97141550023093,5.8665974399772605
The King's College,555,542,New York,Large City,NA,93.4,66.34,99.94,2,1,5,1,0,2,3,1,7,0.1560030584445792,2.549810791773952
The Master's College and SemiNAry,1353,975,California,Suburb,NA,99.89,94.98,100.0,5,2,11,2,1,6,7,3,17,5.35050386018371,1.4550351578067662
The New School,7124,6224,New York,Large City,private,100.0,100.0,100.0,20,9,47,10,4,25,30,13,72,4.169986514613831,26.039447677398684
Stockton University,8276,7809,New Jersey,Suburb,NA,100.0,100.0,100.0,30,13,73,15,7,38,45,20,111,44.80694867415607,0.5094583213568611
The University of Alabama,33303,29923,Alabama,Midsize City,NA,100.0,100.0,100.0,102,38,257,52,18,136,154,56,393,80.9139196104548,73.67686559039267
The University of Findlay,3563,2499,Ohio,Town,private,99.96,95.47,100.0,5,2,12,3,1,6,8,3,18,5.488743332635172,2.2638754546093462
The University of MontaNA,9322,7444,MontaNA,Small City,NA,100.0,99.2,100.0,112,3,1221,36,2,328,148,5,1549,135.8228955378786,11.473849399742498
The University of MontaNA - Western,1540,1230,MontaNA,Town,public,100.0,50.4,100.0,19,0,203,6,0,55,25,0,258,22.423980475345388,2.2012070829144705
The University of Tampa,7970,7728,Florida,Large City,NA,100.0,100.0,100.0,35,15,81,19,8,44,54,23,125,38.24327203479152,15.595683721518647
The University of Tennessee - Knoxville,22315,20965,Tennessee,Midsize City,NA,100.0,100.0,100.0,36,10,111,17,4,55,53,14,166,42.02869352794391,10.609463651570445
The University of Tennessee - Chattanooga,10172,8962,Tennessee,Midsize City,NA,100.0,99.56,100.0,15,4,48,7,2,24,22,6,72,20.663301859542294,1.3006597681119876
The University of Tennessee - Martin,6327,4950,Tennessee,Town,NA,100.0,96.78,100.0,9,2,30,4,1,15,13,3,45,12.879354068506167,0.7994175841279432
The University of Texas at Arlington,33305,17819,Texas,Large City,public,100.0,100.0,100.0,133,51,311,57,22,132,190,73,443,186.37655333995696,3.2603354071017585
The University of Texas at Austin,40489,37740,Texas,Large City,NA,100.0,100.0,100.0,158,60,371,68,26,159,226,86,530,212.34691647322822,13.709768110800434
The University of Texas at Dallas,18474,15294,Texas,Midsize City,NA,100.0,100.0,100.0,73,28,174,31,12,73,104,40,247,101.22455039914331,3.415791547155449
The University of Texas at El Paso,21335,14025,Texas,Large City,NA,100.0,100.0,100.0,85,32,199,36,14,84,121,46,283,119.4066553457958,1.8471738578632069
The University of Texas at San Antonio,26437,21510,Texas,Large City,NA,100.0,100.0,100.0,105,40,246,45,17,104,150,57,350,148.41592156359692,1.7365090157193717
The University of Texas at Tyler,7440,4842,Texas,Midsize City,NA,100.0,100.0,100.0,29,11,69,13,5,29,42,16,98,41.455655398905655,0.5399311614264112
The University of Texas of the Permian Basin,6066,2192,Texas,Midsize City,public,100.0,100.0,100.0,24,9,56,10,4,24,34,13,80,33.76432282661523,0.46958475040519687
The University of Texas Rio Grande Valley,24216,18647,Texas,Small City,public,100.0,100.0,100.0,97,37,226,41,16,96,138,53,322,137.08132619390577,1.15640096417459
The University of Virginia's College at Wise,2093,1210,Virginia,Town,NA,100.0,99.24,100.0,11,3,23,6,2,14,17,5,37,16.940644916018677,0.25131228702768516
The University of West Florida,10000,6906,Florida,Small City,public,100.0,100.0,100.0,91,39,209,49,20,116,140,59,325,136.9901607113545,2.9719508861855775
Thiel College,764,751,Pennsylvania,Town,NA,81.79,54.71,97.84,1,1,2,1,0,1,2,1,3,0.8303774570983506,0.8696501683907926
Thomas AquiNAs College,364,369,California,Rural,private,84.31,47.28,99.95,1,0,5,1,0,2,2,0,7,0.9341211159215759,0.9106239211613879
Thomas College,1660,774,Maine,Rural,NA,90.89,56.62,99.67,2,1,4,1,0,2,3,1,6,0.9380096476473148,1.4536023665891495
Thomas More College,1878,1356,Kentucky,Suburb,NA,98.58,78.99,100.0,3,1,7,1,1,4,4,2,11,2.4332700912525755,1.8129057473287828
Thomas More College of Liberal Arts,90,90,New Hampshire,Suburb,private,26.18,8.2,60.12,0,0,1,0,0,0,0,0,1,0.0,0.3022773857527364
Thomas University,1118,438,Georgia,Town,NA,99.91,91.37,100.0,5,2,13,2,1,7,7,3,20,1.8888643739218893,5.134719489343371
Tiffin University,2243,1772,Ohio,Town,private,99.97,95.87,100.0,5,2,13,3,1,7,8,3,20,1.6721838023705449,6.480474724096351
Toccoa Falls College,1420,872,Georgia,Town,NA,99.69,83.68,100.0,4,1,12,2,1,6,6,2,18,2.077261468212026,3.6758856858455
Tougaloo College,794,766,Mississippi,Midsize City,private,99.99,97.97,100.0,6,3,13,3,1,7,9,4,20,8.543254350833474,0.39724788812705797
Touro College,6428,4232,New York,Large City,NA,100.0,99.99,100.0,12,6,27,6,3,14,18,9,41,14.347328898855427,3.8311103838610028
Towson University,19592,17106,Maryland,Small City,NA,100.0,100.0,100.0,37,17,87,19,8,47,56,25,134,35.38128597934149,21.291165408729412
Transylvania University,962,963,Kentucky,Large City,private,90.38,56.0,99.86,2,1,4,1,0,2,3,1,6,1.8581774579674584,0.4802119222368896
Trevecca Nazarene University,2216,1317,Tennessee,Large City,NA,99.98,94.35,100.0,6,2,15,3,1,8,9,3,23,2.83148195369313,5.477935098252441
Trident University InterNAtioNAl,4368,1862,California,Suburb,private,100.0,99.67,100.0,11,4,30,6,2,16,17,6,46,0.8749995263062863,16.06583745175577
Trine University,4099,1938,IndiaNA,Town,NA,100.0,99.47,100.0,8,3,18,4,2,10,12,5,28,6.562897917229199,5.149256562331589
Trine University - RegioNAl/Non - TraditioNAl Campuses,368,210,IndiaNA,Large City,NA,51.26,24.54,81.69,0,0,1,0,0,1,0,0,2,0.0,0.718043919804388
Trinity Christian College,1109,907,Illinois,Suburb,private,85.59,56.64,99.41,1,1,3,1,0,2,2,1,5,0.8074901867907489,1.1270018350305873
Trinity College,2218,2117,Connecticut,Midsize City,NA,99.9,95.64,100.0,5,2,11,2,1,6,7,3,17,0.13167698358048835,6.757682369603255
Trinity InterNAtioNAl University - Florida,156,64,Florida,Suburb,NA,90.29,62.32,99.58,2,1,3,1,0,2,3,1,5,2.3150758391259125,0.0
Trinity InterNAtioNAl University - Illinois,936,592,Illinois,Suburb,NA,88.52,60.88,99.56,1,1,4,1,0,2,2,1,6,0.5098137196263627,1.6476410178750869
Trinity University,2389,2353,Texas,Large City,NA,100.0,99.09,100.0,8,3,20,4,1,9,12,4,29,9.453098150376231,2.719223933296861
Trinity Washington University,1530,1075,District of Columbia,Large City,NA,98.06,82.58,99.98,3,1,5,1,1,3,4,2,8,2.1097090697378147,1.8260721534513185
Troy University,14006,9491,Alabama,Town,public,100.0,100.0,100.0,44,16,115,22,8,61,66,24,176,41.287118361188774,25.02293450258315
Truett McConnell University,2574,780,Georgia,Town,NA,99.82,63.92,100.0,4,1,18,2,0,10,6,1,28,6.050727456876726,0.2506133776404077
Truman State University,5895,5134,Missouri,Town,NA,99.94,90.19,100.0,5,2,15,2,1,8,7,3,23,5.5447666953968895,1.8216535562014335
Tufts University,5543,5483,Massachusetts,Suburb,NA,100.0,99.99,100.0,13,6,32,7,3,17,20,9,49,5.0131794728363825,15.289541853714244
Tulane University of LouisiaNA,7872,6716,LouisiaNA,Large City,private,100.0,100.0,100.0,23,10,59,12,5,30,35,15,89,6.199882239286321,28.994350741211157
Tusculum College,1485,1376,Tennessee,Town,NA,99.73,85.26,100.0,4,1,11,2,1,6,6,2,17,2.045309532994369,3.8563916069382222
Tuskegee University,2830,2722,Alabama,Town,NA,100.0,98.72,100.0,8,3,21,4,1,11,12,4,32,3.2824172059239864,8.586590683466218
Union College Kentucky,1096,918,Kentucky,Town,private,94.7,63.27,99.98,2,1,6,1,0,3,3,1,9,2.044236839324408,0.8876378002987277
Union College Nebraska,779,707,Nebraska,Large City,private,90.99,54.72,99.9,2,1,4,1,0,2,3,1,6,0.00908853562138843,2.387285231270902
Union College New York,2265,2176,New York,Small City,NA,99.86,95.55,100.0,4,2,9,2,1,5,6,3,14,2.285568618164232,4.261133593163877
Union Institute & University,814,434,Ohio,Large City,NA,99.92,94.84,100.0,5,2,11,2,1,6,7,3,17,0.5014600200807818,6.597211752376311
Union University,2179,1599,Tennessee,Small City,NA,99.65,82.52,100.0,4,1,11,2,1,6,6,2,17,3.1383834869070846,2.4991485248291174
United States Air Force Academy,4279,4276,Colorado,Town,NA,100.0,99.92,100.0,13,5,33,6,2,17,19,7,50,0.2613043286753624,18.518687628308047
United States Coast Guard Academy,1047,1044,Connecticut,Small City,NA,99.17,85.15,100.0,3,1,7,2,1,4,5,2,11,0.01320437718355872,4.759149686114582
United States Merchant Marine Academy,952,954,New York,Suburb,public,98.8,80.69,100.0,3,1,9,1,1,4,4,2,13,0.3739120924624041,4.028670113571264
United States Military Academy,4487,4491,New York,Town,public,100.0,99.96,100.0,13,5,34,7,3,17,20,8,51,0.780015292222896,19.272921303650012
United States Naval Academy,4495,4495,Maryland,Suburb,NA,100.0,99.97,100.0,14,6,36,7,3,18,21,9,54,1.0083011108390278,20.11958886369418
Unity College,706,694,Maine,Rural,private,82.57,51.01,98.4,1,0,3,1,0,1,2,0,4,0.19013709073932056,1.5517108877162145
Polytechnic University of Puerto Rico - Orlando,124,53,Florida,Suburb,NA,84.34,53.96,98.71,1,1,3,1,0,2,2,1,5,1.840188487510341,0.0
University at Buffalo,21016,19401,New York,Suburb,NA,100.0,100.0,100.0,36,19,74,19,9,39,55,28,113,48.871053356543094,5.884343797432057
University of Advancing Technology,775,508,ArizoNA,Midsize City,NA,95.58,71.94,99.96,2,1,5,1,0,3,3,1,8,0.5168554898643197,2.590776114390658
University of Akron Main Campus,16874,13563,Ohio,Midsize City,public,100.0,100.0,100.0,22,9,51,11,4,27,33,13,78,31.86710135392735,1.3634359005594117
University of Alabama at Birmingham,13130,9677,Alabama,Midsize City,NA,100.0,100.0,100.0,37,14,93,19,7,48,56,21,141,50.42947831507537,6.052257474633405
University of Alabama in Huntsville,7089,5903,Alabama,Midsize City,NA,100.0,100.0,100.0,19,7,51,10,3,26,29,10,77,24.989683385333326,3.877794137947366
University of Alaska Anchorage,14954,6974,Alaska,Large City,NA,95.63,67.42,100.0,2,1,8,1,0,3,3,1,11,0.00845898305116122,3.108577207352723
University of Alaska Fairbanks,6633,3022,Alaska,Suburb,public,89.01,59.27,99.64,1,1,4,1,0,2,2,1,6,0.003604673560166395,2.1966815469385326
University of Alaska Southeast,2060,629,Alaska,Town,NA,63.92,35.61,91.85,1,0,2,0,0,1,1,0,3,0.0010977170877712358,1.014805898095958
University of ArizoNA,34099,29325,ArizoNA,Large City,NA,100.0,100.0,100.0,110,57,236,56,28,120,166,85,356,113.12547854138175,52.8149174273103
University of Arkansas,23037,20464,Arkansas,Small City,NA,100.0,100.0,100.0,36,12,92,17,5,44,53,17,136,16.42064310463757,36.31484058240989
University of Arkansas at Little Rock,8794,4603,Arkansas,Midsize City,NA,100.0,95.08,100.0,7,2,20,4,1,10,11,3,30,9.916844190699646,1.1696925048451816
University of Arkansas at Pine Bluff,2517,2341,Arkansas,Small City,public,99.44,82.78,100.0,3,1,9,2,1,5,5,2,14,1.6137768428166832,3.564835377607605
University of Baltimore,2950,1716,Maryland,Large City,NA,99.94,96.11,100.0,5,2,11,3,1,6,8,3,17,7.007692720331244,0.33982146489000103
University of Bridgeport,3124,2300,Connecticut,Midsize City,private,99.88,96.55,100.0,4,2,10,2,1,5,6,3,15,0.38182657355790633,6.357686605625092
University of California - Berkeley,30577,29351,California,Midsize City,public,100.0,100.0,100.0,115,51,279,58,25,146,173,76,425,151.7178232707562,21.409541697940764
University of California - Davis,30067,29284,California,Suburb,NA,100.0,100.0,100.0,117,53,282,60,26,149,177,79,431,175.0944998046417,1.71486499076046
University of California - Irvine,29310,28855,California,Large City,public,100.0,100.0,100.0,114,52,275,58,26,145,172,78,420,171.36392749991694,1.1555093433650756
University of California - Los Angeles,31001,30458,California,Large City,NA,100.0,100.0,100.0,119,53,286,60,27,151,179,80,437,170.24652945618797,8.907735197618566
University of California - Riverside,20077,19719,California,Large City,public,100.0,100.0,100.0,79,35,189,40,18,100,119,53,289,118.35551025084828,0.19938867469977894
University of California - San Diego,28582,27880,California,Large City,NA,100.0,100.0,100.0,111,50,267,56,25,141,167,75,408,163.48301960419883,3.762917664785756
University of California - Santa Barbara,22182,21777,California,Suburb,NA,100.0,100.0,100.0,86,39,207,44,19,109,130,58,316,126.39013427956614,2.9233699329558935
University of California - Santa Cruz,17573,17082,California,Small City,NA,100.0,100.0,100.0,69,31,165,35,15,87,104,46,252,102.74741059241182,0.8241311138986468
University of Central Arkansas,9549,8070,Arkansas,Small City,NA,100.0,98.34,100.0,10,3,25,5,1,12,15,4,37,10.184647675391208,3.8427150099866574
University of Central Florida,56854,39962,Florida,Suburb,NA,100.0,100.0,100.0,526,224,1207,281,115,668,807,339,1875,794.5904208610176,11.940262776246483
University of Central Missouri,9800,7701,Missouri,Town,NA,100.0,96.9,100.0,8,2,24,4,1,12,12,3,36,10.492404669751036,0.9675355113154008
University of Central Oklahoma,14340,10448,Oklahoma,Suburb,public,100.0,100.0,100.0,32,10,96,17,5,55,49,15,151,47.742586111911876,1.7531433838423642
University of Charleston,1833,1220,West Virginia,Small City,NA,98.18,77.78,99.99,3,1,6,1,1,3,4,2,9,0.1605989267185201,3.82680557572747
University of Chicago,6305,6288,Illinois,Large City,private,100.0,99.99,100.0,14,6,36,7,3,18,21,9,54,1.4028431211195216,20.357515082356677
University of CincinNAti - Main Campus,26558,22622,Ohio,Large City,NA,100.0,100.0,100.0,38,15,88,19,7,47,57,22,135,46.11285857808995,10.707460152644598
University of Colorado at Colorado Springs,10804,8171,Colorado,Large City,public,100.0,97.25,100.0,8,2,27,4,1,13,12,3,40,7.525874819356283,4.172788949227395
University of Colorado Boulder,29057,26977,Colorado,Midsize City,NA,100.0,100.0,100.0,43,17,118,22,8,61,65,25,179,13.269917747626565,51.86150320647613
University of Colorado Denver/Anschutz Medical Campus,15589,8671,Colorado,Large City,NA,100.0,99.06,100.0,10,3,34,5,2,18,15,5,52,11.211273852572893,4.449306193614207
University of Connecticut,19243,18555,Connecticut,Suburb,NA,100.0,100.0,100.0,17,9,36,9,4,19,26,13,55,4.741838561917976,21.260376925055738
University of Dallas,1456,1421,Texas,Midsize City,private,99.95,92.28,100.0,5,2,18,2,1,7,7,3,25,3.6603673175763216,3.9626712495880656
University of Dayton,8498,8079,Ohio,Midsize City,NA,100.0,99.93,100.0,12,5,28,6,2,15,18,7,43,9.045792424492236,8.650054050658571
University of Delaware,19752,18195,Delaware,Suburb,NA,100.0,100.0,100.0,28,13,64,14,7,33,42,20,97,4.152428072362129,38.256979300951635
University of Denver,5768,5494,Colorado,Large City,NA,100.0,99.26,100.0,9,3,32,5,2,14,14,5,46,2.074926954110593,11.675673272592737
University of Detroit Mercy,2839,2338,Michigan,Large City,private,99.99,96.3,100.0,6,2,18,3,1,10,9,3,28,9.128411488179543,0.5425420180375969
University of Dubuque,1953,1709,Iowa,Small City,NA,98.94,78.15,100.0,3,1,9,2,0,5,5,1,14,1.8031741427654657,2.7319208723303525
University of Evansville,2346,2024,IndiaNA,Midsize City,NA,99.81,94.16,100.0,4,2,10,2,1,5,6,3,15,3.5383057837552148,2.719313803788657
University of Florida,35251,31384,Florida,Midsize City,NA,100.0,100.0,100.0,330,140,758,176,72,420,506,212,1178,500.82807319757245,5.649756681110401
University of Georgia,28844,27142,Georgia,Midsize City,NA,100.0,100.0,100.0,54,12,214,28,5,120,82,17,334,62.38879879615837,19.795715262629827
University of Providence,930,469,MontaNA,Small City,private,100.0,48.36,100.0,10,0,109,3,0,30,13,0,139,11.964957383348965,1.6817395550918774
University of Hartford,5073,4460,Connecticut,Midsize City,NA,100.0,99.66,100.0,8,4,17,4,2,9,12,6,26,0.6473812702494761,11.211702134563593
University of Hawaii at Hilo,2972,2340,Hawaii,Town,public,95.01,66.31,100.0,2,1,8,1,0,3,3,1,11,0.0002105204737158154,2.9851581564358423
University of Hawaii at Manoa,12877,10702,Hawaii,Large City,NA,100.0,99.95,100.0,12,5,33,6,3,17,18,8,50,0.0008193446137122522,18.20190109492552
University of Hawaii - West Oahu,3083,1611,Hawaii,Suburb,NA,17.85,9.82,34.19,0,0,0,0,0,0,0,0,0,0.00026972657051687487,0.19583251928858883
University of Houston,37217,27159,Texas,Large City,public,100.0,100.0,100.0,147,56,345,63,24,146,210,80,491,206.98750015154326,3.3492674501997457
University of Houston - Downtown,12402,6320,Texas,Large City,public,100.0,100.0,100.0,49,19,115,21,8,49,70,27,164,69.82635286348474,0.6500082553909713
University of Houston - Victoria,3273,1722,Texas,Small City,public,100.0,99.92,100.0,13,5,31,6,2,13,19,7,44,18.661031511569004,0.0
University of Idaho,9889,7166,Idaho,Town,NA,100.0,100.0,100.0,42,10,152,24,5,85,66,15,237,47.2741475293946,18.192912406863485
University of Illinois at Chicago,19446,17961,Illinois,Large City,public,100.0,100.0,100.0,15,8,37,8,4,19,23,12,56,21.807937657663715,1.2383556275174128
University of Illinois at Springfield,2932,1903,Illinois,Midsize City,public,96.77,82.47,99.98,2,1,6,1,1,3,3,2,9,3.2755816616709477,0.15349284540441016
University of Illinois at UrbaNA - Champaign,33955,32613,Illinois,Small City,NA,100.0,100.0,100.0,31,15,74,15,7,38,46,22,112,35.566064950399316,10.3863589307568
University of IndiaNApolis,4486,3828,IndiaNA,Large City,NA,100.0,99.77,100.0,8,4,17,4,2,9,12,6,26,11.167090847022475,0.9420453466753692
University of Iowa,24506,21222,Iowa,Small City,public,100.0,100.0,100.0,34,9,116,17,5,64,51,14,180,34.5179050186532,16.651762555194036
University of Kansas,19344,17151,Kansas,Small City,public,100.0,99.97,100.0,14,6,32,7,3,16,21,9,48,8.033054782952645,12.883576296759237
University of Kentucky,22420,20657,Kentucky,Large City,NA,100.0,100.0,100.0,38,13,103,19,7,54,57,20,157,41.49849110940589,15.354636665814855
University of La Verne,5169,3759,California,Suburb,NA,100.0,100.0,100.0,20,9,47,10,4,25,30,13,72,29.02278834214567,0.5977644401667017
University of LouisiaNA at Lafayette,15665,12767,LouisiaNA,Midsize City,NA,100.0,100.0,100.0,60,22,157,31,11,83,91,33,240,88.56306806656312,2.946597182858962
University of LouisiaNA at Monroe,7946,5212,LouisiaNA,Small City,NA,100.0,100.0,100.0,30,11,79,16,6,42,46,17,121,43.39333224216797,2.872427197834395
University of Louisville,15543,12025,Kentucky,Large City,NA,100.0,100.0,100.0,26,10,72,13,5,38,39,15,110,31.448868160528573,8.074696569303276
University of Maine,9277,8204,Maine,Suburb,NA,100.0,95.44,100.0,7,2,16,4,1,9,11,3,25,5.986149406776275,4.338703300792053
University of Maine at Augusta,4013,1317,Maine,Town,public,95.92,46.3,99.98,2,0,5,1,0,3,3,0,8,3.1626136092973653,0.03413328743921876
University of Maine at Farmington,1810,1673,Maine,Town,public,85.31,40.91,99.23,1,0,3,1,0,2,2,0,5,1.206578288316605,0.7085695303981921
University of Maine at Fort Kent,1762,582,Maine,Rural,NA,79.91,31.72,98.39,1,0,3,1,0,1,2,0,4,1.319868304882117,0.2838852598997345
University of Maine at Machias,698,367,Maine,Rural,public,65.12,29.63,92.14,1,0,2,0,0,1,1,0,3,0.4238472647730687,0.6262730498638904
University of Maine at Presque Isle,1413,716,Maine,Rural,NA,71.27,24.4,96.12,1,0,2,0,0,1,1,0,3,1.0576375672374705,0.18862513157487057
University of Mary,2234,1794,North Dakota,Rural,NA,100.0,99.0,100.0,19,3,92,10,2,43,29,5,135,23.95984626134238,5.3955800584284175
University of Mary Hardin - Baylor,3329,3045,Texas,Suburb,NA,100.0,99.93,100.0,13,5,31,6,2,13,19,7,44,18.598314937591837,0.3828741854233324
University of Mary Washington,4399,3905,Virginia,Suburb,NA,100.0,99.99,100.0,21,6,45,12,3,27,33,9,72,30.26192355917876,2.4617783084475833
University of Maryland - Baltimore County,11238,9543,Maryland,Suburb,public,100.0,100.0,100.0,19,9,45,10,4,25,29,13,70,26.130123287393406,3.4300836767402347
University of Maryland - College Park,29870,27708,Maryland,Suburb,public,100.0,100.0,100.0,58,26,137,30,13,74,88,39,211,50.611674258565,37.730130451456496
University of Maryland Eastern Shore,2860,2573,Maryland,Town,public,99.96,96.66,100.0,5,2,12,3,1,7,8,3,19,5.485158042964311,2.4071003401263367
University of Maryland - University College,45609,9714,Maryland,Suburb,NA,100.0,100.0,100.0,100,40,246,53,20,131,153,60,377,77.31652917913665,75.04268679248835
University of Massachusetts Amherst,23386,21577,Massachusetts,Suburb,NA,100.0,100.0,100.0,58,27,127,31,14,70,89,41,197,72.73950837118852,16.76326026711966
University of Massachusetts - Boston,12658,9574,Massachusetts,Large City,NA,100.0,100.0,100.0,34,16,73,18,8,41,52,24,114,49.719291295670324,2.4850313205551586
University of Massachusetts - Dartmouth,6764,5790,Massachusetts,Suburb,NA,100.0,100.0,100.0,18,8,39,10,4,21,28,12,60,27.275737182182837,0.4147032712958564
University of Massachusetts - Lowell,14015,10495,Massachusetts,Suburb,NA,100.0,100.0,100.0,36,17,77,19,9,43,55,26,120,52.85515922788116,2.0501971727046344
University of Memphis,17392,12400,Tennessee,Large City,NA,100.0,100.0,100.0,30,9,90,14,4,45,44,13,135,33.32824526785789,11.221713223863695
University of Miami,10834,10216,Florida,Suburb,NA,100.0,100.0,100.0,57,24,133,30,12,73,87,36,206,66.15774417194434,21.597402080416458
University of Michigan - Ann Arbor,29819,28702,Michigan,Midsize City,NA,100.0,100.0,100.0,68,26,181,35,13,100,103,39,281,65.1882813655684,38.19561882061034
University of Michigan - Dearborn,7132,5137,Michigan,Small City,NA,100.0,99.97,100.0,16,5,45,8,3,25,24,8,70,24.310509126257095,0.0593557606346129
University of Michigan - Flint,6432,3809,Michigan,Small City,public,100.0,99.94,100.0,14,5,41,8,2,23,22,7,64,21.721446744634047,0.3219930337691537
University of Minnesota - Crookston,2832,1195,Minnesota,Town,public,99.75,80.32,100.0,4,1,12,2,1,7,6,2,19,0.6989488796460016,5.2541199770783455
University of Minnesota - Duluth,10124,8906,Minnesota,Small City,NA,98.9,84.69,100.0,3,1,7,2,1,4,5,2,11,3.0213274721117855,1.4824033830573304
University of Minnesota - Morris,1627,1526,Minnesota,Town,NA,64.6,33.82,92.99,1,0,2,0,0,1,1,0,3,0.48075672342238107,0.555584339812651
University of Minnesota - Twin Cities,35429,29991,Minnesota,Large City,NA,100.0,100.0,100.0,18,7,50,9,3,26,27,10,76,8.088790256332844,19.064119730720734
University of Mississippi,18734,17511,Mississippi,Town,NA,100.0,100.0,100.0,113,47,256,57,24,133,170,71,389,131.0914917611225,39.456300170115945
University of Missouri - Columbia,23800,22197,Missouri,Midsize City,NA,100.0,100.0,100.0,23,8,66,11,4,33,34,12,99,19.698331245518094,14.017809041878536
University of Missouri - Kansas City,11369,6760,Missouri,Large City,public,100.0,98.96,100.0,10,3,29,5,1,15,15,4,44,10.45666916714037,3.9099392837510885
University of Missouri - St Louis,13791,5492,Missouri,Suburb,public,100.0,99.57,100.0,12,4,36,6,2,18,18,6,54,14.735707415230443,2.6625318285879396
University of Mobile,1442,1152,Alabama,Rural,NA,99.96,95.09,100.0,5,2,13,3,1,7,8,3,20,4.441666749542677,3.477093224858142
University of Montevallo,2352,2101,Alabama,Suburb,NA,100.0,97.86,100.0,7,3,17,4,1,9,11,4,26,9.282489019598751,1.2992969115318536
University of Mount Union,2093,2046,Ohio,Town,NA,99.24,86.27,100.0,3,1,7,2,1,4,5,2,11,3.4165622379822915,1.4593548252331563
University of Nebraska at Kearney,4846,4063,Nebraska,Town,NA,79.88,50.43,99.23,1,0,3,1,0,1,2,0,4,0.5605450350149287,1.0389702547416027
University of Nebraska at Omaha,12620,9820,Nebraska,Large City,NA,97.76,77.94,100.0,3,1,7,1,1,4,4,2,11,1.500888452968723,2.2928361303994302
University of Nebraska - Lincoln,20955,19534,Nebraska,Large City,public,100.0,99.49,100.0,9,4,25,5,2,13,14,6,38,2.1998096430078897,11.374430544815013
University of Nevada - Las Vegas,25281,18958,Nevada,Midsize City,NA,100.0,100.0,100.0,127,34,376,48,13,135,175,47,511,162.3225953502735,12.183756561054768
University of Nevada - Reno,18354,15572,Nevada,Midsize City,NA,100.0,100.0,100.0,91,26,264,35,10,98,126,36,362,105.71514942728922,19.865639706602234
University of New England,4427,2361,Maine,Suburb,NA,99.97,96.05,100.0,5,2,12,3,1,7,8,3,19,1.3135304018574727,6.7408135857771745
University of New Hampshire at Manchester,737,575,New Hampshire,Midsize City,NA,30.69,0.9,69.54,0,0,1,0,0,0,0,0,1,0.349131337241743,0.017333673160508798
University of New Hampshire - Main Campus,13010,12677,New Hampshire,Suburb,NA,100.0,99.98,100.0,14,6,34,7,3,18,21,9,52,3.435356706037589,18.16853643111675
University of New Haven,5214,4831,Connecticut,Suburb,NA,100.0,99.75,100.0,8,4,19,4,2,10,12,6,29,0.7042334497897984,11.953224052959978
University of New Mexico - Main Campus,20359,15093,New Mexico,Large City,public,100.0,100.0,100.0,54,11,211,27,5,113,81,16,324,70.87134657861182,10.981985910464743
University of New Orleans,6468,4737,LouisiaNA,Large City,NA,100.0,100.0,100.0,25,9,64,13,5,34,38,14,98,36.106571495334755,1.4540919200272409
University of North Alabama,6061,5141,Alabama,Small City,public,100.0,99.99,100.0,18,6,43,9,3,22,27,9,65,22.900486405624914,3.62256782701353
University of North CaroliNA at Asheville,3820,3285,North CaroliNA,Small City,NA,99.79,90.21,100.0,4,2,10,2,1,6,6,3,16,3.2144824858675234,2.9511425786568366
University of North CaroliNA at Chapel Hill,18863,18303,North CaroliNA,Small City,public,100.0,100.0,100.0,22,9,56,11,4,30,33,13,86,15.55977079181484,18.28106895393457
University of North CaroliNA at Charlotte,23915,20597,North CaroliNA,Large City,public,100.0,100.0,100.0,21,8,54,11,4,28,32,12,82,21.610737357672196,10.173633897315918
University of North CaroliNA at Greensboro,16441,14136,North CaroliNA,Large City,NA,100.0,99.97,100.0,14,6,37,7,3,19,21,9,56,15.130907165093452,6.681198669583907
University of North CaroliNA at Pembroke,5478,4483,North CaroliNA,Town,NA,99.88,91.94,100.0,4,2,11,2,1,6,6,3,17,5.231138888729494,1.4669918968188844
University of North CaroliNA at Wilmington,14499,12346,North CaroliNA,Midsize City,NA,100.0,99.98,100.0,15,6,37,8,3,20,23,9,57,11.949337469183616,10.468333474587165
University of North Dakota,10999,8525,North Dakota,Small City,public,100.0,100.0,100.0,47,9,179,26,4,100,73,13,279,65.62703675898365,8.011777052425257
University of North Florida,14251,10223,Florida,Large City,NA,100.0,100.0,100.0,135,58,311,72,30,172,207,88,483,206.42759565539387,1.3768865642049661
University of North Texas,31444,25592,Texas,Midsize City,NA,100.0,100.0,100.0,124,47,290,53,20,123,177,67,413,173.4683421141115,3.635766763404191
University of Northern Colorado,10103,8328,Colorado,Midsize City,NA,100.0,96.08,100.0,7,2,25,4,1,12,11,3,37,7.1087183539932415,3.566437290603427
University of Northern Iowa,9959,9100,Iowa,Small City,NA,100.0,99.26,100.0,18,3,69,9,2,39,27,5,108,26.31122270119112,0.6266748838357061
University of Notre Dame,8577,8557,IndiaNA,Suburb,private,100.0,100.0,100.0,20,8,49,10,4,26,30,12,75,1.5493823463027494,28.661484225557494
University of Oklahoma Norman Campus,22028,19065,Oklahoma,Suburb,NA,100.0,100.0,100.0,59,20,161,29,9,83,88,29,244,48.46699900344168,39.50893458797153
University of Oregon,19336,17801,Oregon,Midsize City,NA,100.0,100.0,100.0,45,21,113,23,11,58,68,32,171,18.971770783575554,49.18278352170976
University of Pennsylvania,11719,10496,Pennsylvania,Large City,NA,100.0,100.0,100.0,32,14,77,17,7,40,49,21,117,3.8491077323576386,44.6114222073437
University of Phoenix - New Mexico,216,217,New Mexico,Large City,private,68.45,32.88,95.19,1,0,2,0,0,1,1,0,3,0.18437691183409474,0.9662312925017101
University of Phoenix - Hawaii,661,661,Hawaii,Large City,NA,6.83,3.07,15.49,0,0,0,0,0,0,0,0,0,5.6441956739564225e-05,0.07058107775873196
University of Phoenix - New Jersey,111,111,New Jersey,Large City,NA,41.16,21.28,72.2,0,0,1,0,0,0,0,0,1,0.4595868437907753,0.06933469264203519
University of Phoenix - Kentucky,18,18,Kentucky,Suburb,NA,4.36,1.64,11.56,0,0,0,0,0,0,0,0,0,0.03624533403057461,0.008241395459057178
University of Phoenix - Utah,122,122,Utah,Suburb,NA,58.28,15.13,96.31,1,0,2,0,0,1,1,0,3,0.8709513927730481,0.0
University of Pittsburgh - Bradford,1337,1229,Pennsylvania,Town,NA,94.01,75.79,99.77,2,1,4,1,0,2,3,1,6,1.8891993674595664,0.9227503907176167
University of Pittsburgh - Greensburg,1524,1436,Pennsylvania,Suburb,NA,94.07,76.72,99.76,2,1,4,1,0,2,3,1,6,2.6923810563123376,0.1295253990682561
University of Pittsburgh - Johnstown,2785,2713,Pennsylvania,Suburb,NA,99.46,93.32,100.0,3,2,7,2,1,4,5,3,11,4.951442871911781,0.27066801134187285
University of Pittsburgh - Pittsburgh Campus,19329,18390,Pennsylvania,Large City,public,100.0,100.0,100.0,31,15,69,16,7,36,47,22,105,24.17341186788714,22.210471232152123
University of Portland,3888,3792,Oregon,Large City,private,100.0,99.94,100.0,10,5,30,6,3,15,16,8,45,2.1877723217727745,13.865251495340736
University of Puget Sound,2415,2390,Washington,Midsize City,NA,100.0,98.67,100.0,7,3,20,3,1,10,10,4,30,2.5554367702416023,7.56327353539737
University of Redlands,3133,2518,California,Small City,private,100.0,99.92,100.0,11,5,26,5,2,14,16,7,40,12.829384946517846,3.3061458599376166
University of Rhode Island,15100,12629,Rhode Island,Suburb,NA,100.0,100.0,100.0,16,8,35,8,4,19,24,12,54,4.143425807127198,20.75532630010516
University of Richmond,3265,3035,Virginia,Midsize City,NA,100.0,99.5,100.0,9,4,20,5,2,11,14,6,31,5.3368896199326885,8.521642104771766
University of Rio Grande,1755,1269,Ohio,Rural,NA,96.73,73.79,99.97,2,1,5,1,0,3,3,1,8,3.289733828234234,0.12613149112914954
University of Rochester,6542,6250,New York,Midsize City,private,100.0,99.99,100.0,13,6,30,7,3,15,20,9,45,7.302428878620065,12.099754214187621
University of Saint Francis - Fort Wayne,1906,1523,IndiaNA,Large City,NA,99.37,91.76,100.0,3,2,7,2,1,4,5,3,11,4.491560525186162,0.5638912460944394
University of Saint Mary,750,641,Kansas,Town,NA,80.76,43.87,99.54,1,0,4,1,0,2,2,0,6,0.20425929896824033,1.4386391942179921
University of San Diego,5776,5605,California,Large City,NA,100.0,100.0,100.0,19,8,48,10,4,24,29,12,72,19.98309728996789,9.059263765048264
University of San Francisco,6847,6586,California,Large City,NA,100.0,100.0,100.0,24,11,57,12,5,30,36,16,87,30.10471343210547,5.668586359331357
University of Science and Arts of Oklahoma,881,727,Oklahoma,Town,public,95.42,59.65,99.99,2,1,6,1,0,3,3,1,9,2.9113845119301933,0.16578561511449758
University of Scranton,3809,3630,Pennsylvania,Small City,private,100.0,99.7,100.0,8,4,19,4,2,10,12,6,29,2.6651852880667586,9.632527765520482
University of Sioux Falls,1214,1036,South Dakota,Midsize City,private,96.48,70.16,100.0,2,1,7,1,0,3,3,1,10,1.6679435778852907,1.669435092453699
University of South Alabama,10986,9090,Alabama,Midsize City,public,100.0,100.0,100.0,41,16,96,21,8,51,62,24,147,37.61828464072522,24.19292433162161
University of South CaroliNA - Aiken,3352,2716,South CaroliNA,Suburb,public,100.0,100.0,100.0,41,17,94,19,7,47,60,24,141,59.22614893029228,1.4454586296012062
University of South CaroliNA - Beaufort,2078,1797,South CaroliNA,Town,NA,100.0,100.0,100.0,25,10,57,12,4,28,37,14,85,35.40651137306634,0.8913489809799655
University of South CaroliNA - Columbia,26363,25243,South CaroliNA,Midsize City,NA,100.0,100.0,100.0,227,93,519,108,41,259,335,134,778,297.8335453642623,37.25023857136224
University of South CaroliNA - Upstate,5776,4583,South CaroliNA,Suburb,public,100.0,100.0,100.0,73,30,166,34,13,82,107,43,248,105.71065114755739,1.7353184028147368
University of South Dakota,7652,4908,South Dakota,Town,public,100.0,99.98,100.0,13,6,29,7,3,16,20,9,45,14.915210228729755,4.957090645079622
University of South Florida - Main Campus,31773,24672,Florida,Large City,NA,100.0,100.0,100.0,294,125,674,157,64,373,451,189,1047,444.15323582820156,6.292581691024772
University of South Florida - St. Petersburg,4251,2845,Florida,Large City,NA,100.0,100.0,100.0,40,17,91,21,9,50,61,26,141,60.26617296596366,0.551327924335924
University of Southern California,19174,18631,California,Large City,private,100.0,100.0,100.0,64,28,157,32,14,81,96,42,238,67.95435510381388,28.346824528093265
University of Southern IndiaNA,9689,6588,IndiaNA,Suburb,NA,100.0,100.0,100.0,17,9,37,9,4,20,26,13,57,24.729680640810905,1.472561119626701
University of Southern Maine,6110,3901,Maine,Small City,NA,99.78,81.04,100.0,4,1,10,2,1,5,6,2,15,4.080025072114587,2.040688067879535
University of Southern Mississippi,11809,10384,Mississippi,Small City,NA,100.0,100.0,100.0,93,40,203,47,20,106,140,60,309,126.41304294995182,13.439321528167438
University of St Francis,1600,1291,Illinois,Suburb,NA,92.32,70.09,99.83,2,1,4,1,0,2,3,1,6,1.6195424650322932,0.9409855738298464
University of St Thomas Minnesota,6197,5945,Minnesota,Large City,NA,98.9,80.81,100.0,3,1,9,2,1,4,5,2,13,1.6064147281601422,2.8916650703696916
University of St. Thomas - Houston,1815,1434,Texas,Large City,NA,100.0,97.94,100.0,7,3,17,3,1,7,10,4,24,9.778084033712448,0.3958078162497135
University of the Cumberlands,3317,1828,Kentucky,Town,NA,99.98,94.29,100.0,6,2,16,3,1,9,9,3,25,4.820629426066423,3.7343909040475842
University of the District of Columbia,3858,1830,District of Columbia,Large City,public,100.0,99.37,100.0,8,3,17,4,2,9,12,5,26,6.491223598739283,5.246260071446229
University of the IncarNAte Word,5996,4461,Texas,Large City,NA,100.0,100.0,100.0,24,9,56,10,4,24,34,13,80,32.914798324560905,0.9556034593758043
University of the Ozarks,756,747,Arkansas,Town,NA,84.13,45.7,99.12,1,0,3,1,0,2,2,0,5,0.5808205447206597,1.255829758336347
University of the Pacific,3552,3452,California,Large City,private,100.0,99.99,100.0,13,6,32,7,3,17,20,9,49,19.007591061315612,1.012754176880415
University of the Southwest,509,417,New Mexico,Rural,NA,90.69,51.45,99.95,2,0,5,1,0,3,3,0,8,1.1337218621287952,1.2336712743481857
University of the West,185,148,California,Suburb,NA,66.61,38.76,93.19,1,0,2,0,0,1,1,0,3,1.0937494078828578,0.0
University of Toledo,16191,13056,Ohio,Large City,public,100.0,100.0,100.0,23,9,54,12,4,29,35,13,83,28.148102138853535,6.325422036089019
University of Tulsa,3347,3203,Oklahoma,Large City,private,100.0,97.69,100.0,8,3,21,4,1,11,12,4,32,5.997864082950528,5.336319464431061
University of Utah,24637,18066,Utah,Midsize City,NA,100.0,100.0,100.0,106,23,383,57,11,217,163,34,600,139.8233932692862,23.341114069453354
University of Vermont,11341,10395,Vermont,Small City,NA,100.0,100.0,100.0,16,7,38,8,4,20,24,11,58,0.006393896517214352,24.630256243532713
University of Virginia - Main Campus,16658,15766,Virginia,Suburb,public,100.0,100.0,100.0,76,24,168,44,13,99,120,37,267,101.18307054933608,18.935529308821422
University of Washington - Bothell Campus,5365,4641,Washington,Suburb,NA,100.0,100.0,100.0,20,11,39,11,6,24,31,17,63,30.38897780827852,0.5195202482888199
University of Washington - Seattle Campus,31328,28759,Washington,Large City,public,100.0,100.0,100.0,111,59,238,63,33,137,174,92,375,149.68873765865675,24.108746486077603
University of Washington - Tacoma Campus,4436,3945,Washington,Midsize City,NA,100.0,100.0,100.0,16,9,32,9,5,19,25,14,51,25.186016456255075,0.24615553548377372
University of West Alabama,2111,1843,Alabama,Rural,NA,100.0,97.97,100.0,7,3,16,4,1,9,11,4,25,8.259122206367598,2.158859626016219
University of West Georgia,11230,8938,Georgia,Town,public,100.0,98.99,100.0,19,3,81,10,1,46,29,4,127,26.889403457774048,1.3100876739242162
University of Wisconsin - Eau Claire,10184,9476,Wisconsin,Small City,public,98.19,88.11,99.98,3,1,6,1,1,3,4,2,9,2.9871476083655013,1.0241422946599643
University of Wisconsin - Green Bay,6812,4095,Wisconsin,Midsize City,public,96.35,82.19,99.91,2,1,5,1,1,2,3,2,7,2.567036255977954,0.7416335402615966
University of Wisconsin - La Crosse,9701,9094,Wisconsin,Small City,NA,98.92,89.94,100.0,3,2,7,2,1,4,5,3,11,3.2293811759647912,1.2972514113529012
University of Wisconsin - Madison,31358,28977,Wisconsin,Large City,NA,100.0,100.0,100.0,20,9,45,10,5,24,30,14,69,7.797042854111798,21.944382290899668
University of Wisconsin - Milwaukee,20356,17076,Wisconsin,Large City,NA,99.99,99.2,100.0,6,3,12,3,2,6,9,5,18,7.691515359316068,1.171555881267934
University of Wisconsin - Oshkosh,12410,7994,Wisconsin,Small City,NA,99.5,94.52,100.0,4,2,7,2,1,4,6,3,11,4.83467821800893,0.46390568884273764
University of Wisconsin - Parkside,4135,3275,Wisconsin,Suburb,NA,87.84,67.49,98.84,1,1,3,1,0,2,2,1,5,1.4921747654259891,0.6134284965159854
University of Wisconsin - Platteville,7614,6723,Wisconsin,Town,NA,99.51,90.45,100.0,4,2,10,2,1,5,6,3,15,2.356780717104643,2.9578328345074327
University of Wisconsin - River Falls,5680,5014,Wisconsin,Town,NA,89.54,67.64,99.3,2,1,3,1,0,2,3,1,5,1.0708642369612176,1.185341933006123
University of Wisconsin - Stevens Point,7896,7224,Wisconsin,Town,NA,98.29,86.58,99.99,3,1,6,1,1,3,4,2,9,2.900007480087209,1.1632115349832677
University of Wisconsin - Stout,8129,6605,Wisconsin,Town,public,96.67,82.59,99.94,2,1,5,1,1,2,3,2,7,2.0761735150341782,1.3253952141179173
University of Wisconsin - Superior,2373,1829,Wisconsin,Suburb,NA,72.13,43.47,95.28,1,0,2,0,0,1,1,0,3,0.531235002210324,0.7445712491479303
University of Wisconsin - Whitewater,11128,9830,Wisconsin,Town,NA,99.72,95.51,100.0,4,2,8,2,1,4,6,3,12,3.8785351591021624,1.9968646209339682
University of Wyoming,9796,8281,Wyoming,Town,NA,99.99,91.26,100.0,6,2,30,3,1,12,9,3,42,0.0008330959359793718,9.059515365834887
Upper Iowa University,4275,2107,Iowa,Rural,private,100.0,96.5,100.0,7,2,24,4,1,13,11,3,37,5.980714237495396,5.2087637630575125
Ursinus College,1507,1489,Pennsylvania,Suburb,private,98.92,87.75,100.0,3,1,7,2,1,4,5,2,11,1.4649453828285313,3.053608818832497
Ursuline College,620,455,Ohio,Suburb,private,71.97,38.95,95.07,1,0,2,0,0,1,1,0,3,1.1102363868714586,0.16002467023236616
Utah State University,24621,17188,Utah,Small City,public,100.0,100.0,100.0,108,22,397,59,11,227,167,33,624,135.58999838474182,31.848614652228147
Utah Valley University,36870,18404,Utah,Small City,NA,100.0,100.0,100.0,164,34,588,89,17,341,253,51,929,235.02123607771733,18.44870763926356
Utica College,3686,2901,New York,Small City,NA,99.99,99.12,100.0,6,3,13,3,2,7,9,5,20,7.446050741949994,1.9657565476758523
Valdosta State University,8774,7166,Georgia,Small City,NA,100.0,98.13,100.0,15,3,65,8,1,37,23,4,102,20.995265793554058,1.9851349442003572
Valley City State University,1373,834,North Dakota,Town,NA,100.0,94.65,100.0,10,2,37,6,1,22,16,3,59,15.300050174977232,0.9969884795893913
University of Valley Forge,700,589,Pennsylvania,Suburb,NA,90.59,61.61,99.54,2,1,3,1,0,2,3,1,5,0.5203456990987481,1.8359571436303295
Valparaiso University,3228,3153,IndiaNA,Suburb,NA,99.93,96.33,100.0,5,2,11,2,1,6,7,3,17,3.3734778745740712,3.881174980467538
Vanderbilt University,6888,6805,Tennessee,Large City,NA,100.0,100.0,100.0,17,7,44,9,3,23,26,10,67,1.9927579005947196,24.148988511117924
Vanguard University of Southern California,1842,1524,California,Midsize City,NA,100.0,98.96,100.0,7,3,17,3,2,9,10,5,26,8.921447872947203,1.526353564873857
Vassar College,2352,2334,New York,Suburb,private,99.98,97.59,100.0,6,2,14,3,1,7,9,3,21,1.4981246088725462,6.92256285410548
Villanova University,6948,6525,Pennsylvania,Suburb,NA,100.0,100.0,100.0,16,7,37,8,4,20,24,11,57,1.9725997234126758,22.78598402278087
Virginia Commonwealth University,23666,20036,Virginia,Midsize City,NA,100.0,100.0,100.0,119,35,257,69,19,155,188,54,412,180.57453999750274,7.198836820138084
Virginia Military Institute,1724,1722,Virginia,Town,public,100.0,97.05,100.0,7,2,16,4,1,9,11,3,25,8.67977652472569,2.5490009310242043
Virginia Tech,27189,26603,Virginia,Small City,public,100.0,100.0,100.0,118,37,259,67,20,153,185,57,412,159.67102413921063,25.63068264958622
Virginia State University,4299,3976,Virginia,Suburb,public,100.0,99.98,100.0,18,6,39,10,3,23,28,9,62,22.36969432530656,5.596688346821487
Virginia Union University,1298,1201,Virginia,Midsize City,NA,99.93,91.12,100.0,5,2,10,3,1,6,8,3,16,5.001763113186523,2.2196248874657654
Virginia Wesleyan University,1438,1354,Virginia,Large City,NA,99.99,94.63,100.0,6,2,14,4,1,8,10,3,22,8.73842366340627,1.0388000042919485
Viterbo University,1770,1394,Wisconsin,Small City,NA,74.97,42.03,97.68,1,0,2,0,0,1,1,0,3,0.47247537442633786,0.9092587270846844
Voorhees College,475,464,South CaroliNA,Town,private,99.86,92.39,100.0,4,2,10,2,1,5,6,3,15,5.969588705796149,0.5139094488382903
Wabash College,865,864,IndiaNA,Town,NA,91.96,69.51,99.66,2,1,4,1,0,2,3,1,6,1.6290491690736355,0.8864087366468221
Wagner College,1797,1736,New York,Large City,NA,99.84,94.69,100.0,4,2,10,2,1,5,6,3,15,2.0849932573069156,4.338556269225266
Wake Forest University,5099,5046,North CaroliNA,Midsize City,NA,100.0,99.98,100.0,14,6,34,7,3,18,21,9,52,1.149952933976188,19.94185343566917
Walden University,7443,453,Minnesota,Large City,NA,100.0,100.0,100.0,37,15,87,19,7,45,56,22,132,0.018349493260396223,55.07455434316091
Waldorf University,2124,1482,Iowa,Town,private,100.0,99.04,100.0,8,3,19,4,2,10,12,5,29,1.1087841002098204,10.672795808017963
Walla Walla University,1650,1556,Washington,Suburb,NA,99.96,97.65,100.0,5,2,14,3,1,7,8,3,21,4.0863966370980584,3.829468653926065
Walsh University,2012,1744,Ohio,Suburb,private,98.54,81.13,100.0,3,1,6,1,1,3,4,2,9,3.7755841978844855,0.4443384634312838
Warner Pacific College,404,396,Oregon,Large City,NA,70.5,43.1,97.28,1,0,2,0,0,1,1,0,3,0.46155534214615496,0.7560448727714547
Warner University,1003,869,Florida,Rural,NA,100.0,99.71,100.0,9,4,21,5,2,11,14,6,32,13.56396998051977,0.28709674250664835
Warren Wilson College,589,579,North CaroliNA,Suburb,private,87.7,54.59,99.69,1,1,4,1,0,2,2,1,6,0.10571987077317949,1.9816507943212436
Wartburg College,1525,1474,Iowa,Town,NA,97.39,55.1,100.0,2,1,9,1,0,5,3,1,14,3.0099568376908006,0.6305616303001904
Washburn University,5877,3944,Kansas,Midsize City,NA,98.15,78.94,99.97,3,1,5,1,1,3,4,2,8,3.178320464337745,0.8102040064185774
Washington Adventist University,875,655,Maryland,Suburb,NA,96.49,75.41,99.96,2,1,5,1,0,3,3,1,8,1.1570255246877845,2.1816030927472547
Washington & Jefferson College,1411,1398,Pennsylvania,Suburb,NA,95.45,77.32,99.9,2,1,4,1,0,2,3,1,6,1.800359857857341,1.2849295494939217
Washington and Lee University,1824,1823,Virginia,Town,private,99.99,96.44,100.0,6,2,14,3,1,7,9,3,21,2.295616571211235,6.501957241872035
Washington College,1489,1456,Maryland,Town,NA,98.97,85.72,100.0,3,1,7,2,1,4,5,2,11,2.0367682438948362,2.5263142161373286
Washington State University,25279,22166,Washington,Town,NA,100.0,100.0,100.0,90,49,188,52,27,111,142,76,299,131.91579003139083,9.762407517021698
Washington University in St Louis,7673,7074,Missouri,Suburb,NA,100.0,100.0,100.0,18,8,47,9,4,23,27,12,70,0.740070731485406,26.519902175507056
Wayland Baptist University,3563,990,Texas,Town,NA,100.0,99.93,100.0,14,5,33,6,2,14,20,7,47,18.22201549372885,1.1961006587568404
Wayne State College,2756,2404,Nebraska,Town,public,70.62,34.12,97.89,1,0,2,0,0,1,1,0,3,0.3096502488470227,0.9138599957628267
Wayne State University,17300,12389,Michigan,Large City,public,100.0,100.0,100.0,39,13,109,20,7,62,59,20,171,58.43688223568215,0.712812804104519
Waynesburg University,1374,1330,Pennsylvania,Town,private,93.43,74.09,99.73,2,1,4,1,0,2,3,1,6,2.0777566939622485,0.6414470256081166
Webber InterNAtioNAl University,626,584,Florida,Town,NA,99.99,97.71,100.0,6,2,13,3,1,7,9,3,20,8.874457383315999,0.0802529423704928
Weber State University,27106,11311,Utah,Small City,NA,100.0,100.0,100.0,121,25,439,66,12,254,187,37,693,175.77512453162288,11.193834453936022
Webster University,3080,2297,Missouri,Suburb,private,99.72,87.18,100.0,4,1,12,2,1,6,6,2,18,2.348168348965377,3.5324812942253563
Wellesley College,2513,2374,Massachusetts,Suburb,private,99.99,98.29,100.0,6,3,16,3,1,8,9,4,24,1.2838117037910133,8.245255949809476
Wells College,486,481,New York,Rural,NA,72.91,46.4,94.38,1,0,2,0,0,1,1,0,3,0.8394450287732118,0.46432281562853367
Wentworth Institute of Technology,4263,3904,Massachusetts,Large City,private,100.0,99.83,100.0,9,4,21,5,2,11,14,6,32,11.752138613063964,2.140983085161764
Wesley College,1447,1303,Delaware,Small City,private,98.58,85.38,100.0,3,1,7,1,1,3,4,2,10,0.20595347058170532,4.037263133178989
Wesleyan College,565,431,Georgia,Midsize City,NA,87.27,42.72,99.93,1,0,5,1,0,3,2,0,8,1.0398540918611439,1.014033707120972
Wesleyan University,2975,2896,Connecticut,Small City,private,100.0,98.91,100.0,7,3,16,3,2,8,10,5,24,0.07849268659115462,10.18501742099089
West Chester University of Pennsylvania,14450,13020,Pennsylvania,Suburb,NA,100.0,100.0,100.0,22,11,49,11,6,26,33,17,75,21.879902079176627,11.612608309177856
West Liberty University,2174,1869,West Virginia,Rural,NA,83.13,49.15,98.39,1,0,3,1,0,1,2,0,4,0.2499290288142319,1.5269370994224332
West Texas A&M University,7393,5615,Texas,Town,public,100.0,100.0,100.0,28,11,67,12,5,29,40,16,96,38.58779751613169,1.8621045580838058
West Virginia State University,3754,1786,West Virginia,Suburb,NA,95.87,69.79,99.95,2,1,5,1,0,3,3,1,8,0.5088073392591818,2.6671561309533
West Virginia University,22507,20712,West Virginia,Small City,public,100.0,100.0,100.0,30,12,71,16,6,38,46,18,109,1.671725808618111,45.04931847721661
West Virginia University Institute of Technology,1621,1111,West Virginia,Small City,public,67.42,32.94,93.03,1,0,2,0,0,1,1,0,3,0.23837631980003238,0.8785098017365719
West Virginia Wesleyan College,1322,1289,West Virginia,Town,private,84.42,52.16,98.63,1,0,3,1,0,2,2,0,5,0.13684265184425065,1.7160884900324536
Western CaroliNA University,9408,8040,North CaroliNA,Town,NA,100.0,99.64,100.0,10,4,25,5,2,13,15,6,38,8.677008261572277,6.094246401717844
Western Connecticut State University,5082,4089,Connecticut,Small City,NA,95.16,84.71,99.64,2,1,4,1,1,2,3,2,6,1.7015307154035806,1.3237882833623411
Western Governors University,72383,72385,Utah,Suburb,NA,100.0,100.0,100.0,222,82,585,114,40,312,336,122,897,47.17415412659264,288.4973863232692
Western Illinois University,7596,6668,Illinois,Town,NA,99.99,98.88,100.0,6,3,15,3,1,8,9,4,23,8.35889206071949,0.7678071110742392
Western InterNAtioNAl University,593,597,ArizoNA,Midsize City,NA,94.78,71.77,99.9,2,1,5,1,0,2,3,1,7,0.8360897630158114,2.10352231847556
Western Kentucky University,17655,12919,Kentucky,Small City,NA,100.0,100.0,100.0,29,10,83,15,5,44,44,15,127,35.09514876400438,9.215669819807564
Western Michigan University,17938,15063,Michigan,Small City,NA,100.0,100.0,100.0,38,13,107,20,7,61,58,20,168,54.56525922908071,4.246179815831046
Western New England University,2737,2613,Massachusetts,Midsize City,private,99.92,96.55,100.0,5,2,10,2,1,5,7,3,15,4.752207913377226,2.324531974375647
Western New Mexico University,2170,1266,New Mexico,Town,public,99.99,88.22,100.0,6,1,22,3,1,12,9,2,34,7.025937214784333,2.056466633975
Western Oregon University,4758,4065,Oregon,Town,public,100.0,99.48,100.0,6,3,14,4,2,8,10,5,22,7.750437305318234,2.2350901827518994
Western Colorado University,2427,1832,Colorado,Town,NA,97.85,70.73,100.0,3,1,9,1,0,4,4,1,13,1.34994313419527,2.47787495459792
Western Washington University,14961,13728,Washington,Small City,NA,100.0,100.0,100.0,53,28,121,30,16,68,83,44,189,77.7739123339522,5.854886810517154
Westfield State University,5585,4800,Massachusetts,Suburb,NA,100.0,100.0,100.0,14,7,31,8,4,17,22,11,48,21.980540056382527,0.3169541345256201
Westminster College Missouri,765,760,Missouri,Town,NA,75.4,37.93,98.1,1,0,3,0,0,1,1,0,4,0.6674469681153428,0.7317005505481966
Westminster College Pennsylvania,1193,1170,Pennsylvania,Town,private,90.91,67.74,99.51,2,1,3,1,0,2,3,1,5,1.4975803047232263,0.8977765345093651
Westminster College Utah,2033,1906,Utah,Midsize City,NA,100.0,93.72,100.0,8,2,28,4,1,15,12,3,43,8.224065610447143,3.6393839384157936
Westmont College,1295,1294,California,Suburb,private,99.88,94.4,100.0,4,2,12,2,1,6,6,3,18,5.374152496029826,1.3427730892205387
Wheaton College Illinois,2386,2310,Illinois,Suburb,private,99.94,95.02,100.0,5,2,12,3,1,6,8,3,18,0.5964934571914713,6.763065431848485
Wheaton College Massachusetts,1686,1675,Massachusetts,Suburb,private,99.04,87.33,100.0,3,1,7,2,1,4,5,2,11,2.5592049701801183,2.0725927070891057
Wheeling Jesuit University,721,670,West Virginia,Small City,NA,70.47,39.36,94.23,1,0,2,0,0,1,1,0,3,0.03693612600314495,1.1803407096809289
Boston University Wheelock College of Education and Human Development,613,593,Massachusetts,Large City,NA,85.28,58.89,98.5,1,1,3,1,0,1,2,1,4,1.5658293567549408,0.3461829183538656
Whitman College,1512,1455,Washington,Small City,NA,99.88,95.95,100.0,4,2,10,2,1,6,6,3,16,3.2460953567933872,3.463073894141737
Whittier College,1684,1640,California,Suburb,NA,99.99,98.01,100.0,6,3,14,3,1,7,9,4,21,7.449320291526491,1.3812403107991542
Whitworth University,2252,2211,Washington,Suburb,private,100.0,99.58,100.0,8,4,25,4,2,12,12,6,37,7.5857334756271,4.715329335516241
Wichita State University,12403,8749,Kansas,Large City,NA,99.98,96.36,100.0,6,2,13,3,1,6,9,3,19,6.735407471860294,1.934963981065521
Widener University,3438,2919,Pennsylvania,Suburb,private,100.0,99.29,100.0,7,3,16,4,2,8,11,5,24,3.428479850159347,7.099872313853889
Wilberforce University,613,489,Ohio,Rural,private,82.21,49.13,98.85,1,0,3,1,0,2,2,0,5,0.3707291977250916,1.3523650951364141
Wiley College,1325,1188,Texas,Town,NA,99.92,93.51,100.0,5,2,12,2,1,5,7,3,17,4.78926564916528,2.2818481343247514
Wilkes University,2489,2233,Pennsylvania,Small City,NA,99.8,95.13,100.0,4,2,9,2,1,5,6,3,14,3.439358157457579,2.7461124696005212
Willamette University,1950,1901,Oregon,Midsize City,private,99.97,97.58,100.0,5,2,13,3,1,7,8,3,20,1.0024982031414484,6.957630005493756
William Carey University,3099,1676,Mississippi,Small City,private,100.0,100.0,100.0,25,11,55,13,6,29,38,17,84,35.86810755230879,2.288541282085341
William Jewell College,922,909,Missouri,Suburb,NA,73.0,33.67,97.98,1,0,3,0,0,1,1,0,4,0.6328642236534079,0.6749604372643465
William Paterson University of New Jersey,8839,7285,New Jersey,Suburb,NA,100.0,100.0,100.0,32,14,78,16,7,41,48,21,119,48.03513096246959,0.48511765758630737
William Penn University,1284,1068,Iowa,Town,NA,98.51,69.72,100.0,3,1,9,1,0,5,4,1,14,1.679975909408819,2.51648520927693
William Woods University,959,794,Missouri,Town,NA,79.82,44.56,98.99,1,0,3,1,0,2,2,0,5,0.7239321174031698,0.8741565965236829
Williams Baptist College,492,447,Arkansas,Rural,NA,49.74,18.09,84.64,0,0,1,0,0,1,0,0,2,0.4776408471555125,0.20951676676910644
Williams College,2073,2047,Massachusetts,Town,private,99.97,96.79,100.0,5,2,13,3,1,7,8,3,20,1.186999673669068,6.83723966773231
Wilmington College,1168,1098,Ohio,Town,NA,91.76,63.11,99.73,2,1,4,1,0,2,3,1,6,2.068278682045248,0.4243944113450203
Wilmington University,8441,3035,Delaware,Suburb,private,99.98,98.44,100.0,6,3,12,3,1,6,9,4,18,3.4649495860541832,4.875907970771714
Wilson College,827,565,Pennsylvania,Small City,NA,84.5,57.82,98.4,1,1,3,1,0,1,2,1,4,1.0533827567121,0.8080943066795995
Wingate University,2588,2537,North CaroliNA,Suburb,NA,99.56,87.82,100.0,4,1,9,2,1,5,6,2,14,2.174238851750295,3.230878535676137
WinoNA State University,7463,6522,Minnesota,Town,public,96.59,79.21,99.97,2,1,5,1,1,3,3,2,8,1.5336840094189355,1.84201700305263
Winston - Salem State University,4688,4072,North CaroliNA,Midsize City,NA,99.96,94.66,100.0,5,2,13,3,1,7,8,3,20,4.136040604682786,3.6439693202544676
Winthrop University,5014,4488,South CaroliNA,Small City,public,100.0,100.0,100.0,62,26,141,29,11,70,91,37,211,90.24843777844605,1.312765852223897
Wisconsin Lutheran College,992,921,Wisconsin,Large City,NA,77.84,49.35,96.96,1,0,2,1,0,1,2,0,3,0.3037912728967993,1.1961934859956616
Wittenberg University,1860,1775,Ohio,Small City,NA,98.34,80.56,100.0,3,1,7,1,1,4,4,2,11,2.6263236849367018,1.4633444934092708
Wofford College,1679,1663,South CaroliNA,Small City,private,100.0,99.98,100.0,15,6,34,7,3,17,22,9,51,19.5919944082031,2.1871590811499786
Woodbury University,1023,923,California,Large City,private,99.7,92.48,100.0,4,2,9,2,1,5,6,3,14,5.551517264875694,0.2441020840701771
Worcester Polytechnic Institute,4435,4301,Massachusetts,Midsize City,NA,100.0,99.81,100.0,9,4,20,5,2,11,14,6,31,8.759384116685569,5.035289769907271
Worcester State University,5496,4153,Massachusetts,Midsize City,NA,100.0,100.0,100.0,15,7,31,8,4,17,23,11,48,22.241511615841684,0.29923262765323366
Wright State University - Main Campus,12120,9423,Ohio,Suburb,public,100.0,99.99,100.0,16,6,37,8,3,20,24,9,57,22.950088545486988,1.1761154817800819
Xavier University,4629,4370,Ohio,Large City,private,100.0,99.04,100.0,7,3,18,4,2,9,11,5,27,4.792162682172763,6.507452834272391
Xavier University of LouisiaNA,2289,2155,LouisiaNA,Large City,NA,100.0,99.01,100.0,8,3,21,4,2,11,12,5,32,6.229099403467689,5.92700588453662
Yale University,5751,5743,Connecticut,Midsize City,NA,100.0,100.0,100.0,15,7,37,8,3,19,23,10,56,0.15038318459052988,23.175400867526374
Yeshiva University,2755,2646,New York,Large City,NA,100.0,99.21,100.0,7,3,16,4,2,8,11,5,24,2.8229124861400043,7.774092526068002
York College,431,398,Nebraska,Town,NA,53.73,20.56,96.99,1,0,2,0,0,1,1,0,3,0.01766504106692399,0.7502638665743976
York College of Pennsylvania,4169,3814,Pennsylvania,Suburb,NA,100.0,99.41,100.0,7,3,16,4,2,8,11,5,24,3.6224763303111454,7.1268788907178156
Youngstown State University,11272,8834,Ohio,Small City,NA,100.0,99.99,100.0,15,6,34,8,3,18,23,9,52,19.71498849375961,2.620521515138104
