school,real_size,size,state,setting,status,meanprob,lowprob,highprob,meaNActive,lowactive,highactive,meanincub,lowincub,highincub,meantot,lowtot,hightot,instate,outstate
Abilene Christian University,3669,3508,Texas,Midsize City,private,100.0,100.0,100.0,42,18,97,22,9,54,64,27,151,61.76978993283373,1.883222169611346
Adams State University,1956,1514,Colorado,Town,NA,98.48,81.45,100.0,3,1,7,1,1,4,4,2,11,1.5345164883773719,2.634783992538524
Adelphi University,5269,4874,New York,Suburb,private,100.0,99.99,100.0,11,7,19,5,3,9,16,10,28,13.518174270935113,2.68431784304501
Adrian College,1673,1606,Michigan,Town,private,99.5,92.04,100.0,4,2,8,2,1,4,6,3,12,4.333028902676494,0.961599069887219
Agnes Scott College,923,913,Georgia,Suburb,private,98.36,78.95,100.0,3,1,7,1,0,4,4,1,11,1.8644468633617222,2.230319192177841
Alabama A & M University,5032,4714,Alabama,Midsize City,public,100.0,100.0,100.0,16,7,34,7,3,17,23,10,51,16.76747097179868,6.943058366087235
Alabama State University,4212,3866,Alabama,Midsize City,NA,100.0,99.99,100.0,15,7,31,7,3,15,22,10,46,13.79326567581214,7.615037459368974
Alaska Pacific University,298,203,Alaska,Large City,private,54.6,32.32,81.42,1,0,1,0,0,1,1,0,2,0.002119055323204234,0.7825696738162266
Albany State University,6266,3927,Georgia,Small City,NA,100.0,99.76,100.0,14,4,40,6,2,20,20,6,60,17.87534689383558,2.326649338813168
Albertus Magnus College,1130,1012,Connecticut,Midsize City,NA,66.74,47.37,86.94,1,0,1,0,0,1,1,0,2,0.43971302074947144,0.6585679025789837
Albion College,1565,1554,Michigan,Town,NA,99.32,90.53,100.0,3,2,7,2,1,4,5,3,11,4.454301269846714,0.5315156442584581
Albright College,2019,1993,Pennsylvania,Small City,NA,99.91,97.86,100.0,5,3,9,2,1,4,7,4,13,2.5214708522618694,4.48934485201368
Alcorn State University,3169,2893,Mississippi,Rural,NA,100.0,100.0,100.0,27,14,52,13,6,26,40,20,78,36.159668007706195,3.915296705449569
Alderson Broaddus University,950,903,West Virginia,Town,private,62.06,37.82,84.44,1,0,1,0,0,1,1,0,2,0.15598425185383802,0.8115467344584036
Alfred University,1704,1600,New York,Town,NA,99.41,95.1,99.99,3,2,6,2,1,3,5,3,9,3.8544633353513764,1.2654503246580397
Alice Lloyd College,598,584,Kentucky,Rural,private,79.5,48.98,97.81,1,0,3,1,0,1,2,0,4,1.2994037480668055,0.2829483691168116
Allegheny College,1800,1752,Pennsylvania,Town,NA,99.45,94.06,100.0,4,2,7,2,1,3,6,3,10,1.9200380506158006,3.2682705868976742
Allen University,590,563,South CaroliNA,Midsize City,private,99.96,97.93,100.0,5,3,10,3,1,6,8,4,16,7.553320997967639,0.312591068646785
Alma College,1427,1386,Michigan,Town,NA,99.12,89.04,100.0,3,2,7,2,1,4,5,3,11,4.454301269846714,0.2755969238492422
Alvernia University,2252,1670,Pennsylvania,Small City,NA,99.9,97.78,100.0,5,3,9,2,1,4,7,4,13,3.2345097408113324,3.6693659877135705
Alverno College,1312,1036,Wisconsin,Large City,NA,56.62,37.4,79.76,1,0,1,0,0,1,1,0,2,0.6250372538535554,0.20879417789979127
American InterContinental University - Atlanta,1905,932,Georgia,Midsize City,private,99.79,85.23,100.0,4,1,12,2,1,6,6,2,18,5.069619561050975,1.0817719260221992
American InterNAtioNAl College,1374,1254,Massachusetts,Midsize City,private,99.25,93.47,99.99,3,2,6,2,1,3,5,3,9,3.2674037480913585,1.6157233490005372
American Jewish University,68,63,California,Large City,NA,37.22,20.75,62.04,0,0,1,0,0,0,0,0,1,0.3659220440191994,0.0976001037010151
American Public University System,37910,2914,West Virginia,Town,NA,100.0,100.0,100.0,152,71,335,75,32,175,227,103,510,0.15057439340804019,226.4979100844613
American University,8124,7764,District of Columbia,Large City,NA,100.0,100.0,100.0,25,13,51,12,6,26,37,19,77,0.5174107791640913,36.46093264252573
Amherst College,1832,1836,Massachusetts,Suburb,private,99.99,99.04,100.0,6,3,12,3,1,6,9,4,18,0.9390067988663072,8.092238051131693
Amridge University,321,147,Alabama,Midsize City,NA,89.01,64.88,99.04,1,1,3,1,0,2,2,1,5,0.8342283147279318,1.3635701569036405
Anderson University IndiaNA,1565,1431,IndiaNA,Small City,NA,99.09,92.46,99.99,3,2,6,2,1,3,5,3,9,3.308759712379645,1.3797128279557167
Anderson University South CaroliNA,2984,2550,South CaroliNA,Small City,private,100.0,100.0,100.0,26,13,53,14,7,28,40,20,81,37.672968779119586,2.4230661482401987
Andrews University,1704,1344,Michigan,Town,NA,99.97,98.08,100.0,5,3,11,3,1,6,8,4,17,1.4683789322231993,6.558090436541614
Angelo State University,8721,5332,Texas,Midsize City,NA,100.0,100.0,100.0,111,48,256,57,22,142,168,70,398,167.60502633784085,0.5470196995559687
AnNA Maria College,1121,866,Massachusetts,Rural,NA,98.4,90.2,99.95,3,2,5,1,1,2,4,3,7,3.768773894092373,0.3574529392573124
Antioch University - Seattle,90,17,Washington,Large City,NA,33.86,18.69,57.64,0,0,1,0,0,0,0,0,1,0.010961254644264366,0.40082040558079657
Appalachian State University,17014,16071,North CaroliNA,Town,public,100.0,100.0,100.0,22,10,48,10,5,23,32,15,71,20.535089322507844,11.787407452699114
AquiNAs College Michigan,1553,1317,Michigan,Midsize City,NA,99.32,90.33,100.0,3,2,7,2,1,4,5,3,11,4.670624951826024,0.30898978828709656
Arcadia University,2387,2177,Pennsylvania,Suburb,NA,99.95,98.29,100.0,5,3,10,2,1,5,7,4,15,2.8893575831656504,4.616169439064706
ArizoNA Christian University,784,646,ArizoNA,Large City,NA,99.61,94.98,100.0,4,2,7,2,1,3,6,3,10,4.529731525206863,0.9937963067513207
ArizoNA State University - Tempe,42429,38814,ArizoNA,Midsize City,NA,100.0,100.0,100.0,192,104,370,86,45,170,278,149,540,198.2349891785145,79.28811285216356
Arkansas Baptist College,597,496,Arkansas,Midsize City,NA,94.65,73.29,99.85,2,1,4,1,0,2,3,1,6,0.6136532239978602,2.2988884685786615
Arkansas State University - Main Campus,9608,6894,Arkansas,Small City,public,100.0,99.98,100.0,14,6,32,6,2,15,20,8,47,15.250616645094647,5.0517504440634715
Arkansas Tech University,10780,6729,Arkansas,Town,public,100.0,99.99,100.0,15,6,34,7,3,16,22,9,50,18.395367079959044,3.4241816296308785
Armstrong State University,6283,4513,Georgia,Midsize City,public,100.0,99.76,100.0,14,4,41,6,2,20,20,6,61,18.024981473559635,2.2506358814332
Asbury University,1731,1325,Kentucky,Town,NA,99.83,94.41,100.0,4,2,10,2,1,5,6,3,15,2.288423604894981,4.039572417495508
Ashford University,31543,31545,California,Large City,private,100.0,100.0,100.0,132,62,289,65,28,151,197,90,440,10.926432234413294,185.76879741646562
Ashland University,4812,3380,Ohio,Town,NA,100.0,99.79,100.0,8,4,15,4,2,7,12,6,22,10.411938613029854,1.2312000902662732
Assumption College,2085,1937,Massachusetts,Midsize City,private,99.92,98.07,100.0,5,3,9,2,1,4,7,4,13,5.247390934841128,1.9290756258544877
Point University,1925,1119,Georgia,Town,NA,99.92,90.55,100.0,5,2,13,2,1,7,7,3,20,5.195312608019181,1.8873720937904686
Auburn University,23968,21762,Alabama,Small City,public,100.0,100.0,100.0,95,43,203,45,19,102,140,62,305,69.52075340810349,70.44599583202157
Auburn University at Montgomery,4312,3239,Alabama,Midsize City,NA,100.0,100.0,100.0,15,7,31,7,3,15,22,10,46,20.92306791845583,1.4356744772552812
Augsburg University,2428,2033,Minnesota,Large City,NA,89.87,67.65,99.16,2,1,3,1,0,2,3,1,5,1.1363134768767247,1.147986749165654
AugustaNA College,2650,2637,Illinois,Small City,NA,98.96,90.57,99.99,3,2,7,1,1,3,4,3,10,3.634483752963897,0.9276986840130576
AugustaNA University,1746,1679,South Dakota,Midsize City,NA,96.54,83.66,99.83,2,1,4,1,1,2,3,2,6,2.1263421012362627,1.2320187595890018
Aurora University,3935,3461,Illinois,Suburb,private,99.95,98.15,100.0,5,3,11,2,1,5,7,4,16,5.385928940814602,2.2151402423812523
Austin College,1218,1204,Texas,Small City,NA,100.0,99.99,100.0,14,6,33,7,3,19,21,9,52,21.37809243483711,0.5165405035946877
Austin Peay State University,9591,7065,Tennessee,Midsize City,NA,100.0,100.0,100.0,23,9,57,10,4,26,33,13,83,31.142389001669248,2.0164820747722443
Ave Maria University,1071,1035,Florida,Rural,NA,99.99,98.93,100.0,6,3,13,3,1,7,9,4,20,6.561263832240557,2.4977911850437677
Averett University,929,890,Virginia,Town,NA,99.23,89.47,99.99,3,2,6,2,1,3,5,3,9,2.626792947975173,2.2176698821639884
Averett University - Non - TraditioNAl Programs,344,87,Virginia,Town,NA,83.61,53.74,96.59,1,1,2,1,0,1,2,1,3,1.8036262956156877,0.0
Avila University,1274,1077,Missouri,Large City,NA,97.71,78.92,99.99,3,1,6,1,0,3,4,1,9,1.4496017707426128,2.310184803802774
Azusa Pacific University,5674,5075,California,Suburb,private,100.0,100.0,100.0,25,13,51,12,6,25,37,19,76,31.05946309634965,5.699292779716276
Bacone College,936,864,Oklahoma,Town,private,99.81,93.38,100.0,4,2,9,2,1,5,6,3,14,1.5406988775212007,4.680678415845915
Baker University,1774,1062,Kansas,Town,NA,98.74,85.88,100.0,3,1,6,1,1,3,4,2,9,0.8117865590350762,3.5406752846261864
Baldwin Wallace University,3191,2958,Ohio,Suburb,NA,99.98,98.72,100.0,6,3,11,3,1,5,9,4,16,6.238751368220312,2.0456186036157855
Ball State University,17000,15203,IndiaNA,Small City,NA,100.0,100.0,100.0,33,19,61,15,9,30,48,28,91,42.97101667916881,5.465429848584028
Bard College,1941,1862,New York,Town,NA,99.96,98.36,100.0,5,3,10,2,1,5,7,4,15,1.6473552855376838,6.109327526192393
BarNArd College,2549,2514,New York,Large City,NA,100.0,99.8,100.0,8,4,16,4,2,8,12,6,24,2.6189468711981134,9.12044053513437
Barry University,3504,2991,Florida,Suburb,NA,100.0,100.0,100.0,24,12,48,11,6,24,35,18,72,30.097415628804715,5.0498946623526635
Barton College,888,830,North CaroliNA,Town,private,82.71,55.67,97.77,1,1,3,1,0,1,2,1,4,0.9778613963098973,0.7736101639457212
Bates College,1788,1787,Maine,Small City,NA,99.69,95.18,100.0,4,2,8,2,1,4,6,3,12,0.14878662371169224,5.599262358656267
Bay Path University,1946,1367,Massachusetts,Suburb,NA,99.75,96.56,100.0,4,2,7,2,1,4,6,3,11,5.217648638044458,0.7771325595680848
Baylor University,14311,14100,Texas,Midsize City,private,100.0,100.0,100.0,155,67,357,80,31,197,235,98,554,223.39520357866348,11.141926618114594
Beacon College,349,344,Florida,Suburb,private,91.72,72.67,99.32,2,1,3,1,0,2,3,1,5,1.347645475916629,1.1296746502601638
Becker College,1885,1530,Massachusetts,Midsize City,private,99.83,96.99,100.0,4,2,8,2,1,4,6,3,12,5.238893135756365,1.1059018121773347
Belhaven University,2479,1248,Mississippi,Midsize City,private,100.0,100.0,100.0,15,8,32,7,3,16,22,11,48,10.578314546824908,12.356970872779492
Bellarmine University,2539,2410,Kentucky,Large City,NA,99.9,95.59,100.0,5,2,11,2,1,5,7,3,16,4.426916008089946,2.444917902512413
Bellevue University,5743,4919,Nebraska,Suburb,NA,99.99,98.25,100.0,6,3,13,3,1,7,9,4,20,0.7121109198980742,8.260768807428216
Belmont Abbey College,1552,1381,North CaroliNA,Suburb,private,99.52,92.41,100.0,4,2,7,2,1,4,6,3,11,1.207236291740614,4.1014546990547265
Belmont University,6496,6161,Tennessee,Large City,NA,100.0,100.0,100.0,23,10,51,11,5,26,34,15,77,6.699354565931053,27.03674887347224
Beloit College,1407,1346,Wisconsin,Small City,NA,96.41,81.27,99.91,2,1,5,1,1,2,3,2,7,0.1474524278414587,3.1683442124890715
Bemidji State University,4819,3333,Minnesota,Town,NA,97.91,83.93,99.98,3,1,6,1,1,3,4,2,9,2.4057038188752458,1.45398946030858
Benedict College,2089,2077,South CaroliNA,Midsize City,NA,100.0,99.99,100.0,13,7,27,7,3,14,20,10,41,16.02739806800158,3.9176717605499047
Benedictine College,2080,1821,Kansas,Town,NA,99.67,92.57,100.0,4,2,8,2,1,4,6,3,12,0.42431077562130076,5.248807021913974
Benedictine University,2883,2473,Illinois,Suburb,private,99.36,93.37,100.0,4,2,7,2,1,3,6,3,10,4.218821011522317,0.8323564945139877
Bennett College,490,400,North CaroliNA,Large City,private,76.16,51.93,94.25,1,1,2,0,0,1,1,1,3,0.23608176371816453,1.194588186370078
Bennington College,775,724,Vermont,Town,NA,96.38,82.05,99.88,2,1,4,1,1,2,3,2,6,0.00010596276166283344,3.306633485872145
Bentley University,4270,4171,Massachusetts,Small City,private,100.0,99.98,100.0,11,6,20,5,3,10,16,9,30,7.966686641965276,7.762731861639857
Berea College,1668,1615,Kentucky,Town,NA,99.6,91.29,100.0,4,2,8,2,1,4,6,3,12,2.059581244405483,3.441067791635562
Berry College,1976,1945,Georgia,Suburb,private,99.98,95.41,100.0,6,2,15,3,1,7,9,3,22,4.282541671702447,3.98434557087807
Bethany College Kansas,777,710,Kansas,Town,NA,91.39,65.44,99.65,2,1,4,1,0,2,3,1,6,0.370475017779533,2.0636334489903327
Bethany College West Virginia,598,594,West Virginia,Rural,private,79.0,55.6,95.29,1,1,2,1,0,1,2,1,3,0.03133209683191255,1.5246535734538866
Bethany Lutheran College,651,522,Minnesota,Small City,NA,53.67,30.27,82.01,1,0,1,0,0,1,1,0,2,0.26289470497530343,0.5037847167902201
Bethel College - Mishawaka,1330,1044,IndiaNA,Small City,NA,98.14,88.43,99.97,3,1,5,1,1,3,4,2,8,2.780158203925211,1.1975418420084756
Bethel College - North Newton,502,489,Kansas,Town,NA,65.56,38.03,90.59,1,0,2,0,0,1,1,0,3,0.2564282149831567,0.8035688262690809
Bethel University Minnesota,2898,2407,Minnesota,Suburb,NA,94.44,74.76,99.89,2,1,4,1,0,2,3,1,6,1.1879147102912988,1.6967823161907203
Bethel University Tennessee,4830,3454,Tennessee,Town,NA,100.0,99.97,100.0,14,6,34,6,2,16,20,8,50,14.301337334136628,5.679688990965585
Bethune - Cookman University,3988,3755,Florida,Small City,private,100.0,100.0,100.0,30,15,61,14,7,31,44,22,92,36.72674236386934,7.408914882864235
Biola University,4047,3882,California,Suburb,private,100.0,100.0,100.0,18,9,38,9,4,18,27,13,56,22.467613502778846,4.324958687367696
Birmingham Southern College,1287,1272,Alabama,Midsize City,NA,99.94,96.34,100.0,5,2,11,2,1,5,7,3,16,3.7410735604569365,3.7135425525776333
Black Hills State University,3951,2195,South Dakota,Town,NA,100.0,99.75,100.0,7,4,14,4,2,8,11,6,22,9.00692084972818,1.7166908837520731
Blackburn College,557,546,Illinois,Town,private,64.83,41.4,89.29,1,0,2,0,0,1,1,0,3,0.798959790522236,0.24370660048593001
Bloomfield College,1839,1700,New Jersey,Suburb,NA,100.0,99.89,100.0,9,5,17,4,2,8,13,7,25,12.598392258995176,0.020301913730217933
Bloomsburg University of Pennsylvania,8578,7863,Pennsylvania,Small City,public,100.0,100.0,100.0,15,9,30,7,4,14,22,13,44,15.310701699636006,7.233951971476015
Blue Mountain College,590,531,Mississippi,Rural,NA,99.87,96.13,100.0,4,2,9,2,1,4,6,3,13,5.714048023908191,0.8594028149192319
Bluefield College,949,829,Virginia,Town,NA,98.88,85.9,99.98,3,1,6,2,1,3,5,2,9,3.5653077936589175,0.915688550562218
Bluefield State College,1380,1099,West Virginia,Town,NA,59.23,32.03,81.34,1,0,1,0,0,1,1,0,2,0.28582085455298645,0.6095659401603577
Bluffton University,735,660,Ohio,Town,NA,83.92,61.69,97.07,1,1,2,1,0,1,2,1,3,1.3902835446034028,0.43464368017560223
Boise State University,20744,12477,Idaho,Midsize City,public,100.0,100.0,100.0,58,23,151,31,11,90,89,34,241,53.57689956203874,35.49484322351591
Boston College,9924,9681,Massachusetts,Small City,private,100.0,100.0,100.0,29,16,55,13,7,27,42,23,82,10.983405317056127,31.04740531855419
Boston University,18086,16840,Massachusetts,Large City,private,100.0,100.0,100.0,56,30,110,26,13,54,82,43,164,17.131562954882128,64.60605713915338
Bowdoin College,1819,1813,Maine,Town,private,99.92,97.41,100.0,5,3,10,2,1,5,7,4,15,0.16238540114770714,6.992023675631843
Bowie State University,5185,4389,Maryland,Suburb,NA,100.0,99.97,100.0,10,6,19,5,2,9,15,8,28,12.620552831766583,2.2102742489204075
Bowling Green State University - Main Campus,14679,13104,Ohio,Town,public,100.0,100.0,100.0,25,13,48,12,6,23,37,19,71,29.714682078523484,6.803347622762483
Bradley University,4645,4512,Illinois,Midsize City,NA,99.97,98.67,100.0,6,3,12,3,1,5,9,4,17,6.211520724354246,1.9768727885747546
Brandeis University,3630,3620,Massachusetts,Small City,NA,100.0,99.98,100.0,11,6,21,5,3,10,16,9,31,3.6540536064480733,11.927114260476422
BreNAu University,1737,1080,Georgia,Small City,NA,99.74,84.56,100.0,4,1,11,2,1,6,6,2,17,4.815240775520082,1.1040613010526015
Brescia University,1177,715,Kentucky,Small City,NA,95.88,75.24,99.95,2,1,5,1,0,3,3,1,8,2.4620281542318416,0.7234731300153814
Brevard College,673,656,North CaroliNA,Town,NA,96.46,79.37,99.93,2,1,5,1,1,2,3,2,7,0.48423589035373515,2.8381025888911697
Brewton - Parker College,782,438,Georgia,Rural,NA,97.43,76.07,99.99,2,1,6,1,0,3,3,1,9,1.8794103213341278,1.7686140950758877
Briar Cliff University,943,720,Iowa,Small City,NA,96.88,76.46,99.98,2,1,6,1,0,3,3,1,9,1.1645667933160313,2.287237796759374
Bridgewater College,1880,1876,Virginia,Suburb,private,99.99,97.97,100.0,6,3,11,3,1,6,9,4,17,7.85940644513929,0.9988937925086543
Bridgewater State University,9562,7858,Massachusetts,Suburb,NA,100.0,100.0,100.0,27,16,50,13,7,24,40,23,74,39.268329570689644,0.8650832884463754
Brigham Young University - Hawaii,3138,2702,Hawaii,Town,private,100.0,99.95,100.0,11,5,26,6,2,14,17,7,40,0.0008514305572542829,17.028971624727852
Brigham Young University - Idaho,51883,17230,Idaho,Town,NA,100.0,100.0,100.0,187,83,453,94,38,254,281,121,707,37.76472140766612,243.41306549418218
Brigham Young University - Provo,31232,28156,Utah,Midsize City,NA,100.0,100.0,100.0,127,54,309,63,25,167,190,79,476,59.65970915242625,130.71661782889743
Brown University,6986,6666,Rhode Island,Midsize City,NA,100.0,100.0,100.0,22,12,44,10,5,22,32,17,66,0.24100489857240323,32.35466029833803
Bryan College - Dayton,1238,833,Tennessee,Town,NA,99.54,89.05,100.0,4,2,9,2,1,4,6,3,13,2.563738658171361,2.800739597384923
Bryant University,3476,3418,Rhode Island,Suburb,private,100.0,99.72,100.0,7,4,14,3,2,7,10,6,21,0.20860751876430966,10.46005689075911
Bryn Athyn College of the New Church,329,313,Pennsylvania,Suburb,private,58.95,38.17,82.87,1,0,1,0,0,1,1,0,2,0.4712257002587756,0.417471308814827
Bryn Mawr College,1340,1325,Pennsylvania,Suburb,NA,99.87,96.62,100.0,4,2,9,2,1,5,6,3,14,0.38855452477477986,6.21728957677789
Bucknell University,3608,3585,Pennsylvania,Town,private,100.0,99.93,100.0,9,5,18,4,2,9,13,7,27,1.793964508002707,11.924944693170414
BueNA Vista University,1805,1522,Iowa,Town,private,99.37,84.17,100.0,3,1,9,2,1,5,5,2,14,3.9266803415655924,1.1342237246036422
Butler University,4288,4182,IndiaNA,Large City,NA,100.0,99.84,100.0,8,4,16,4,2,8,12,6,24,6.491797984910668,5.418735439081331
Cabrini University,1687,1479,Pennsylvania,Suburb,private,99.73,96.07,100.0,4,2,8,2,1,4,6,3,12,1.870435345325403,4.033619107880115
Caldwell University,1605,1440,New Jersey,Suburb,NA,100.0,99.63,100.0,7,4,14,3,2,7,10,6,21,9.710114557697155,0.5587704127548169
California Baptist University,7421,6367,California,Large City,NA,100.0,100.0,100.0,37,19,74,17,8,36,54,27,110,50.153275353271475,3.142504964221234
California Institute of Technology,962,961,California,Midsize City,NA,99.72,94.47,100.0,4,2,8,2,1,4,6,3,12,2.3565379634836443,3.5008264261298647
California Lutheran University,2968,2858,California,Midsize City,private,100.0,100.0,100.0,15,8,30,7,3,14,22,11,44,18.010683006624998,3.3390844246239144
California State University Maritime Academy,1050,1007,California,Midsize City,NA,99.88,96.99,100.0,5,2,9,2,1,4,7,3,13,6.425591092977142,0.27109212321623555
California Polytechnic State University - San Luis Obispo,21348,20584,California,Suburb,NA,100.0,100.0,100.0,104,54,212,48,24,102,152,78,314,139.73831017005188,11.727856408380656
California State Polytechnic University - PomoNA,24318,21668,California,Suburb,NA,100.0,100.0,100.0,122,64,246,56,28,117,178,92,363,176.73302882039295,1.6768164430950105
California State University - Bakersfield,8816,7502,California,Large City,NA,100.0,100.0,100.0,44,23,89,20,10,43,64,33,132,63.809486036067995,0.9411065400224404
California State University - Channel Islands,7054,5858,California,Suburb,NA,100.0,100.0,100.0,35,19,71,16,8,34,51,27,105,51.62428197022866,0.0
California State University - Chico,16709,15446,California,Small City,NA,100.0,100.0,100.0,83,44,168,38,19,80,121,63,248,119.96388291125434,1.4983716533728282
California State University - Dominguez Hills,13279,10084,California,Small City,NA,100.0,100.0,100.0,67,35,134,30,15,64,97,50,198,96.70587779339402,0.3274566417471897
California State University - East Bay,13473,11539,California,Midsize City,NA,100.0,100.0,100.0,67,35,135,31,15,64,98,50,199,97.02057075125053,0.6521202467016196
California State University - Fresno,22260,19432,California,Large City,NA,100.0,100.0,100.0,112,59,225,51,26,107,163,85,332,161.64240372504116,1.2783790850058503
California State University - Fullerton,35161,28475,California,Suburb,public,100.0,100.0,100.0,177,93,355,81,41,169,258,134,524,256.2698443084061,0.942930301132325
California State University - Long Beach,31564,27507,California,Large City,public,100.0,100.0,100.0,158,83,317,72,36,151,230,119,468,228.42317675854505,1.6155567064240115
California State University - Los Angeles,24820,21004,California,Large City,public,100.0,100.0,100.0,125,65,251,57,29,119,182,94,370,180.61912092787685,1.2572632151696328
California State University - Monterey Bay,6762,6109,California,Suburb,NA,100.0,100.0,100.0,34,18,68,16,8,33,50,26,101,48.543218359586994,0.8173199125842693
California State University - Northridge,35836,29739,California,Large City,NA,100.0,100.0,100.0,180,94,361,82,41,171,262,135,532,260.5730875460719,1.0829837868655867
California State University - Sacramento,28449,23491,California,Large City,public,100.0,100.0,100.0,143,75,287,65,33,137,208,108,424,206.47517255827347,1.3231348203013038
California State University - San BerNArdino,18324,16381,California,Midsize City,public,100.0,100.0,100.0,92,48,185,42,21,88,134,69,273,133.5176354217255,0.3662767851299238
California State University - San Marcos,14616,11634,California,Suburb,NA,100.0,100.0,100.0,73,38,147,34,17,70,107,55,217,106.52722545486934,0.5016730612965359
California State University - Stanislaus,9058,7621,California,Suburb,NA,100.0,100.0,100.0,45,24,91,21,10,43,66,34,134,66.02697362282434,0.19776013916178176
California University of Pennsylvania,5553,4534,Pennsylvania,Suburb,public,100.0,99.88,100.0,8,5,16,4,2,8,12,7,24,10.710050783951646,1.4534307456729072
Calumet College of Saint Joseph,624,427,IndiaNA,Suburb,private,79.37,59.36,94.71,1,1,2,1,0,1,2,1,3,1.3372189511171622,0.23896109558876344
Calvin College,3737,3524,Michigan,Midsize City,NA,100.0,99.78,100.0,8,4,18,4,2,9,12,6,27,6.974799928060197,5.4919671679904525
Cambridge College,750,221,Massachusetts,Large City,private,95.83,83.37,99.72,2,1,4,1,1,2,3,2,6,3.1696790586165844,0.001849476427968334
Cameron University,4149,2814,Oklahoma,Small City,NA,100.0,99.71,100.0,10,4,23,5,2,12,15,6,35,10.886663077677328,3.5319952545100874
Campbell University,4382,3634,North CaroliNA,Town,NA,100.0,99.04,100.0,7,3,14,3,1,7,10,4,21,4.960399785396434,4.940174301635249
Campbellsville University,3704,2128,Kentucky,Town,private,100.0,99.14,100.0,7,3,18,4,1,9,11,4,27,8.333018368169311,2.557833964480665
Canisius College,2397,2303,New York,Large City,private,99.92,98.62,100.0,5,3,8,2,1,4,7,4,12,6.5401164945202055,0.5944109134501079
Capella University,9208,1382,Minnesota,Large City,NA,100.0,100.0,100.0,30,14,66,15,6,34,45,20,100,0.16403760517054056,44.25074402242037
Capital University,2703,2493,Ohio,Suburb,NA,99.87,96.97,100.0,5,2,9,2,1,4,7,3,13,5.680301339379617,0.9901875714800467
CardiNAl Stritch University,1542,901,Wisconsin,Suburb,NA,67.48,45.68,89.1,1,0,1,0,0,1,1,0,2,0.6723428109084942,0.44892147793182663
Carleton College,2068,2055,Minnesota,Town,NA,99.92,97.1,100.0,5,2,10,2,1,5,7,3,15,0.2444268951216664,6.884105435977513
Carlos Albizu University - Miami,376,291,Florida,Suburb,NA,99.42,92.99,100.0,3,2,7,2,1,3,5,3,10,5.118330292370227,0.0
Carlow University,1365,1075,Pennsylvania,Large City,NA,94.62,80.24,99.66,2,1,4,1,1,2,3,2,6,2.6020752483587652,0.31632378472139283
Carnegie Mellon University,6530,6298,Pennsylvania,Large City,NA,100.0,100.0,100.0,21,11,42,10,5,21,31,16,63,2.657878291810462,28.258632427628697
Carroll College,1360,1287,MontaNA,Town,NA,99.91,74.14,100.0,4,1,29,3,0,26,7,1,55,4.36110881440534,2.6631280363904595
Carroll University,2983,2737,Wisconsin,Small City,NA,91.5,74.68,99.16,2,1,3,1,0,2,3,1,5,1.09909932561688,1.363994873606301
Carson - Newman University,1688,1608,Tennessee,Suburb,NA,99.93,94.91,100.0,5,2,12,2,1,6,7,3,18,4.104727490191363,3.129047017807918
Carthage College,2740,2596,Wisconsin,Suburb,NA,97.32,85.61,99.94,3,1,5,1,1,2,4,2,7,0.43430527381289713,3.181292481585017
Case Western Reserve University,5147,4978,Ohio,Large City,private,100.0,99.99,100.0,12,6,24,6,3,12,18,9,36,4.864824100612243,12.840731633054824
Castleton University,1857,1590,Vermont,Town,NA,88.39,69.45,98.24,1,1,3,1,0,1,2,1,4,0.007092882358805914,2.1410159915621616
Catawba College,1322,1268,North CaroliNA,Suburb,NA,95.56,77.16,99.88,2,1,4,1,0,2,3,1,6,1.5090453646757676,1.5949104407084465
Catholic University of America,3308,3194,District of Columbia,Large City,NA,100.0,99.92,100.0,9,5,18,4,2,9,13,7,27,0.08326150469307217,13.524214558390051
Cazenovia College,897,713,New York,Town,NA,94.6,81.38,99.59,2,1,4,1,1,2,3,2,6,1.9953880923414198,0.9173692573017955
Cedar Crest College,1432,931,Pennsylvania,Midsize City,NA,97.52,87.13,99.93,3,1,5,1,1,2,4,2,7,2.0502451520030935,1.641990269906803
Cedarville University,3536,3109,Ohio,Town,private,100.0,99.45,100.0,7,4,14,3,2,7,10,6,21,2.860011863184143,7.458559354753819
CenteNAry University,1366,1125,New Jersey,Suburb,private,99.98,99.07,100.0,6,3,12,3,1,6,9,4,18,7.798349793504656,0.8588915270336669
CenteNAry College of LouisiaNA,536,524,LouisiaNA,Midsize City,NA,99.55,90.41,100.0,4,2,8,2,1,4,6,3,12,2.4997912301703975,2.864596378952652
Central Baptist College,745,599,Arkansas,Small City,private,91.23,64.39,99.61,2,1,4,1,0,2,3,1,6,1.1276989681583867,1.2941846887770034
Central Christian College of Kansas,869,730,Kansas,Town,NA,99.42,89.22,100.0,3,2,8,2,1,4,5,3,12,0.21675976183659104,4.883384394156103
Central College,1232,1198,Iowa,Town,NA,98.17,77.1,100.0,3,1,7,1,0,4,4,1,11,2.9771104947079055,1.010865616588558
Central Connecticut State University,9550,7605,Connecticut,Suburb,NA,99.78,97.65,100.0,4,3,7,2,1,3,6,4,10,4.210795457376904,1.90608413766069
Central Methodist University - College of Liberal Arts & Sciences,1058,1034,Missouri,Town,NA,90.68,60.45,99.74,2,1,4,1,0,2,3,1,6,1.674480327063066,0.692232278980475
Central Michigan University,17801,15585,Michigan,Town,NA,100.0,100.0,100.0,39,19,86,19,8,44,58,27,130,55.90656126547123,1.8841452109892505
Central Penn College,1197,316,Pennsylvania,Suburb,NA,94.41,79.94,99.62,2,1,4,1,0,2,3,1,6,2.0171766818094956,0.8626190581492034
Central State University,1788,1710,Ohio,Rural,public,99.11,90.95,99.99,3,2,6,1,1,3,4,3,9,2.137999064390107,2.578855127919455
Central Washington University,12080,10446,Washington,Town,NA,100.0,100.0,100.0,29,19,49,15,9,27,44,28,76,42.53332177129383,1.4038566650672237
Centre College,1447,1449,Kentucky,Town,NA,99.23,88.16,100.0,3,1,8,2,1,4,5,2,12,2.080624220082678,2.7692050849004812
Chadron State College,2151,1616,Nebraska,Town,NA,85.76,63.37,98.56,1,1,3,1,0,1,2,1,4,0.21386719321199787,1.7303740807476642
ChamiNAde University of Honolulu,1813,1524,Hawaii,Large City,NA,99.2,90.72,100.0,3,2,7,2,1,3,5,3,10,0.0022424690520930985,4.796216543379487
Champlain College,3933,2603,Vermont,Small City,NA,100.0,99.52,100.0,7,4,13,3,2,6,10,6,19,0.004423945299423296,9.881235710350078
Chapman University,7023,6515,California,Midsize City,NA,100.0,100.0,100.0,32,16,65,15,7,32,47,23,97,34.58695160069473,11.94945435026636
Charleston Southern University,3062,2804,South CaroliNA,Midsize City,private,100.0,100.0,100.0,27,13,53,14,7,28,41,20,81,36.86145495289166,3.552854710308571
Chatham University,1207,951,Pennsylvania,Large City,NA,97.08,84.31,99.92,2,1,5,1,1,2,3,2,7,1.6451563921315147,1.8764759937775082
Chestnut Hill College,1363,1118,Pennsylvania,Large City,NA,99.11,92.32,99.99,3,2,6,1,1,3,4,3,9,1.5645519960346188,3.1492964719511285
Cheyney University of Pennsylvania,718,671,Pennsylvania,Suburb,public,85.39,65.53,97.62,1,1,3,1,0,1,2,1,4,1.0623246049693449,0.8578278788907808
Chicago State University,2032,1297,Illinois,Large City,NA,96.57,83.82,99.89,2,1,5,1,1,2,3,2,7,3.061112609177351,0.30734133678994263
Chowan University,1500,1440,North CaroliNA,Town,private,99.63,92.15,100.0,4,2,7,2,1,4,6,3,11,0.8879893612580961,4.685104045112428
Christian Brothers University,1789,1426,Tennessee,Large City,NA,99.97,96.4,100.0,6,2,13,3,1,6,9,3,19,5.15493368751457,2.9239447725885253
Christopher Newport University,4951,4867,Virginia,Midsize City,NA,100.0,100.0,100.0,17,7,31,9,4,17,26,11,48,24.684513371391446,0.7042618958377814
Citadel Military College of South CaroliNA,2837,2559,South CaroliNA,Midsize City,NA,100.0,100.0,100.0,20,10,41,10,5,22,30,15,63,23.455870785011076,7.278779922837958
City University of Seattle,929,235,Washington,Large City,NA,97.73,90.6,99.85,2,2,4,1,1,2,3,3,6,3.109342567422992,0.6661214248609184
Claflin University,2040,1955,South CaroliNA,Town,private,100.0,100.0,100.0,17,8,33,9,4,18,26,12,51,22.894053520699433,2.1990766275718916
Claremont McKenNA College,1341,1337,California,Suburb,NA,99.96,98.06,100.0,5,3,11,3,1,6,8,4,17,4.574025550239993,3.194086065855024
Clarion University of Pennsylvania,4319,3483,Pennsylvania,Town,public,99.99,99.45,100.0,6,4,12,3,2,6,9,6,18,8.391124311625566,1.0086426502004624
Clark Atlanta University,3305,3187,Georgia,Large City,NA,100.0,99.97,100.0,12,6,27,6,3,14,18,9,41,2.5737147712537416,15.519647748762004
Clark University,2240,2199,Massachusetts,Midsize City,private,99.95,98.25,100.0,5,3,10,2,1,5,7,4,15,3.6370580082785473,3.882517932278517
Clarke University,765,708,Iowa,Small City,NA,87.7,57.63,99.58,1,1,4,1,0,2,2,1,6,1.0869290070949624,1.003467326560042
Clarkson University,3086,3021,New York,Town,private,99.98,99.31,100.0,6,3,10,3,2,5,9,5,15,6.316795443487808,2.2549185798720535
Clayton State University,6553,3743,Georgia,Suburb,NA,100.0,99.71,100.0,14,4,41,6,2,21,20,6,62,19.006584316549436,1.2472142958370758
Clemson University,19409,18642,South CaroliNA,Suburb,public,100.0,100.0,100.0,142,70,283,73,35,151,215,105,434,183.01197384951757,31.849000234358712
Cleveland State University,12077,9268,Ohio,Large City,NA,100.0,100.0,100.0,20,11,37,9,5,18,29,16,55,27.167776089250022,1.5740586340463047
Coastal CaroliNA University,9899,9021,South CaroliNA,Small City,NA,100.0,100.0,100.0,61,31,120,31,15,63,92,46,183,72.88018400931585,18.905916302257975
Coe College,1393,1369,Iowa,Midsize City,private,97.98,78.52,100.0,3,1,7,1,0,3,4,1,10,2.188788357693977,1.7007042585230012
Cogswell College,606,436,California,Large City,NA,98.29,87.79,99.97,3,1,6,1,1,3,4,2,9,3.90804743012505,0.14384001064419996
Coker College,1025,909,South CaroliNA,Town,private,100.0,99.92,100.0,10,5,19,5,2,10,15,7,29,12.828160868449173,1.6746028299655988
Colby College,1923,1917,Maine,Town,NA,99.73,95.74,100.0,4,2,8,2,1,4,6,3,12,0.16878482582347884,5.743661430662829
Colby - Sawyer College,983,920,New Hampshire,Rural,NA,87.23,63.59,98.07,1,1,3,1,0,1,2,1,4,0.2452359610420097,1.8089086340367995
Colgate University,2882,2854,New York,Town,private,100.0,99.74,100.0,7,4,14,3,2,7,10,6,21,2.3434208991451557,8.639366107628014
College of Charleston,9901,9083,South CaroliNA,Midsize City,public,100.0,100.0,100.0,65,32,129,33,16,69,98,48,198,77.56199454524621,20.12036233678677
College of Mount Saint Vincent,1693,1613,New York,Large City,NA,99.42,95.36,99.99,4,2,6,2,1,3,6,3,9,4.382313092337043,0.75204334472629
Mount St. Joseph University,1315,1000,Ohio,Suburb,NA,96.81,83.48,99.88,2,1,5,1,1,2,3,2,7,2.476807659293457,0.9621792470441292
Notre Dame of Maryland University,817,528,Maryland,Large City,NA,91.84,73.48,99.18,2,1,3,1,0,2,3,1,5,1.8655271325558902,0.6348312719374041
College of Our Lady of the Elms,1174,973,Massachusetts,Suburb,private,98.27,89.84,99.95,3,2,5,1,1,2,4,3,7,3.7602760950076104,0.286922164227494
College of Saint Benedict,1940,1916,Minnesota,Suburb,NA,84.66,59.4,98.2,1,1,3,1,0,1,2,1,4,0.8739619427794695,0.9962613625511
College of Saint Elizabeth,757,587,New Jersey,Suburb,NA,99.45,93.97,100.0,4,2,7,2,1,3,6,3,10,5.157638752317895,0.019289054546368138
College of Saint Mary,833,761,Nebraska,Large City,NA,55.85,28.0,87.35,1,0,1,0,0,1,1,0,2,0.10676651286130207,0.7089576724814562
Northeast Catholic College,69,70,New Hampshire,Rural,NA,13.58,5.78,26.41,0,0,0,0,0,0,0,0,0,0.021324866177566064,0.12435047019342198
College of the Atlantic,352,330,Maine,Town,private,62.59,39.3,85.77,1,0,1,0,0,1,1,0,2,0.06559410292666001,0.9150364320640989
College of the Holy Cross,2852,2827,Massachusetts,Midsize City,private,100.0,99.64,100.0,7,4,13,3,2,6,10,6,19,4.605807103941525,5.72514924067736
College of the Ozarks,1510,1477,Missouri,Town,private,93.2,64.4,99.88,2,1,5,1,0,2,3,1,7,2.150184965433255,0.5355603223820503
College of William and Mary,6287,6199,Virginia,Suburb,NA,100.0,100.0,100.0,21,10,40,11,5,21,32,15,61,21.145421076215314,10.347832816926493
Colorado Christian University,6541,1840,Colorado,Midsize City,NA,100.0,100.0,100.0,17,7,40,8,3,21,25,10,61,3.0474614989628575,21.624046099155116
Colorado College,2106,2091,Colorado,Large City,private,99.95,97.38,100.0,5,3,11,2,1,6,7,4,17,0.42652694724866247,7.18253517853649
Colorado School of Mines,4790,4584,Colorado,Suburb,public,100.0,99.94,100.0,12,5,29,6,2,15,18,7,44,3.1072733237494514,14.513522793764915
Colorado State University - Fort Collins,25523,22154,Colorado,Midsize City,public,100.0,100.0,100.0,32,13,82,15,6,41,47,19,123,20.446819381554846,26.16394982352091
Colorado State University - Pueblo,4627,3292,Colorado,Midsize City,NA,99.95,95.47,100.0,5,2,13,2,1,6,7,3,19,3.9799376526030366,3.5901362474902414
Colorado Technical University - Colorado Springs,22305,14445,Colorado,Large City,NA,100.0,99.98,100.0,16,6,45,7,3,21,23,9,66,21.282223885131536,1.9881776499392125
Columbia College Chicago,7029,6436,Illinois,Large City,NA,100.0,99.99,100.0,13,6,26,6,3,13,19,9,39,5.946767382004721,12.479427978409138
Columbia College Missouri,12747,5163,Missouri,Midsize City,private,100.0,100.0,100.0,34,16,78,16,7,39,50,23,117,12.278369175096737,38.540713546748826
Columbia College South CaroliNA,1383,804,South CaroliNA,Midsize City,NA,100.0,99.99,100.0,13,6,25,7,3,14,20,9,39,18.477545581805135,0.8867423622985549
Columbia InterNAtioNAl University,497,454,South CaroliNA,Midsize City,NA,99.65,93.69,100.0,4,2,7,2,1,4,6,3,11,4.510144149612908,1.1108690603613967
Columbia Southern University,15049,8567,Alabama,Town,private,100.0,100.0,100.0,68,32,151,34,15,80,102,47,231,4.69447734871743,97.24199442200288
Columbia University in the City of New York,8157,7592,New York,Large City,NA,100.0,100.0,100.0,29,15,59,14,7,29,43,22,88,5.806347326842329,37.35852289584308
Columbus State University,6798,4693,Georgia,Midsize City,NA,100.0,99.85,100.0,15,5,42,7,2,21,22,7,63,18.393082539680808,2.841270332568159
Concord University,1853,1696,West Virginia,Town,public,91.62,67.1,99.09,2,1,3,1,0,2,3,1,5,0.32053411291352263,2.152023229566293
Concordia College at Moorhead,2032,1997,Minnesota,Suburb,NA,99.13,81.34,100.0,3,1,10,2,1,7,5,2,17,0.7664141089259362,3.9667088040376726
Concordia College - New York,1131,1024,New York,Suburb,NA,97.46,88.22,99.86,3,1,4,1,1,2,4,2,6,2.6421490583183624,1.0224950873034504
Concordia University - Ann Arbor,906,780,Michigan,Midsize City,NA,95.79,77.57,99.91,2,1,5,1,0,2,3,1,7,2.4615012904009435,0.6981565197477999
Concordia University - Chicago,1458,1299,Illinois,Suburb,private,97.24,83.92,99.96,2,1,5,1,1,3,3,2,8,1.5603214732551902,2.017459716409254
Concordia University - Irvine,1851,1645,California,Large City,private,100.0,99.86,100.0,9,5,19,4,2,9,13,7,28,10.867884707370223,2.2032830270727963
Concordia University - Portland,1378,1124,Oregon,Large City,NA,97.94,88.7,99.98,3,1,5,1,1,3,4,2,8,1.1113970670061315,2.758872109414694
Concordia University - Saint Paul,2867,1417,Minnesota,Large City,NA,95.24,76.67,99.85,2,1,4,1,0,2,3,1,6,1.0917734648767767,1.9440745282995582
Concordia University - Nebraska,1682,1231,Nebraska,Town,NA,97.89,81.65,99.99,3,1,6,1,1,3,4,2,9,0.13349991201280179,3.7016404642686007
Concordia University - Texas,1725,1347,Texas,Large City,NA,100.0,100.0,100.0,21,9,49,11,4,27,32,13,76,31.246407498450218,0.5396428742463366
Concordia University - Wisconsin,3713,2616,Wisconsin,Suburb,NA,99.74,95.05,100.0,4,2,8,2,1,4,6,3,12,1.2963735635481148,4.631797272491622
Connecticut College,1815,1766,Connecticut,Small City,private,99.83,96.57,100.0,4,2,8,2,1,4,6,3,12,0.14472153048852213,6.1912397510299035
Converse College,920,860,South CaroliNA,Small City,NA,100.0,99.67,100.0,8,4,16,4,2,8,12,6,24,10.346801284406084,1.3498922690036257
Cooper Union for the Advancement of Science and Art,864,859,New York,Large City,NA,98.78,90.46,99.98,3,2,6,1,1,3,4,3,9,1.2529181044934496,3.136512271968373
Coppin State University,2509,1854,Maryland,Large City,NA,99.95,98.35,100.0,5,3,10,2,1,5,7,4,15,5.701293408062241,1.9263634553089322
Corban University,1021,936,Oregon,Midsize City,private,96.93,83.88,99.98,2,1,5,1,1,3,3,2,8,0.6559306297317354,2.8156279815912697
Cornell College,1006,1002,Iowa,Town,private,98.29,83.5,99.99,3,1,6,1,1,3,4,2,9,0.4150635494126368,3.6302396545130917
Cornell University,14907,14898,New York,Small City,NA,100.0,100.0,100.0,47,25,92,22,11,46,69,36,138,15.53386427700675,53.516364849834495
Cornerstone University,1757,1260,Michigan,Midsize City,NA,99.58,92.42,100.0,4,2,8,2,1,4,6,3,12,4.4608565329369965,1.0068329752823886
CoveNAnt College,1033,983,Georgia,Rural,private,99.39,89.8,100.0,3,2,8,2,1,4,5,3,12,0.7631363565926792,4.318022979384441
Creighton University,4256,4011,Nebraska,Large City,NA,99.98,97.93,100.0,6,3,13,3,1,7,9,4,20,0.1968246512529168,8.483412492785325
Crown College,1055,698,Minnesota,Rural,NA,78.74,46.3,99.78,1,0,3,1,0,3,2,0,6,0.37152888058493294,1.1730907023604689
Culver - Stockton College,1092,969,Missouri,Rural,NA,92.12,67.06,99.75,2,1,4,1,0,2,3,1,6,0.9738971323724236,1.5581523847077274
Cumberland University,1974,1578,Tennessee,Town,NA,99.9,92.59,100.0,5,2,12,2,1,5,7,3,17,5.810454549242455,1.0495049671293633
CUNY BerNArd M Baruch College,15253,11598,New York,Large City,NA,100.0,100.0,100.0,31,19,51,14,8,25,45,27,76,43.826031196760454,0.9765129371055213
CUNY Brooklyn College,14691,10786,New York,Large City,NA,100.0,100.0,100.0,30,18,50,14,8,24,44,26,74,41.442006470154865,1.9150025231204064
CUNY City College,13211,10225,New York,Large City,public,100.0,100.0,100.0,26,16,44,12,7,21,38,23,65,38.02548441669819,0.47304795143884476
College of Staten Island CUNY,12509,9710,New York,Large City,public,100.0,100.0,100.0,25,15,41,11,7,20,36,22,61,36.26501846894929,0.03438425834878596
CUNY Graduate School and University Center,2066,418,New York,Large City,NA,99.75,97.39,100.0,4,3,7,2,1,3,6,4,10,5.991964823804321,0.0
CUNY Hunter College,16846,12612,New York,Large City,NA,100.0,100.0,100.0,34,21,58,16,9,28,50,30,86,47.45137293429937,2.6614199839566206
CUNY John Jay College of CrimiNAl Justice,12916,10276,New York,Large City,public,100.0,100.0,100.0,26,16,43,12,7,21,38,23,64,37.401925637841494,0.13753703339514384
CUNY Lehman College,11978,7216,New York,Large City,NA,100.0,100.0,100.0,24,15,40,11,6,19,35,21,59,34.684369471382325,0.13066018172538665
CUNY Queens College,16680,12149,New York,Large City,NA,100.0,100.0,100.0,33,20,55,15,9,27,48,29,82,48.3765601457193,0.0
CUNY York College,8393,5056,New York,Large City,NA,100.0,100.0,100.0,17,10,28,8,5,13,25,15,41,24.3419945625313,0.0
Curry College,2561,2059,Massachusetts,Suburb,private,99.99,99.3,100.0,6,3,11,3,2,5,9,5,16,7.023430943556587,1.8767731195711723
Daemen College,1799,1560,New York,Suburb,NA,99.56,96.08,99.99,4,2,6,2,1,3,6,3,9,4.950766676783145,0.4663622756269729
Dakota State University,2963,1397,South Dakota,Town,public,99.99,99.44,100.0,6,4,11,3,2,6,9,6,17,6.865562208228949,2.2516294702026376
Dakota Wesleyan University,793,668,South Dakota,Town,NA,93.71,78.11,99.41,2,1,3,1,0,2,3,1,5,1.7659451349250315,0.9915227624287077
Dallas Baptist University,3159,2423,Texas,Large City,NA,100.0,100.0,100.0,38,16,87,20,8,48,58,24,135,56.356872561307334,0.9670199344025866
Dartmouth College,4415,4360,New Hampshire,Town,NA,100.0,100.0,100.0,14,7,28,7,3,14,21,10,42,0.09432152347769604,20.307167615867748
Davenport University,5597,2621,Michigan,Suburb,NA,100.0,99.98,100.0,12,6,27,6,3,14,18,9,41,17.88931297337996,0.2865618435817349
Davidson College,1812,1810,North CaroliNA,Suburb,private,99.98,98.3,100.0,6,3,12,3,1,6,9,4,18,0.5311839683658701,7.90828547845009
Davis & Elkins College,839,785,West Virginia,Town,NA,78.12,49.98,96.11,1,0,2,1,0,1,2,0,3,0.12825872731912405,1.3859847191418688
Defiance College,583,525,Ohio,Town,NA,84.3,61.47,97.51,1,1,2,1,0,1,2,1,3,0.9626837317253814,0.8842667230340125
Delaware State University,4054,3571,Delaware,Small City,NA,100.0,99.73,100.0,7,4,14,3,2,7,10,6,21,0.8631543193509672,9.890267198676737
Delaware Valley University,1991,1756,Pennsylvania,Suburb,private,99.92,97.86,100.0,5,3,9,2,1,5,7,4,14,2.217654282358185,4.839897282514985
Delta State University,3034,2198,Mississippi,Town,NA,100.0,100.0,100.0,26,13,51,13,6,25,39,19,76,34.416150790154724,4.182902712291936
Denison University,2344,2319,Ohio,Suburb,NA,99.91,97.25,100.0,5,2,10,2,1,5,7,3,15,1.5187971495667425,5.526817597524749
DePaul University,14822,12886,Illinois,Large City,NA,100.0,100.0,100.0,22,12,46,10,5,22,32,17,68,16.303479490127273,16.40298737613672
DePauw University,2156,2140,IndiaNA,Town,NA,99.83,96.51,100.0,4,2,9,2,1,4,6,3,13,2.5572883787390177,3.8285671384983395
DeSales University,2350,1811,Pennsylvania,Suburb,private,99.94,98.35,100.0,5,3,10,2,1,5,7,4,15,3.1167033157466384,4.345013187909442
Dickinson College,2386,2346,Pennsylvania,Small City,private,99.98,98.93,100.0,6,3,11,3,1,6,9,4,17,1.020989017227347,7.553162407114007
Dickinson State University,1426,922,North Dakota,Town,public,100.0,96.76,100.0,6,2,22,4,1,16,10,3,38,6.988260141038568,3.3598932118428815
DigiPen Institute of Technology,1024,964,Washington,Small City,NA,98.59,89.89,99.98,3,2,6,1,1,3,4,3,9,1.7611082461784748,2.4852573451938995
Dillard University,1292,1200,LouisiaNA,Large City,NA,100.0,98.92,100.0,7,3,15,3,1,7,10,4,22,5.985214431093694,4.003607075437375
Doane University,1066,1062,Nebraska,Town,NA,62.9,35.88,89.95,1,0,1,0,0,1,1,0,2,0.15004120273779226,0.8358302747344455
Dominican College of Blauvelt,1420,1271,New York,Suburb,private,99.49,95.1,99.99,4,2,6,2,1,3,6,3,9,3.1438963547937484,2.1129525517256496
Dominican University,2171,2014,Illinois,Suburb,NA,97.15,85.35,99.93,2,1,5,1,1,2,3,2,7,3.122209534334934,0.43157750027424996
Dominican University of California,1304,1135,California,Small City,private,99.99,99.08,100.0,6,3,13,3,1,6,9,4,19,8.489391421245427,0.6070341316538632
Dordt College,1445,1341,Iowa,Town,NA,99.6,90.58,100.0,4,2,10,2,1,6,6,3,16,1.5945606862327197,3.904796696813842
Drake University,3100,2955,Iowa,Midsize City,NA,99.82,93.07,100.0,4,2,10,2,1,5,6,3,15,2.8158627848641475,3.512709365520631
Drew University,1534,1507,New Jersey,Suburb,private,99.99,99.14,100.0,6,3,12,3,1,6,9,4,18,6.649915564655205,2.246134669093493
Drexel University,15528,13572,Pennsylvania,Large City,private,100.0,100.0,100.0,42,23,82,19,10,40,61,33,122,14.213241845085964,46.869519726415064
Drury University,3277,2478,Missouri,Midsize City,NA,99.87,92.24,100.0,5,2,11,2,1,5,7,3,16,5.1237714140090915,1.5120508961591534
Duke University,6699,6669,North CaroliNA,Large City,NA,100.0,100.0,100.0,26,13,53,12,6,27,38,19,80,1.2058949180831244,36.81192310917014
Duquesne University,5941,5826,Pennsylvania,Large City,NA,100.0,99.97,100.0,10,5,19,5,2,9,15,7,28,8.969822540013535,5.6628910535364705
D'Youville College,1734,1295,New York,Large City,private,99.33,95.13,99.98,3,2,6,2,1,3,5,3,9,4.788351366941401,0.2126976577847389
Earlham College,1061,1051,IndiaNA,Town,private,97.22,84.1,99.95,2,1,5,1,1,3,3,2,8,0.7314701954828922,2.8416587910192126
East CaroliNA University,23267,19999,North CaroliNA,Small City,public,100.0,100.0,100.0,28,13,60,13,6,28,41,19,88,26.956245020910423,13.95107631384758
East Central University,3082,2551,Oklahoma,Town,NA,100.0,98.82,100.0,7,3,17,4,1,9,11,4,26,8.21517603316809,2.774733287943405
East Stroudsburg University of Pennsylvania,6051,5552,Pennsylvania,Small City,public,100.0,100.0,100.0,13,8,26,6,3,12,19,11,38,8.593668691561355,11.051709961809692
East Tennessee State University,11319,9641,Tennessee,Small City,NA,100.0,100.0,100.0,27,11,66,12,4,31,39,15,97,33.96009909318021,5.72190250010837
East Texas Baptist University,1421,1216,Texas,Town,NA,100.0,100.0,100.0,17,8,40,9,4,22,26,12,62,25.598995511550836,0.6540634232033711
Eastern Connecticut State University,5069,4210,Connecticut,Town,public,96.95,88.45,99.78,2,1,4,1,1,2,3,2,6,2.1731348028627924,1.314009799924166
Eastern Illinois University,5569,4319,Illinois,Town,NA,99.99,99.3,100.0,6,3,13,3,1,6,9,4,19,8.534770468166943,0.6216011047318483
Eastern Kentucky University,14138,10744,Kentucky,Town,NA,100.0,100.0,100.0,25,11,60,12,5,29,37,16,89,31.916933358385865,5.550751639057057
Eastern Mennonite University,1102,942,Virginia,Small City,NA,98.92,87.58,99.98,3,1,6,2,1,3,5,2,9,3.056727123092866,1.462004850274802
Eastern Michigan University,17218,12410,Michigan,Suburb,NA,100.0,100.0,100.0,37,18,82,18,8,42,55,26,124,49.010424494494416,6.587721876504862
Eastern Nazarene College,694,571,Massachusetts,Suburb,private,92.4,75.12,99.28,2,1,3,1,0,2,3,1,5,1.538101634342096,1.031614684133294
Eastern New Mexico University - Main Campus,4600,2590,New Mexico,Town,NA,100.0,100.0,100.0,22,8,57,10,3,29,32,11,86,18.839377952543387,13.633134431533746
Eastern Oregon University,2736,1668,Oregon,Town,public,99.87,96.79,100.0,4,2,10,2,1,6,6,3,16,2.917048800537313,3.6905597442689726
Eastern University,1882,1462,Pennsylvania,Suburb,NA,99.81,96.47,100.0,4,2,8,2,1,4,6,3,12,1.9448394032609992,4.311690951394434
Eastern Washington University,11474,10060,Washington,Town,NA,100.0,100.0,100.0,28,18,48,15,9,27,43,27,75,39.19379285634128,3.2593200603912322
Eckerd College,2036,1915,Florida,Large City,private,100.0,99.58,100.0,7,4,15,4,2,8,11,6,23,5.036654808981341,5.798223245692464
Edgewood College,1566,1361,Wisconsin,Large City,NA,62.75,43.01,84.53,1,0,1,0,0,1,1,0,2,0.7266938764609774,0.2601783751249578
Edinboro University of Pennsylvania,4294,3888,Pennsylvania,Town,public,99.99,99.55,100.0,7,4,13,3,2,6,10,6,19,7.6305494971728045,2.0766141999472785
Edward Waters College,3443,853,Florida,Large City,private,100.0,100.0,100.0,28,14,57,13,7,28,41,21,85,37.380146230980436,3.7641813163614906
Elizabeth City State University,1365,1179,North CaroliNA,Town,NA,89.54,65.52,99.24,2,1,3,1,0,2,3,1,5,1.641841356767235,0.6129589875191015
Elizabethtown College,1674,1636,Pennsylvania,Suburb,private,99.32,93.53,99.99,3,2,7,2,1,3,5,3,10,2.108114974841891,2.865455115134575
Elmhurst College,2874,2732,Illinois,Suburb,private,99.71,95.37,100.0,4,2,8,2,1,4,6,3,12,3.8585058118750335,1.9775431451312473
Elmira College,936,833,New York,Small City,NA,93.16,77.91,99.28,2,1,3,1,0,2,3,1,5,1.3399263061943836,1.3373229369081547
Elon University,6049,5885,North CaroliNA,Suburb,NA,100.0,100.0,100.0,15,8,30,7,3,15,22,11,45,2.054984443274023,19.722244821119176
Embry Riddle AeroNAutical University - DaytoNA Beach,5733,5378,Florida,Small City,NA,100.0,100.0,100.0,27,14,56,13,6,28,40,20,84,22.392695029119743,17.716967028931016
Embry Riddle AeroNAutical University - Prescott,2607,2471,ArizoNA,Rural,NA,100.0,99.94,100.0,10,5,22,5,2,11,15,7,33,3.1429367967204542,11.940989825057269
Emerson College,3814,3748,Massachusetts,Large City,NA,100.0,99.99,100.0,12,6,24,6,3,12,18,9,36,2.974229679667036,14.482969769833135
Emmanuel College Georgia,954,822,Georgia,Town,NA,99.1,84.73,100.0,3,1,8,2,1,4,5,2,12,2.0589718170029934,2.630183924941069
Emmanuel College Massachusetts,1947,1804,Massachusetts,Large City,NA,99.89,97.6,100.0,5,3,9,2,1,4,7,4,13,5.345115624315903,1.4380098359288949
Emory and Henry College,999,966,Virginia,Rural,NA,99.05,86.61,99.99,3,1,6,2,1,3,5,2,9,2.946622029465164,1.6916736977218507
Emory University,6938,6794,Georgia,Large City,NA,100.0,100.0,100.0,27,13,59,13,6,30,40,19,89,5.518523300223139,34.13360279557883
Emporia State University,3605,3340,Kansas,Town,NA,99.36,90.94,100.0,3,2,7,2,1,3,5,3,10,2.326979796186933,2.700946306502144
Endicott College,3348,2946,Massachusetts,Suburb,NA,99.99,99.41,100.0,6,4,12,3,2,6,9,6,18,6.692016779250832,2.686684700987496
Erskine College,573,568,South CaroliNA,Rural,NA,99.94,97.45,100.0,5,2,10,3,1,5,8,3,15,6.851049417578086,0.5915334316248171
Eureka College,615,593,Illinois,Town,private,62.43,41.37,86.08,1,0,1,0,0,1,1,0,2,0.9399526947320422,0.038349700156631
Evangel University,1632,1461,Missouri,Midsize City,NA,99.83,94.03,100.0,4,2,10,2,1,5,6,3,15,0.9669777921779481,5.38086180757644
Everglades University,2101,2099,Florida,Small City,NA,100.0,100.0,100.0,16,8,33,8,4,16,24,12,49,21.317301164499405,2.6761323562066037
Fairfield University,4118,3879,Connecticut,Suburb,private,100.0,99.94,100.0,9,5,17,4,2,8,13,7,25,0.5298749966129277,12.626611310935237
Fairleigh Dickinson University - Florham Campus,2747,2640,New Jersey,Suburb,NA,100.0,99.99,100.0,12,6,23,5,3,11,17,9,34,15.369763481907325,1.7955265335161281
Fairleigh Dickinson University - Metropolitan Campus,5471,2374,New Jersey,Suburb,NA,100.0,100.0,100.0,24,13,48,11,6,23,35,19,71,32.32120284785881,2.8571745673737947
Fairmont State University,3661,3108,West Virginia,Town,public,87.3,61.72,98.27,1,1,3,1,0,1,2,1,4,0.7634662731632217,1.2940290920259159
Farmingdale State College,9552,7407,New York,Suburb,NA,100.0,100.0,100.0,19,12,32,9,5,15,28,17,47,27.575799392416016,0.13234214490643825
Faulkner University,2673,1744,Alabama,Midsize City,NA,100.0,99.93,100.0,11,5,23,5,2,11,16,7,34,10.860512718445621,5.183776031408039
Fayetteville State University,5394,3905,North CaroliNA,Midsize City,NA,99.98,98.23,100.0,6,3,13,3,1,6,9,4,19,6.832957411251876,1.7104734320898538
Felician University,1626,1430,New Jersey,Suburb,NA,100.0,99.73,100.0,7,4,15,3,2,7,10,6,22,10.487198796379719,0.3963155370711372
Ferris State University,12513,8469,Michigan,Town,public,100.0,100.0,100.0,27,13,60,13,6,31,40,19,91,38.71210617966118,1.7129423199143385
Ferrum College,1137,1118,Virginia,Rural,NA,99.59,90.89,100.0,4,2,7,2,1,4,6,3,11,4.765977624170524,0.7190649368654611
Finlandia University,399,336,Michigan,Town,NA,78.55,51.02,97.17,1,0,2,1,0,1,2,0,3,1.039009199809719,0.4953091463921967
Fisk University,663,639,Tennessee,Large City,NA,95.68,74.12,99.94,2,1,5,1,0,2,3,1,7,0.8236911351554573,2.3031991227139375
Fitchburg State University,4119,3386,Massachusetts,Suburb,public,100.0,99.99,100.0,11,6,21,5,3,10,16,9,31,16.10332926562581,0.35212374118791623
Five Towns College,626,591,New York,Suburb,NA,85.8,68.73,96.69,1,1,2,1,0,1,2,1,3,1.5951503645171234,0.3534007463165529
Flagler College - St Augustine,2681,2591,Florida,Suburb,NA,100.0,100.0,100.0,17,9,35,8,4,17,25,13,52,20.976986650379043,4.5508842274647785
Florida Agricultural and Mechanical University,8027,6875,Florida,Midsize City,NA,100.0,100.0,100.0,64,33,131,31,15,65,95,48,196,88.45454851016419,7.053027980512368
Florida Atlantic University,25033,16325,Florida,Small City,public,100.0,100.0,100.0,216,113,434,105,53,217,321,166,651,312.721813315482,7.9740985406107106
Florida Gulf Coast University,13857,10973,Florida,Suburb,NA,100.0,100.0,100.0,119,63,240,58,29,120,177,92,360,173.00228639822663,4.083043598475067
Florida Institute of Technology,3634,3269,Florida,Small City,private,100.0,100.0,100.0,21,11,42,10,5,21,31,16,63,22.923585671147507,7.856758293676158
Florida InterNAtioNAl University,47621,26655,Florida,Suburb,public,100.0,100.0,100.0,424,223,855,207,103,427,631,326,1282,622.9525243876029,8.007374179281094
Florida Memorial University,1173,1129,Florida,Suburb,private,100.0,99.93,100.0,10,5,19,5,2,10,15,7,29,13.47645475916629,0.6447809979657908
Florida Southern College,2615,2356,Florida,Midsize City,NA,100.0,100.0,100.0,17,9,34,8,4,17,25,13,51,21.752903742573466,3.058348625649317
Florida State University,33009,29286,Florida,Midsize City,NA,100.0,100.0,100.0,285,149,576,139,69,288,424,218,864,412.2706149859699,11.649816529335586
Fontbonne University,892,765,Missouri,Suburb,NA,85.36,53.7,99.16,1,1,3,1,0,2,2,1,5,1.2921867813182957,0.6242917183475953
Fordham University,9595,9132,New York,Large City,NA,100.0,100.0,100.0,27,15,52,13,7,26,40,22,78,11.943325820148207,27.673881195869342
Fort Hays State University,12499,5889,Kansas,Town,NA,100.0,99.98,100.0,11,6,22,5,3,11,16,9,33,6.932770552597113,9.785688089179258
Fort Lewis College,3303,2921,Colorado,Town,public,99.98,97.03,100.0,6,2,14,3,1,7,9,3,21,2.0934138675307916,6.2053194031641175
Fort Valley State University,2345,2115,Georgia,Town,NA,99.96,90.97,100.0,5,2,15,2,1,8,7,3,23,6.470199227268127,1.268652081105983
Framingham State University,4128,3558,Massachusetts,Small City,public,100.0,99.99,100.0,12,7,21,5,3,10,17,10,31,16.85113558508495,0.22034284285087932
Francis Marion University,3462,3006,South CaroliNA,Suburb,public,100.0,100.0,100.0,34,17,68,18,9,37,52,26,105,51.68718831667112,0.6093169905359065
Franciscan University of Steubenville,2201,2011,Ohio,Small City,NA,99.99,98.75,100.0,6,3,12,3,1,6,9,4,18,0.8995952347433782,8.036043055060412
Franklin and Marshall College,2281,2263,Pennsylvania,Small City,NA,99.97,98.77,100.0,5,3,11,3,1,5,8,4,16,1.3165384695826317,6.7353631325960714
Franklin College,1017,962,IndiaNA,Suburb,private,95.24,81.9,99.68,2,1,4,1,1,2,3,2,6,2.703010956745375,0.3366041548530785
Franklin Pierce University,1712,1563,New Hampshire,Rural,NA,99.01,91.22,99.98,3,2,6,1,1,3,4,3,9,0.28050400895106126,4.326502427548313
Welch College,344,222,Tennessee,Rural,private,70.43,40.5,94.16,1,0,2,0,0,1,1,0,3,0.521671052265123,0.6930691862873548
Freed - Hardeman University,1469,1261,Tennessee,Town,NA,99.89,94.46,100.0,5,2,10,2,1,5,7,3,15,3.0064726433174194,3.778955623787174
Fresno Pacific University,2803,2342,California,Large City,private,100.0,100.0,100.0,14,7,28,6,3,13,20,10,41,20.07448333489328,0.34132181489130636
Friends University,1149,906,Kansas,Large City,NA,94.3,73.04,99.81,2,1,4,1,0,2,3,1,6,0.6368203460493311,2.2105741746190652
Frostburg State University,4726,3849,Maryland,Suburb,public,100.0,99.91,100.0,9,5,16,4,2,8,13,7,24,12.13281530966556,0.8902800409968815
Full Sail University,16908,16908,Florida,Suburb,NA,100.0,100.0,100.0,83,41,174,40,19,89,123,60,263,57.036712566572476,65.94366624996722
Furman University,2732,2658,South CaroliNA,Suburb,NA,100.0,100.0,100.0,15,7,30,7,3,16,22,10,46,11.938616866622404,9.942195815834555
Gallaudet University,1125,1074,District of Columbia,Large City,NA,99.76,94.53,100.0,4,2,8,2,1,4,6,3,12,0.07136700402263328,5.921886968616685
Gannon University,3074,2530,Pennsylvania,Small City,private,99.92,98.07,100.0,5,3,9,2,1,4,7,4,13,4.63165260649086,2.4482270958505747
Gardner - Webb University,2218,1781,North CaroliNA,Town,NA,99.97,98.05,100.0,6,3,12,3,1,6,9,4,18,2.026815596466742,6.174957847125021
Geneva College,1412,1247,Pennsylvania,Suburb,NA,97.58,86.89,99.93,3,1,5,1,1,2,4,2,7,2.039911255067594,1.6741571245881954
George Fox University,2700,2494,Oregon,Town,private,99.94,98.65,100.0,5,3,9,2,1,5,7,4,14,2.3156562231652953,5.051118898193543
George Mason University,25006,20221,Virginia,Suburb,NA,100.0,100.0,100.0,83,38,156,43,18,84,126,56,240,103.32576572005335,22.8233586259276
George Washington University,11996,10893,District of Columbia,Large City,NA,100.0,100.0,100.0,37,19,74,18,9,37,55,28,111,0.40738664796253166,54.24472174575449
Georgetown College,1059,976,Kentucky,Town,private,94.71,72.26,99.92,2,1,5,1,0,2,3,1,7,2.3541829038862163,0.5805290910323583
Georgetown University,7465,6987,District of Columbia,Large City,private,100.0,100.0,100.0,24,12,48,11,6,24,35,18,72,0.33007239360467894,34.73611182672137
Georgia College & State University,5987,5442,Georgia,Town,NA,100.0,99.28,100.0,12,4,37,6,1,19,18,5,56,17.872354202241098,0.05105076236844129
Georgia Gwinnett College,12290,8289,Georgia,Suburb,public,100.0,100.0,100.0,26,8,77,12,3,39,38,11,116,36.3941224804846,0.9109110889839535
Georgia Institute of Technology - Main Campus,15576,13974,Georgia,Large City,NA,100.0,100.0,100.0,46,18,117,22,8,59,68,26,176,32.267200771695165,35.49017160526715
Georgia Southern University,17763,15755,Georgia,Town,NA,100.0,100.0,100.0,39,12,114,18,5,57,57,17,171,51.121157816926065,5.477848210377456
Georgia Southwestern State University,2604,1779,Georgia,Town,public,99.96,89.46,100.0,5,2,16,2,1,8,7,3,24,7.65231240708816,0.288604731585545
Georgia State University,25771,19882,Georgia,Large City,NA,100.0,100.0,100.0,55,16,162,25,7,81,80,23,243,74.35940804807177,5.013816891391667
Georgian Court University,1612,1343,New Jersey,Small City,private,100.0,99.64,100.0,7,4,14,3,2,7,10,6,21,9.875158997771328,0.4607869364973383
Gettysburg College,2411,2404,Pennsylvania,Small City,NA,99.96,98.56,100.0,5,3,10,2,1,5,7,4,15,1.3723415130343288,6.403939192744018
Glenville State College,1655,1037,West Virginia,Town,NA,66.36,39.6,87.09,1,0,1,0,0,1,1,0,2,0.33157924057369326,0.7557776299298019
Goddard College,189,173,Vermont,Rural,NA,48.74,28.88,72.47,0,0,1,0,0,0,0,0,1,0.0,0.6665790906945099
Gonzaga University,5194,5106,Washington,Midsize City,private,100.0,100.0,100.0,14,8,32,7,4,19,21,12,51,8.977267553652515,12.842047090478724
Gordon College,1593,1528,Massachusetts,Suburb,NA,99.55,94.06,100.0,4,2,7,2,1,3,6,3,10,2.183934364784081,3.1966385072251104
Goshen College,888,816,IndiaNA,Small City,private,93.07,76.12,99.47,2,1,3,1,0,2,3,1,5,1.497228056379045,1.1662941309365522
Goucher College,1534,1447,Maryland,Small City,NA,99.77,95.69,100.0,4,2,8,2,1,4,6,3,12,0.7853400779592743,5.263522211882042
Grace Bible College,873,822,Michigan,Small City,NA,95.52,77.02,99.9,2,1,5,1,0,2,3,1,7,2.3041749762341723,0.7925331693502873
Grace College and Theological SemiNAry,1761,1439,IndiaNA,Town,private,99.43,93.95,100.0,4,2,7,2,1,3,6,3,10,2.6858671240387446,2.46780461198539
Graceland University - Lamoni,1405,1061,Iowa,Rural,private,100.0,99.52,100.0,8,4,16,4,2,8,12,6,24,1.0749847322917212,10.32237969596846
Grambling State University,4075,3734,LouisiaNA,Town,NA,100.0,100.0,100.0,23,10,51,11,5,26,34,15,77,15.870103181253208,17.69641574555521
Grand Canyon University,49564,15998,ArizoNA,Large City,NA,100.0,100.0,100.0,233,115,493,111,52,248,344,167,741,106.49050374874781,237.55326631737924
Grand Valley State University,21935,19373,Michigan,Suburb,NA,100.0,100.0,100.0,48,23,105,23,10,54,71,33,159,68.63032692370886,2.295857099519514
Grand View University,1787,1574,Iowa,Midsize City,NA,99.97,95.38,100.0,5,2,14,3,1,7,8,3,21,4.341743890978229,3.845689307003415
Granite State College,1758,807,New Hampshire,Town,NA,75.8,0.0,96.23,1,0,2,0,0,1,1,0,3,1.4181036008081431,0.00019205750551388561
Grantham University,7817,3296,Kansas,Suburb,NA,100.0,100.0,100.0,35,16,77,17,7,41,52,23,118,0.1473399688301011,51.88443236572542
Greensboro College,944,772,North CaroliNA,Large City,NA,97.15,82.3,99.94,2,1,5,1,1,2,3,2,7,0.7001970492095562,2.843680024459566
Greenville University,988,887,Illinois,Town,NA,89.63,67.5,99.26,2,1,3,1,0,2,3,1,5,0.9712844512231104,1.2882967783685
Grinnell College,1717,1662,Iowa,Town,private,99.86,95.69,100.0,4,2,10,2,1,5,6,3,15,0.8629738545341873,5.715420008946714
Grove City College,2376,2315,Pennsylvania,Town,NA,99.89,97.19,100.0,5,2,9,2,1,5,7,3,14,2.1122485336160906,4.702905859892165
Guilford College,1669,1429,North CaroliNA,Large City,NA,99.32,91.12,100.0,3,2,7,2,1,3,5,3,10,1.0865126625665527,3.894909802983617
Gustavus Adolphus College,2184,2150,Minnesota,Town,private,92.12,68.98,99.77,2,1,4,1,0,2,3,1,6,0.982596118389099,1.5492984602935296
Gwynedd Mercy University,2081,1934,Pennsylvania,Suburb,private,99.63,95.48,100.0,4,2,7,2,1,4,6,3,11,3.532125972553717,2.0700627116040784
Hamilton College,1894,1886,New York,Suburb,private,99.95,98.25,100.0,5,3,10,2,1,5,7,4,15,1.7343634872386178,5.75508551886569
Hamline University,2166,2082,Minnesota,Large City,NA,92.83,72.47,99.63,2,1,4,1,0,2,3,1,6,0.9353402519989101,1.6907356858446818
Hampden - Sydney College,1044,1039,Virginia,Rural,NA,99.41,89.17,100.0,3,2,7,2,1,4,5,3,11,3.738330083645306,1.3757963447871404
Hampshire College,1264,1268,Massachusetts,Suburb,private,99.42,92.81,100.0,3,2,7,2,1,4,5,3,11,0.9560023970358331,4.168958159534695
Hampton University,3796,3651,Virginia,Midsize City,NA,100.0,99.98,100.0,12,6,24,6,3,12,18,9,36,4.928513714763797,12.819987159353907
Hannibal - LaGrange University,913,706,Missouri,Town,NA,86.99,58.36,99.21,1,1,3,1,0,2,2,1,5,1.034441359074084,1.0007702033413846
Hanover College,1096,1081,IndiaNA,Town,NA,96.71,83.35,99.9,2,1,5,1,1,2,3,2,7,1.9001081249848566,1.5061523201087843
Hardin - Simmons University,1741,1585,Texas,Midsize City,NA,100.0,100.0,100.0,22,9,50,11,4,28,33,13,78,32.360256921471894,0.3789453101889498
Harding University,4187,3945,Arkansas,Town,NA,100.0,100.0,100.0,18,8,40,9,4,21,27,12,61,1.9405671518309144,24.556303040994013
Harris - Stowe State University,1441,1163,Missouri,Large City,NA,91.68,62.11,99.81,2,1,4,1,0,2,3,1,6,2.205539686989059,0.2792260246166253
Harrisburg University of Science and Technology,509,463,Pennsylvania,Small City,NA,67.64,46.57,88.75,1,0,1,0,0,1,1,0,2,0.925917165420752,0.20106051206627346
Hartwick College,1198,1180,New York,Town,private,97.07,87.51,99.79,2,1,4,1,1,2,3,2,6,2.6624509720485805,0.8601406100233729
Harvard University,9964,7147,Massachusetts,Midsize City,NA,100.0,100.0,100.0,35,18,73,17,8,37,52,26,110,6.309615820436498,45.42346659894588
Harvey Mudd College,867,844,California,Suburb,NA,99.18,91.04,100.0,3,2,7,2,1,3,5,3,10,2.6785493622205396,2.110129974506228
Hastings College,1156,1073,Nebraska,Town,NA,64.73,37.33,91.44,1,0,2,0,0,1,1,0,3,0.1328315770340143,0.9048839406030104
Haverford College,1293,1294,Pennsylvania,Suburb,private,99.29,92.71,99.99,3,2,7,2,1,3,5,3,10,0.36375317212958114,4.570894591684285
Hawaii Pacific University,3565,2411,Hawaii,Large City,NA,99.99,98.74,100.0,6,3,13,3,1,6,9,4,19,0.004120039293934361,8.866756038197872
Heidelberg University,1049,1031,Ohio,Town,NA,97.11,83.37,99.92,2,1,5,1,1,2,3,2,7,1.9183576304527625,1.6123072375511238
Henderson State University,2838,2565,Arkansas,Town,public,100.0,98.63,100.0,7,3,16,3,1,8,10,4,24,4.370278177863022,5.955889434877628
Hendrix College,1240,1228,Arkansas,Small City,NA,99.94,95.9,100.0,5,2,11,2,1,6,7,3,17,1.0618868832658623,6.35321567548509
Heritage University,812,734,Washington,Rural,private,94.88,85.51,99.29,2,1,3,1,1,2,3,2,5,2.966846257047555,0.0
Herzing University - Atlanta,593,365,Georgia,Large City,NA,83.09,38.59,99.62,1,0,4,1,0,2,2,0,6,1.7746661155272894,0.0
High Point University,4467,4418,North CaroliNA,Midsize City,NA,100.0,99.93,100.0,10,5,19,5,2,9,15,7,28,1.4191733296239661,12.778028961124575
Hilbert College,744,680,New York,Suburb,private,88.37,72.78,97.41,1,1,2,1,0,1,2,1,3,2.088196840822416,0.06032391430322029
Hiram College,1209,853,Ohio,Town,NA,96.96,83.73,99.89,2,1,5,1,1,2,3,2,7,2.409045940312787,1.0739618411815688
Hobart and William Smith Colleges,2239,2220,New York,Town,private,99.92,98.18,100.0,5,3,9,2,1,4,7,4,13,2.7088553462890785,4.39576657035487
Hodges University,1076,573,Florida,Suburb,NA,100.0,99.93,100.0,9,5,19,5,2,9,14,7,28,13.680643467638506,0.29453598331741015
Hofstra University,6863,6494,New York,Suburb,NA,100.0,100.0,100.0,17,9,31,8,4,15,25,13,46,10.745512910065349,13.652775251034253
Hollins University,647,632,Virginia,Suburb,NA,97.51,80.16,99.97,2,1,5,1,1,3,3,2,8,1.6725488032017568,2.003405173966831
Holy Cross College,555,526,IndiaNA,Suburb,NA,82.93,61.32,96.91,1,1,2,1,0,1,2,1,3,0.8600489407826193,0.9034736291146263
Holy Family University,2095,1630,Pennsylvania,Large City,private,99.67,95.7,100.0,4,2,8,2,1,4,6,3,12,3.503191061134318,2.186970426176423
Holy Names University,591,543,California,Large City,private,98.07,86.75,99.97,3,1,5,1,1,3,4,2,8,3.79827081691929,0.13328906688989728
Hood College,1132,1048,Maryland,Small City,NA,97.33,85.16,99.93,2,1,5,1,1,2,3,2,7,2.251308223483253,1.3638191240058002
Hope College,3150,3019,Michigan,Small City,private,100.0,99.19,100.0,7,3,15,3,1,7,10,4,22,6.98463282269562,3.0028850993802427
Hope InterNAtioNAl University,866,579,California,Suburb,NA,99.67,94.69,100.0,4,2,8,2,1,4,6,3,12,5.203411465953016,0.4984725232604459
Houghton College,1036,971,New York,Rural,private,96.58,84.53,99.83,2,1,4,1,1,2,3,2,6,1.7633662211389292,1.601720660687873
Houston Baptist University,2320,2098,Texas,Large City,NA,100.0,100.0,100.0,29,13,68,15,6,38,44,19,106,44.182693779859875,0.33855273774103906
Howard Payne University,980,860,Texas,Town,private,100.0,99.96,100.0,12,5,28,6,2,16,18,7,44,18.388286088831556,0.19430903263453173
Howard University,6354,6090,District of Columbia,Large City,NA,100.0,100.0,100.0,23,11,48,11,5,24,34,16,72,0.2051801365650707,33.48728957888839
Humboldt State University,7860,7270,California,Town,NA,100.0,100.0,100.0,37,19,75,17,8,36,54,27,111,51.19981239916638,2.6921551363933496
Humphreys University - Stockton and Modesto Campuses,324,208,California,Large City,NA,90.74,70.77,99.22,2,1,3,1,0,2,3,1,5,2.371174845244412,0.0
Huntingdon College,1101,878,Alabama,Midsize City,private,99.92,96.4,100.0,5,2,10,2,1,5,7,3,15,4.368040182084761,2.708446667922799
Huntington University,1075,859,IndiaNA,Town,NA,95.83,82.25,99.79,2,1,4,1,1,2,3,2,6,2.0001138157735334,1.1713813253022551
Huston - Tillotson University,1052,1003,Texas,Large City,NA,100.0,99.98,100.0,13,6,31,7,3,17,20,9,48,19.932042306703703,0.16541911420195585
Idaho State University,10565,6279,Idaho,Small City,public,100.0,100.0,100.0,26,9,73,15,4,45,41,13,118,36.4694881446125,3.9683072873369025
Illinois College,956,950,Illinois,Town,NA,85.62,62.65,98.42,1,1,3,1,0,1,2,1,4,1.2830354283092378,0.6523532812432917
Illinois Institute of Technology,2895,2631,Illinois,Large City,NA,99.89,96.79,100.0,5,2,10,2,1,5,7,3,15,3.313333248930449,3.4529637935951567
Illinois State University,18336,17165,Illinois,Suburb,NA,100.0,100.0,100.0,20,11,40,9,5,18,29,16,58,28.40067067132866,0.7904129738726141
Illinois Wesleyan University,1650,1646,Illinois,Small City,NA,93.96,77.1,99.71,2,1,4,1,0,2,3,1,6,2.2496201160586877,0.5530239567864131
Immaculata University,1481,885,Pennsylvania,Suburb,NA,98.79,91.18,99.98,3,2,6,1,1,3,4,3,9,2.0709129458740927,2.337183234145275
IndiaNA State University,11578,9369,IndiaNA,Small City,public,100.0,100.0,100.0,22,13,40,10,6,20,32,19,60,29.015936855971756,3.100331328348014
IndiaNA University - Bloomington,33427,32212,IndiaNA,Small City,public,100.0,100.0,100.0,68,38,128,32,17,63,100,55,191,65.71231076451389,33.867258907388006
IndiaNA University - East,3292,1887,IndiaNA,Rural,public,99.99,99.45,100.0,6,4,11,3,2,6,9,6,17,7.909021488658771,1.23488145317309
IndiaNA University - Kokomo,2877,2215,IndiaNA,Small City,NA,99.97,99.1,100.0,6,3,10,3,1,5,9,4,15,8.174750895611542,0.018184047413336138
IndiaNA University - Northwest,3700,2608,IndiaNA,Small City,NA,100.0,99.77,100.0,7,4,13,3,2,6,10,6,19,10.526313281870994,0.02506540519285446
IndiaNA University of Pennsylvania - Main Campus,10255,9526,Pennsylvania,Town,NA,100.0,100.0,100.0,16,9,30,7,4,15,23,13,45,19.357455739577595,3.871075643444085
IndiaNA University - Purdue University - Fort Wayne,9952,5913,IndiaNA,Large City,public,100.0,100.0,100.0,19,11,35,9,5,17,28,16,52,27.561568381359287,0.9376071881824148
IndiaNA University - Purdue University - IndiaNApolis,21615,17521,IndiaNA,Large City,NA,100.0,100.0,100.0,42,24,78,20,11,38,62,35,116,59.5548175173825,2.9360923592166333
IndiaNA University - South Bend,4877,3767,IndiaNA,Midsize City,NA,100.0,99.97,100.0,9,5,17,4,3,8,13,8,25,13.652205445379916,0.2665203248251679
IndiaNA University - Southeast,4824,3218,IndiaNA,Suburb,NA,100.0,99.94,100.0,9,5,18,4,2,9,13,7,27,10.654892027170723,2.876144642371673
IndiaNA Wesleyan University,2803,2634,IndiaNA,Town,private,99.96,98.55,100.0,5,3,10,2,1,5,7,4,15,4.654550579850122,3.1607407733035133
Institute of American Indian and Alaska Native Culture and Arts Development,612,264,New Mexico,Rural,NA,94.06,66.45,99.98,2,1,5,1,0,3,3,1,8,1.3405726194585796,1.4747054616709068
IoNA College,3177,2949,New York,Suburb,private,100.0,99.72,100.0,7,4,12,3,2,6,10,6,18,6.914251761834222,3.1308749696542146
Iowa State University,30573,28743,Iowa,Small City,public,100.0,100.0,100.0,55,21,143,26,9,73,81,30,216,61.381628213857276,19.464569309766226
Iowa Wesleyan University,625,550,Iowa,Town,private,83.4,52.25,98.84,1,1,3,1,0,1,2,1,4,0.6121440836661189,1.177901127052053
Ithaca College,6062,5936,New York,Suburb,NA,100.0,100.0,100.0,14,8,27,7,4,13,21,12,40,7.36959468406911,13.767852050967127
Jackson State University,6498,5935,Mississippi,Midsize City,NA,100.0,100.0,100.0,50,25,98,24,12,49,74,37,147,62.37103189173634,11.558786783877808
Jacksonville State University,7492,5523,Alabama,Small City,NA,100.0,100.0,100.0,25,11,53,12,5,26,37,16,79,30.540010478300808,6.0977374406740905
Jacksonville University,2878,2180,Florida,Large City,NA,100.0,100.0,100.0,20,10,41,10,5,20,30,15,61,25.918353395406683,3.858390415496355
James Madison University,19972,18905,Virginia,Small City,NA,100.0,100.0,100.0,64,30,120,33,14,64,97,44,184,73.62360593905665,23.52101995769828
University of Jamestown,916,871,North Dakota,Town,NA,99.4,84.72,100.0,3,1,9,2,1,6,5,2,15,3.248640838398491,1.8368440083665103
Jarvis Christian College,908,835,Texas,Rural,NA,100.0,99.9,100.0,11,5,25,6,2,14,17,7,39,15.98471628125846,0.35752251387002487
John Brown University,1972,1489,Arkansas,Town,NA,100.0,98.92,100.0,7,3,16,4,1,9,11,4,25,1.1490434281235296,9.430044852153411
John Carroll University,3079,2987,Ohio,Suburb,private,99.96,98.49,100.0,5,3,10,2,1,5,7,4,15,4.787715937634239,3.0095260352222946
Johns Hopkins University,6106,5668,Maryland,Large City,NA,100.0,100.0,100.0,19,10,38,9,4,19,28,14,57,1.9867726182759184,25.778966147375936
Johnson & Wales University - Providence,7717,7267,Rhode Island,Midsize City,private,100.0,100.0,100.0,18,10,33,8,4,16,26,14,49,0.7111619957874193,25.0362974106546
Johnson C Smith University,1395,1329,North CaroliNA,Large City,NA,99.87,95.97,100.0,4,2,9,2,1,5,6,3,14,0.753851995509139,5.83157157025463
Johnson State College,1377,882,Vermont,Rural,NA,71.03,47.85,90.66,1,0,2,0,0,1,1,0,3,0.0059802733613461626,1.2296443882736001
Judson College,313,230,Alabama,Rural,NA,83.78,56.84,97.99,1,1,3,1,0,1,2,1,4,1.2798409548931624,0.5325551693831493
Judson University,1078,761,Illinois,Midsize City,private,86.09,64.34,98.31,1,1,3,1,0,1,2,1,4,1.353531880414141,0.6160120846554378
Juniata College,1487,1400,Pennsylvania,Town,NA,98.57,89.83,99.98,3,2,6,1,1,3,4,3,9,1.9117709330674009,2.3256309193381353
Kalamazoo College,1434,1427,Michigan,Small City,NA,99.21,90.1,100.0,3,2,7,2,1,4,5,3,11,3.251410492779941,1.5726377994267133
Kansas State University,18484,16770,Kansas,Small City,NA,100.0,100.0,100.0,18,9,35,8,4,18,26,13,53,10.89819913678416,15.11032170009976
Kansas Wesleyan University,693,631,Kansas,Town,NA,98.67,84.54,100.0,3,1,6,1,1,3,4,2,9,0.27838753726071985,4.008535868803063
Kaplan University - Davenport Campus,25486,3127,Iowa,Midsize City,NA,100.0,100.0,100.0,101,48,221,49,22,115,150,70,336,2.21864904470208,148.0216135986373
Kean University,11985,9516,New Jersey,Suburb,NA,100.0,100.0,100.0,55,30,110,25,13,53,80,43,163,79.29009975230042,1.3768258759412562
Keene State College,3778,3624,New Hampshire,Town,NA,99.82,93.89,100.0,4,2,8,2,1,4,6,3,12,1.4082613548800358,4.900265747117952
Kent State University at Kent,23179,19108,Ohio,Suburb,public,100.0,100.0,100.0,38,21,72,18,9,35,56,30,107,46.771942373657666,9.214357583074541
Kentucky Christian University,589,439,Kentucky,Town,NA,84.74,58.99,98.43,1,1,3,1,0,1,2,1,4,0.789111587894821,1.0856035704750178
Kentucky State University,1762,1122,Kentucky,Town,public,99.31,90.87,100.0,3,2,7,2,1,4,5,3,11,1.6071572673457857,3.3527310673931554
Kentucky Wesleyan College,716,673,Kentucky,Small City,private,89.43,64.24,99.44,2,1,3,1,0,2,3,1,5,1.2809911443492596,0.9609929722651307
Kenyon College,1678,1661,Ohio,Town,NA,99.79,95.63,100.0,4,2,8,2,1,4,6,3,12,0.5888259718320294,5.533481391279353
Kettering University,1891,1807,Michigan,Small City,NA,99.86,95.68,100.0,4,2,10,2,1,5,6,3,15,4.1593144307840175,2.4096917759350736
Keuka College,1645,1312,New York,Town,private,99.06,93.94,99.96,3,2,5,1,1,3,4,3,8,4.364911451996855,0.29647057042832436
Keystone College,1454,1065,Pennsylvania,Suburb,private,96.8,85.25,99.87,2,1,4,1,1,2,3,2,6,2.4987362790037704,0.9383478711955969
King University,1798,1608,Tennessee,Small City,NA,99.96,96.0,100.0,5,2,12,2,1,6,7,3,18,3.665425551441785,4.090894112665975
King's College,2198,2025,Pennsylvania,Small City,NA,99.88,97.53,100.0,5,3,9,2,1,4,7,4,13,2.947227406004447,3.754169159924684
Knox College,1354,1334,Illinois,Town,private,95.75,78.82,99.9,2,1,5,1,0,2,3,1,7,1.1765074562396063,1.9740287562017613
Kutztown University of Pennsylvania,7489,7053,Pennsylvania,Town,NA,100.0,100.0,100.0,13,7,26,6,3,12,19,10,38,13.382396531471807,6.176870720755053
Kuyper College,182,146,Michigan,Suburb,NA,43.88,23.58,72.89,0,0,1,0,0,0,0,0,1,0.5244210472225712,0.05236802639074302
La Roche College,1379,1163,Pennsylvania,Suburb,NA,94.75,80.61,99.66,2,1,4,1,1,2,3,2,6,2.51113695532637,0.4333252482969261
La Salle University,3822,3322,Pennsylvania,Large City,NA,100.0,99.91,100.0,9,5,17,4,2,8,13,7,25,4.784594281136252,7.906781790203927
La Sierra University,2027,1830,California,Large City,private,100.0,99.94,100.0,10,5,20,5,2,10,15,7,30,13.868445468327659,0.5011236809851467
Lafayette College,2590,2551,Pennsylvania,Suburb,NA,100.0,99.68,100.0,7,4,14,3,2,7,10,6,21,1.1119273102597425,9.53717110334914
LaGrange College,940,888,Georgia,Town,NA,97.68,73.91,100.0,3,1,7,1,0,3,4,1,10,2.4061240419628005,1.3471188539524763
Lake Erie College,959,724,Ohio,Suburb,private,94.76,77.75,99.75,2,1,4,1,0,2,3,1,6,1.5538463145567443,1.3852927267266995
Lake Forest College,1505,1487,Illinois,Suburb,NA,98.21,87.3,99.98,3,1,6,1,1,3,4,2,9,1.2987013065547717,2.713609479586181
Lake Superior State University,1962,1706,Michigan,Town,public,99.86,95.38,100.0,4,2,10,2,1,5,6,3,15,5.9456236228859005,0.6178452356946781
Lakeland University,1997,779,Wisconsin,Rural,private,86.65,64.41,98.55,1,1,3,1,0,1,2,1,4,0.8318732533171714,1.1765005451318022
Lamar University,9270,5967,Texas,Midsize City,NA,100.0,100.0,100.0,118,51,272,61,24,151,179,75,423,177.33655287581973,1.0381636351717591
Lander University,2785,2600,South CaroliNA,Town,NA,100.0,100.0,100.0,28,14,55,14,7,29,42,21,84,41.106296505468514,0.9162081321627276
Lane College,1416,1370,Tennessee,Small City,NA,99.33,86.52,100.0,3,1,8,2,1,4,5,2,12,3.2123954271062836,1.775624129319617
Langston University,2028,1822,Oklahoma,Rural,NA,100.0,98.67,100.0,7,3,15,3,1,8,10,4,23,3.2368811280032563,6.698330300432562
Lasell College,1733,1669,Massachusetts,Small City,NA,99.59,95.18,100.0,4,2,7,2,1,3,6,3,10,4.3891132272800695,1.1034311861786525
Lawrence Technological University,2191,1672,Michigan,Small City,NA,99.93,96.81,100.0,5,2,11,2,1,6,7,3,17,6.610982826549538,0.6963473197998861
Lawrence University,1471,1434,Wisconsin,Small City,private,94.16,77.11,99.69,2,1,4,1,0,2,3,1,6,0.23753428648862973,2.5951075131877945
Le Moyne College,2793,2410,New York,Suburb,NA,99.98,99.37,100.0,6,4,10,3,2,5,9,6,15,7.320290036438581,1.151730311075648
Le Moyne - Owen College,867,770,Tennessee,Large City,private,95.68,69.92,99.96,2,1,5,1,0,2,3,1,7,2.707884606823566,0.42638916705260405
Lebanon Valley College,1756,1624,Pennsylvania,Suburb,private,99.14,92.73,99.99,3,2,6,1,1,3,4,3,9,2.664078629971762,2.080604975599746
Lee University,4856,3854,Tennessee,Small City,NA,100.0,99.98,100.0,14,6,32,6,3,16,20,9,48,7.81133759839092,12.327655184932178
Lees - McRae College,920,891,North CaroliNA,Rural,NA,98.04,84.71,99.98,3,1,6,1,1,3,4,2,9,0.6653213341148273,3.2487572831192493
Lehigh University,5065,5013,Pennsylvania,Small City,NA,100.0,100.0,100.0,14,8,27,6,3,13,20,11,40,2.449133573713373,17.82257733357454
Lenoir - Rhyne University,1698,1441,North CaroliNA,Small City,private,98.88,88.35,99.99,3,1,6,1,1,3,4,2,9,1.723665149874099,2.755624488798442
Lesley University,2097,1645,Massachusetts,Midsize City,private,99.91,97.58,100.0,5,3,9,2,1,4,7,4,13,3.8707474831095285,3.0931801622899884
LeTourneau University,2606,1301,Texas,Small City,NA,100.0,100.0,100.0,26,11,60,13,5,33,39,16,93,36.32712416486489,3.064373868820504
Lewis & Clark College,2113,2067,Oregon,Large City,NA,99.99,99.26,100.0,7,3,14,3,2,7,10,5,21,0.45988844151977853,9.213984058051135
Lewis - Clark State College,3746,2215,Idaho,Small City,NA,100.0,99.29,100.0,9,3,24,5,2,15,14,5,39,11.395100616266658,2.4834376630114265
Lewis University,4502,3687,Illinois,Suburb,private,99.95,98.42,100.0,5,3,11,2,1,5,7,4,16,6.598467917018937,1.0764026427282787
Liberty University,45756,26892,Virginia,Small City,NA,100.0,100.0,100.0,163,77,332,81,36,173,244,113,505,65.09832583245459,178.33745817033002
Life University,760,624,Georgia,Small City,NA,94.22,67.05,99.95,2,1,5,1,0,3,3,1,8,1.3796308250557847,1.4624679388418809
Limestone College,2599,1943,South CaroliNA,Town,private,100.0,100.0,100.0,20,10,41,11,5,22,31,15,63,27.43540974055188,3.5367514311649253
Lincoln Memorial University,1923,1355,Tennessee,Town,NA,99.93,94.31,100.0,5,2,12,2,1,6,7,3,18,4.818593140659425,2.39993971592933
Lincoln University California,107,72,California,Large City,private,54.43,33.38,79.88,1,0,1,0,0,1,1,0,2,0.7830731742010868,0.0
Lincoln University Missouri,2513,1804,Missouri,Small City,NA,99.77,92.06,100.0,4,2,10,2,1,5,6,3,15,3.094674901979158,2.9685469023207363
Lincoln University of Pennsylvania,2002,1826,Pennsylvania,Suburb,NA,99.86,97.22,100.0,4,2,8,2,1,4,6,3,12,1.5645519960346188,4.9633035642421595
Lindenwood University,6931,6215,Missouri,Small City,private,100.0,99.94,100.0,12,5,29,6,2,15,18,7,44,8.46408289289213,9.249100831055694
Lindsey Wilson College,2071,1919,Kentucky,Town,NA,99.69,91.7,100.0,4,2,9,2,1,5,6,3,14,4.8109503141987595,0.9500808707870299
Linfield College - McMinnville Campus,1536,1505,Oregon,Town,NA,98.57,91.18,99.99,3,2,6,1,1,3,4,3,9,1.2602712099340085,2.9788644744091615
Lipscomb University,2994,2723,Tennessee,Large City,NA,100.0,99.29,100.0,8,3,19,4,1,9,12,4,28,6.761131401067712,5.275823945096803
Livingstone College,1153,1140,North CaroliNA,Suburb,private,98.02,85.83,99.97,3,1,5,1,1,3,4,2,8,0.9389615602426998,2.9662522645349076
Lock Haven University,3471,3176,Pennsylvania,Town,public,99.97,98.87,100.0,6,3,11,3,1,5,9,4,16,6.55582421588086,1.5108636908721165
LIU Brooklyn,3947,3396,New York,Large City,NA,100.0,99.95,100.0,9,5,16,4,2,8,13,7,24,9.1851658262286,4.027537610909158
LIU Post,6317,2845,New York,Suburb,private,100.0,100.0,100.0,14,8,23,6,4,11,20,12,34,16.3865446536759,3.5576070614376083
Longwood University,4469,3959,Virginia,Town,NA,100.0,100.0,100.0,15,7,28,8,3,15,23,10,43,22.676406187610027,0.5267510936219838
Loras College,1395,1335,Iowa,Small City,NA,94.26,71.29,99.9,2,1,5,1,0,2,3,1,7,1.403452289380858,1.450736429828307
LouisiaNA College,985,866,LouisiaNA,Suburb,NA,99.95,96.74,100.0,5,2,12,2,1,6,7,3,18,6.556595283704071,1.0727851298746949
LouisiaNA State University - Alexandria,3372,1844,LouisiaNA,Rural,public,100.0,100.0,100.0,17,8,37,8,3,18,25,11,55,23.226631658611808,1.2003785419587385
LouisiaNA State University and Agricultural & Mechanical College,25448,22060,LouisiaNA,Midsize City,NA,100.0,100.0,100.0,151,68,335,72,30,169,223,98,504,133.16030770084825,88.89490734956466
LouisiaNA State University - Shreveport,2641,1641,LouisiaNA,Midsize City,public,100.0,99.99,100.0,14,6,31,6,3,15,20,9,46,17.04857618976211,3.1248558809798865
LouisiaNA Tech University,11323,8090,LouisiaNA,Town,NA,100.0,100.0,100.0,60,27,133,28,12,65,88,39,198,72.26539333389738,15.21450891110416
Lourdes University,1046,827,Ohio,Suburb,NA,93.04,74.85,99.45,2,1,3,1,0,2,3,1,5,2.1216427873947725,0.5393642264746111
Loyola Marymount University,6395,6164,California,Large City,NA,100.0,100.0,100.0,30,15,62,14,7,31,44,22,93,33.18912939254139,10.12708002179981
Loyola University Maryland,3927,3886,Maryland,Large City,private,100.0,99.98,100.0,11,6,20,5,3,10,16,9,30,1.8269490234631538,13.728312397359021
Loyola University Chicago,11426,10681,Illinois,Large City,private,100.0,100.0,100.0,18,9,37,8,4,18,26,13,55,10.555668761840835,15.846367890429887
Loyola University New Orleans,2607,2446,LouisiaNA,Large City,private,100.0,99.98,100.0,12,6,27,6,3,13,18,9,40,7.999331936545271,10.114087995245766
Lubbock Christian University,1482,1276,Texas,Large City,NA,100.0,100.0,100.0,18,8,41,9,4,23,27,12,64,26.1852320499833,0.598069581344107
Luther College,2046,2014,Iowa,Town,NA,96.79,75.72,99.98,2,1,6,1,0,3,3,1,9,1.8244879761951156,1.6092510743473307
Lycoming College,1222,1199,Pennsylvania,Small City,private,97.45,86.57,99.92,3,1,5,1,1,2,4,2,7,1.5170160701313213,2.144958393917514
University of Lynchburg,2051,1928,Virginia,Small City,private,99.99,98.58,100.0,6,3,12,3,1,6,9,4,18,6.93137779884866,2.421920598135982
Lyndon State College,1069,871,Vermont,Town,NA,56.85,33.76,80.58,1,0,1,0,0,1,1,0,2,0.004470304007650786,0.8337632092800326
Lynn University,2205,1826,Florida,Small City,NA,100.0,99.97,100.0,11,6,21,5,3,11,16,9,32,9.392680589721959,6.30453696007529
Lyon College,670,652,Arkansas,Town,NA,90.9,62.69,99.65,2,1,4,1,0,2,3,1,6,0.9693942234169096,1.413910928186497
Macalester College,2138,2093,Minnesota,Large City,NA,99.88,96.45,100.0,5,2,9,2,1,5,7,3,14,0.18196224414612944,6.482753651771216
MadonNA University,2455,1358,Michigan,Small City,NA,99.97,97.8,100.0,5,3,12,3,1,6,8,4,18,7.928590707696248,0.22768286681965585
Maharishi University of MaNAgement,325,261,Iowa,Town,NA,73.49,45.55,95.17,1,0,2,0,0,1,1,0,3,0.3224954196875163,1.0000629642612482
Maine Maritime Academy,1021,989,Maine,Rural,NA,75.17,46.48,94.13,1,0,2,0,0,1,1,0,3,0.6287434743945705,0.7609558058539115
Malone University,1334,1099,Ohio,Small City,NA,97.35,84.69,99.92,2,1,5,1,1,2,3,2,7,2.642707040246132,0.9777631499944619
Manchester University,1264,1244,IndiaNA,Town,NA,97.59,87.72,99.92,3,1,5,1,1,2,4,2,7,3.257328214259754,0.4599939355821216
Manhattan College,3666,3479,New York,Large City,NA,100.0,99.95,100.0,9,5,16,4,2,8,13,7,24,7.375395230849172,5.8084264730047535
Manhattanville College,1731,1633,New York,Suburb,NA,99.78,96.59,100.0,4,2,8,2,1,4,6,3,12,2.8219660085002927,3.290424092579738
Mansfield University of Pennsylvania,1827,1655,Pennsylvania,Town,NA,98.25,89.93,99.95,3,2,5,1,1,2,4,3,7,3.1559721241015364,0.8841631358189648
MaraNAtha Baptist University,933,591,Wisconsin,Town,NA,92.84,70.87,99.78,2,1,4,1,0,2,3,1,6,0.12480615052792408,2.5016766173287905
Marian University IndiaNA,2301,1961,IndiaNA,Large City,NA,99.88,97.74,100.0,5,3,8,2,1,4,7,4,12,5.826045814803192,0.8751534789774277
Marian University Wisconsin,1508,1254,Wisconsin,Small City,NA,61.65,42.1,83.71,1,0,1,0,0,1,1,0,2,0.6642908011970153,0.2938248720284199
Marietta College,1063,960,Ohio,Town,NA,94.89,78.61,99.72,2,1,4,1,0,2,3,1,6,1.6169348115387474,1.3487693504964577
Marist College,5697,5085,New York,Suburb,private,100.0,100.0,100.0,14,8,26,6,4,13,20,12,39,8.631213608732653,11.748260896710578
Marquette University,8334,8026,Wisconsin,Large City,NA,100.0,99.91,100.0,9,5,18,4,2,9,13,7,27,1.419166711648169,11.843755105848665
Mars Hill University,1265,1199,North CaroliNA,Suburb,private,98.97,88.31,100.0,3,1,7,1,1,3,4,2,10,1.1066332674288961,3.4482948045598705
Marshall University,9492,7846,West Virginia,Small City,NA,100.0,99.23,100.0,7,3,13,3,1,7,10,4,20,1.590498383064568,8.491955278473862
Martin Luther College,896,743,Minnesota,Town,private,84.25,60.58,97.91,1,1,3,1,0,1,2,1,4,0.059205625707248084,1.7806568306844996
Martin Methodist College,979,810,Tennessee,Town,NA,97.45,75.68,99.99,3,1,6,1,0,3,4,1,9,3.04079310728223,0.6212393974849933
Martin University,263,159,IndiaNA,Large City,NA,52.88,35.12,74.89,1,0,1,0,0,0,1,0,1,0.7514713336406275,0.0
Mary Baldwin University,1133,720,Virginia,Small City,private,99.53,90.94,100.0,4,2,7,2,1,4,6,3,11,3.759302482431535,1.5775808227197587
Marymount Manhattan College,2149,1915,New York,Large City,private,99.99,99.38,100.0,6,3,13,3,2,6,9,5,19,2.1752050425233502,7.403122974147002
Marymount University,2306,2069,Virginia,Midsize City,NA,100.0,99.19,100.0,7,3,13,3,2,7,10,5,20,6.506686723427524,3.8220622606473844
Maryville College,1184,1158,Tennessee,Suburb,NA,99.55,89.5,100.0,4,2,9,2,1,4,6,3,13,2.9309676225948356,2.4527808823257153
Maryville University of Saint Louis,3184,2375,Missouri,Suburb,private,99.91,94.51,100.0,5,2,11,2,1,5,7,3,16,4.1481444465880495,2.836248513098824
Marywood University,1957,1756,Pennsylvania,Small City,NA,99.72,96.21,100.0,4,2,8,2,1,4,6,3,12,2.684746423842761,3.183845760706258
Massachusetts College of Liberal Arts,1407,1201,Massachusetts,Town,public,99.58,95.58,100.0,4,2,7,2,1,3,6,3,10,4.690785094789154,0.7785546811285998
Massachusetts Institute of Technology,4551,4510,Massachusetts,Midsize City,private,100.0,100.0,100.0,18,9,36,8,4,18,26,13,54,2.0734629766821624,23.996474283058507
Massachusetts Maritime Academy,1687,1607,Massachusetts,Suburb,NA,99.9,97.79,100.0,5,3,9,2,1,4,7,4,13,5.357862322943046,1.574220581746243
Mayville State University,1097,600,North Dakota,Rural,NA,99.93,92.91,100.0,5,2,12,3,1,7,8,3,19,5.981754289343318,1.241072409906314
McDaniel College,1588,1543,Maryland,Suburb,private,98.92,91.33,99.98,3,2,6,1,1,3,4,3,9,4.166435782015518,0.3553651899416384
McKendree University,2103,1692,Illinois,Suburb,NA,97.66,86.2,99.96,3,1,5,1,1,2,4,2,7,2.8919211241255836,0.8590686355538473
McMurry University,1106,956,Texas,Midsize City,private,100.0,99.98,100.0,14,6,32,7,3,18,21,9,50,20.75277346050915,0.223272907757851
McNeese State University,6924,5567,LouisiaNA,Small City,NA,100.0,100.0,100.0,37,17,82,17,7,40,54,24,122,46.18899967289131,7.830931830507805
McPherson College,723,673,Kansas,Town,private,96.88,77.32,99.97,2,1,5,1,0,3,3,1,8,0.2493445626355557,3.190673524963663
Medaille College,1526,1426,New York,Large City,NA,98.88,93.36,99.95,3,2,5,1,1,2,4,3,7,4.318507077756357,0.16827772308678268
Menlo College,746,728,California,Suburb,private,99.44,92.64,100.0,4,2,7,2,1,4,6,3,11,4.273969474144249,0.8811471573792924
Mercer University,4746,4135,Georgia,Midsize City,NA,100.0,99.71,100.0,12,4,32,5,2,16,17,6,48,11.824124489794807,5.300585467582192
Mercy College,6862,5055,New York,Suburb,private,100.0,100.0,100.0,14,9,24,7,4,12,21,13,36,18.207916342615455,2.5472458930288497
Mercyhurst University,2452,2373,Pennsylvania,Small City,NA,99.79,96.71,100.0,4,2,8,2,1,4,6,3,12,2.910025377036649,3.240042274679363
Meredith College,1682,1600,North CaroliNA,Large City,NA,95.06,75.68,99.85,2,1,4,1,0,2,3,1,6,2.00132949697444,1.0001967538707452
Merrimack College,3535,3323,Massachusetts,Suburb,NA,100.0,99.92,100.0,9,5,17,4,2,8,13,7,25,10.584008760072267,2.4405487441690217
Colorado Mesa University,9461,7145,Colorado,Small City,public,100.0,99.65,100.0,10,4,26,4,2,12,14,6,38,7.984388348151399,6.191324955195457
Messiah College,2760,2637,Pennsylvania,Suburb,private,99.96,98.63,100.0,5,3,10,2,1,5,7,4,15,3.222109064488733,4.633273019204004
Methodist University,1938,1755,North CaroliNA,Midsize City,NA,99.92,96.87,100.0,5,2,10,2,1,5,7,3,15,1.5533106953729234,5.525926299178171
Metropolitan College of New York,777,681,New York,Large City,NA,90.02,75.21,98.01,2,1,3,1,0,1,3,1,4,2.218709143373817,0.08252222003708631
Metropolitan State University of Denver,19668,12759,Colorado,Large City,public,100.0,99.95,100.0,14,5,40,6,2,19,20,7,59,18.986822543731265,1.527629545381433
Metropolitan State University,7317,2878,Minnesota,Large City,NA,98.12,86.68,99.96,3,1,5,1,1,2,4,2,7,3.974381314678296,0.0
Miami University - Oxford,17153,16619,Ohio,Town,NA,100.0,100.0,100.0,30,16,57,14,7,28,44,23,85,27.4037738001827,16.13849527024877
Michigan State University,38997,35404,Michigan,Small City,NA,100.0,100.0,100.0,89,43,195,43,19,100,132,62,295,113.84197645738477,18.191430210305015
Michigan Technological University,5886,5492,Michigan,Town,NA,100.0,99.96,100.0,11,5,24,5,2,12,16,7,36,14.998441950565535,1.3733452853783485
Mid - America Christian University,1622,1170,Oklahoma,Large City,private,99.98,97.28,100.0,6,2,13,3,1,7,9,3,20,2.6601791628393574,5.881296698939918
Mid - Atlantic Christian University,192,166,North CaroliNA,Town,private,34.53,17.41,57.53,0,0,1,0,0,0,0,0,1,0.15425797061130067,0.26858897292468825
MidAmerica Nazarene University,1311,998,Kansas,Suburb,NA,95.23,73.63,99.93,2,1,5,1,0,3,3,1,8,0.42431077562130076,2.605919676083972
Middle Tennessee State University,19520,15812,Tennessee,Midsize City,public,100.0,100.0,100.0,48,19,117,21,7,54,69,26,171,63.691917025895734,5.034057497689182
Middlebury College,2547,2528,Vermont,Town,NA,99.99,99.3,100.0,7,3,14,3,2,8,10,5,22,0.0008212114028869592,9.769843273044225
Midland University,1660,1187,Nebraska,Town,NA,96.03,77.87,99.93,2,1,5,1,0,2,3,1,7,0.1811187792514107,3.0294412922929927
Midway University,1003,760,Kentucky,Rural,private,94.1,70.85,99.89,2,1,5,1,0,2,3,1,7,2.385747367402009,0.44023236074917554
Midwestern State University,5328,4199,Texas,Midsize City,public,100.0,100.0,100.0,66,29,154,34,13,85,100,42,239,99.99241223863025,0.6838361455313295
Miles College,1654,1555,Alabama,Suburb,private,99.97,97.35,100.0,5,3,12,3,1,6,8,4,18,4.621935756132392,3.388152215442516
Millersville University of Pennsylvania,6756,5671,Pennsylvania,Suburb,NA,100.0,99.98,100.0,10,6,20,5,3,9,15,9,29,13.10544809360042,1.9130664085284608
Millikin University,1951,1840,Illinois,Small City,private,97.15,84.26,99.94,2,1,5,1,1,2,3,2,7,2.6553663626180195,0.8954130045488964
Mills College,764,739,California,Large City,private,99.41,92.76,100.0,3,2,7,2,1,3,5,3,10,4.442293614393081,0.672714091994596
Millsaps College,808,797,Mississippi,Midsize City,NA,99.98,98.28,100.0,6,3,12,3,1,6,9,4,18,4.424724367231471,4.148325337997071
Milwaukee School of Engineering,2607,2508,Wisconsin,Large City,private,94.04,76.73,99.79,2,1,4,1,0,2,3,1,6,0.9028315888995799,1.9110293145303592
Minnesota State University - Mankato,12781,10832,Minnesota,Small City,NA,99.99,99.16,100.0,7,3,13,3,1,6,10,4,19,5.950980139895505,3.5029313165360385
Minnesota State University - Moorhead,5126,4157,Minnesota,Suburb,NA,100.0,99.29,100.0,8,3,19,4,2,12,12,5,31,1.914134174241672,10.551537763202623
Minot State University,2959,1952,North Dakota,Town,public,100.0,99.97,100.0,14,5,41,9,3,28,23,8,69,20.113751085096954,2.8288429467850276
Misericordia University,2148,1660,Pennsylvania,Suburb,private,99.74,96.33,100.0,4,2,8,2,1,4,6,3,12,3.222109064488733,2.701343649303403
Mississippi College,3246,2793,Mississippi,Suburb,private,100.0,100.0,100.0,27,13,53,13,6,27,40,19,80,30.343060147471448,9.688555641924014
Mississippi State University,18312,16803,Mississippi,Town,public,100.0,100.0,100.0,141,70,275,67,32,136,208,102,411,176.35896426611,31.39665024024667
Mississippi University for Women,2577,2113,Mississippi,Town,NA,100.0,100.0,100.0,22,11,43,11,5,21,33,16,64,29.74235253470161,3.1149504484850206
Mississippi Valley State University,1974,1667,Mississippi,Town,public,100.0,100.0,100.0,17,8,32,8,4,16,25,12,48,22.445952750326537,2.2290469745813013
Missouri Baptist University,4507,1519,Missouri,Suburb,NA,100.0,98.77,100.0,7,3,18,3,1,9,10,4,27,6.402119514938437,4.30966444747945
Missouri Southern State University,6025,4358,Missouri,Small City,NA,100.0,99.13,100.0,8,3,20,4,1,10,12,4,30,8.867134459220326,3.1440214069532435
Missouri State University - Springfield,20365,15363,Missouri,Midsize City,NA,100.0,100.0,100.0,27,10,66,12,4,31,39,14,97,32.06422246119937,6.415903660603355
Missouri Valley College,1793,1296,Missouri,Town,NA,99.57,90.03,100.0,4,2,9,2,1,4,6,3,13,2.337007150684093,3.0796772358885587
Missouri Western State University,5290,3498,Missouri,Small City,NA,99.99,96.91,100.0,6,2,16,3,1,8,9,3,24,8.559223820566167,0.6509388980265315
Mitchell College,706,575,Connecticut,Small City,NA,78.64,58.38,94.35,1,1,2,0,0,1,1,1,3,0.15859260369828465,1.3814271336643407
Molloy College,3534,2800,New York,Suburb,private,100.0,99.81,100.0,7,4,12,3,2,6,10,6,18,10.223463699859746,0.06189166502781473
Monmouth College,1035,1016,Illinois,Town,NA,82.52,60.25,97.29,1,1,2,1,0,1,2,1,3,1.5227233654659085,0.21907400594242796
Monmouth University,4708,4502,New Jersey,Suburb,NA,100.0,100.0,100.0,20,11,39,9,5,19,29,16,58,26.716568737006693,2.186462142261676
MontaNA State University,14652,12403,MontaNA,Town,NA,100.0,99.99,100.0,45,6,383,35,3,352,80,9,735,61.57802046410352,18.63904009368296
MontaNA State University - Billings,4022,2400,MontaNA,Midsize City,public,100.0,43.09,100.0,14,0,148,12,0,140,26,0,288,25.31672433154793,1.0483783454393516
MontaNA State University - Northern,1164,855,MontaNA,Town,NA,99.95,27.41,100.0,4,0,42,4,0,39,8,0,81,7.098993421532015,0.5511696222491865
MontaNA Tech of the University of MontaNA,1657,1529,MontaNA,Town,NA,100.0,54.37,100.0,6,1,58,5,0,54,11,1,112,9.488546653706187,1.7417709900103342
Montclair State University,16852,14944,New Jersey,Suburb,NA,100.0,100.0,100.0,78,43,155,36,19,75,114,62,230,112.80787479069699,1.337800201193044
Montreat College,757,543,North CaroliNA,Suburb,NA,89.6,63.96,99.39,2,1,3,1,0,2,3,1,5,0.7283658960168371,1.525605528259597
Moravian College,2083,1886,Pennsylvania,Small City,private,99.96,98.57,100.0,5,3,10,2,1,5,7,4,15,2.476001705745672,5.293485845205514
Morehead State University,9660,5835,Kentucky,Town,NA,100.0,100.0,100.0,18,8,42,8,4,21,26,12,63,20.485336821749556,5.96674628192879
Morehouse College,2202,2090,Georgia,Large City,private,100.0,99.12,100.0,7,3,17,3,1,8,10,4,25,1.9781691439520037,8.780307049841463
Morgan State University,6436,5825,Maryland,Large City,public,100.0,100.0,100.0,14,8,26,7,3,13,21,11,39,12.361528385001067,8.348059767479672
Morningside College,1322,1252,Iowa,Small City,NA,95.01,67.87,99.96,2,1,5,1,0,3,3,1,8,2.3052450370255797,0.6885231495205246
Morris College,745,731,South CaroliNA,Small City,private,100.0,99.3,100.0,7,3,13,3,2,7,10,5,20,9.441651247459548,0.5590664566805537
Mount Aloysius College,1689,999,Pennsylvania,Town,NA,97.51,87.11,99.92,3,1,5,1,1,2,4,2,7,3.2675782110049307,0.4211147062894263
Mount Holyoke College,2213,2161,Massachusetts,Suburb,NA,99.99,99.28,100.0,6,3,13,3,2,6,9,5,19,1.9799871867497698,7.354217893878024
Mount Marty College,875,457,South Dakota,Town,private,89.5,71.79,98.29,2,1,3,1,0,1,3,1,4,1.6908624336101918,0.5579445240068355
Mount Mary University,700,624,Wisconsin,Large City,private,30.96,19.57,49.04,0,0,0,0,0,0,0,0,0,0.3437201645587587,0.026631993017407863
Mount Mercy University,1517,1083,Iowa,Midsize City,NA,99.09,80.06,100.0,3,1,9,2,0,4,5,1,13,4.25813396735554,0.437180389533079
University of Mount Olive,3206,1472,North CaroliNA,Town,private,99.84,94.94,100.0,4,2,10,2,1,5,6,3,15,3.81620805555783,2.575420584249006
Mount Saint Mary College,2036,1737,New York,Suburb,private,99.77,97.32,100.0,4,3,7,2,1,3,6,4,10,4.6868417982903114,1.3971429999857843
Mount Saint Mary's University,2603,2056,California,Large City,NA,100.0,99.99,100.0,13,7,26,6,3,12,19,10,38,18.501018545610723,0.3690314258844093
Mount St Mary's University,1815,1696,Maryland,Town,private,99.78,96.12,100.0,4,2,8,2,1,4,6,3,12,2.397353922191469,3.6944422720199883
Mount Vernon Nazarene University,1829,1440,Ohio,Town,NA,98.65,89.62,99.97,3,2,6,1,1,3,4,3,9,3.7572704869281877,0.5436083350561053
Muhlenberg College,2369,2279,Pennsylvania,Midsize City,NA,99.99,99.54,100.0,7,4,13,3,2,6,10,6,19,0.9548520768401505,8.811180960087432
Murray State University,8559,6584,Kentucky,Town,NA,100.0,100.0,100.0,16,7,37,7,3,18,23,10,55,15.119378024064773,7.891037450443989
Muskingum University,1559,1363,Ohio,Town,NA,98.01,87.11,99.95,3,1,5,1,1,2,4,2,7,3.2689187880674964,0.6409613292826142
Naropa University,391,368,Colorado,Midsize City,NA,73.41,46.55,96.54,1,0,2,0,0,1,1,0,3,0.05588973791534198,1.2642274163599803
NatioNAl Louis University,1883,1250,Illinois,Large City,NA,94.78,80.03,99.74,2,1,4,1,0,2,3,1,6,2.9498848736340593,0.0
NatioNAl University,7881,2899,California,Large City,private,100.0,100.0,100.0,42,21,88,20,9,43,62,30,131,52.18780191801822,9.290491458699618
Nazareth College,2195,2099,New York,Suburb,NA,99.87,98.04,100.0,5,3,8,2,1,4,7,4,12,5.986164277024259,0.6183088652604818
Nebraska Wesleyan University,1776,1566,Nebraska,Large City,NA,74.16,45.18,95.54,1,0,2,0,0,1,1,0,3,0.25430145942864124,1.0918418492247397
Neumann University,2085,1462,Pennsylvania,Suburb,private,99.77,96.45,100.0,4,2,8,2,1,4,6,3,12,2.856289112972052,3.2043547308156435
Nevada State College,4217,1708,Nevada,Rural,public,100.0,100.0,100.0,53,19,151,28,9,83,81,28,234,81.26313354238944,0.14576703157619686
New College of Florida,836,835,Florida,Small City,NA,99.99,99.33,100.0,7,3,13,3,2,7,10,5,20,9.02514091447197,0.6801299510474814
New England College,1841,1811,New Hampshire,Rural,NA,98.51,86.97,99.97,3,1,5,1,1,3,4,2,8,0.5216390341896929,3.6783809556861327
New Jersey City University,6508,5210,New Jersey,Large City,NA,100.0,100.0,100.0,31,17,61,14,7,29,45,24,90,44.47259974831976,0.09940797472696407
New Jersey Institute of Technology,8479,6380,New Jersey,Large City,public,100.0,100.0,100.0,39,22,78,18,9,38,57,31,116,55.564961491638115,1.5513411790506673
New Mexico Highlands University,1933,1315,New Mexico,Town,public,100.0,99.19,100.0,9,3,22,4,1,11,13,4,33,6.137070090601254,6.754428718617614
New Mexico Institute of Mining and Technology,1471,1294,New Mexico,Town,NA,99.96,92.68,100.0,5,2,14,2,1,7,7,3,21,6.009639233238271,1.8465042535599827
New Mexico State University - Main Campus,11711,9703,New Mexico,Suburb,public,100.0,100.0,100.0,56,20,143,26,9,74,82,29,217,46.75693018362567,34.997489238632625
New York Institute of Technology,3663,3234,New York,Suburb,NA,100.0,99.9,100.0,8,5,14,4,2,7,12,7,21,9.414287424041058,2.2581619240015804
New York University,26418,25347,New York,Large City,NA,100.0,100.0,100.0,91,48,181,43,21,90,134,69,271,22.645334629363088,111.17792549661915
Newberry College,1177,1158,South CaroliNA,Town,private,100.0,99.97,100.0,11,5,21,6,3,11,17,8,32,15.028611820336438,1.1970976739214996
Newman University,2811,1013,Kansas,Large City,private,99.35,89.89,100.0,3,2,7,2,1,4,5,3,11,1.5945301434449883,3.414637876665479
Niagara University,2998,2827,New York,Suburb,private,99.99,99.58,100.0,6,4,11,3,2,5,9,6,16,7.784333778843562,1.4629638533371643
Nicholls State University,5684,4662,LouisiaNA,Small City,public,100.0,100.0,100.0,28,13,62,13,6,30,41,19,92,39.182441967756574,2.0730960405723406
Nichols College,1339,1232,Massachusetts,Suburb,private,99.27,93.38,99.99,3,2,6,2,1,3,5,3,9,3.53083551971901,1.3702688666253995
Norfolk State University,4684,4011,Virginia,Midsize City,NA,100.0,100.0,100.0,15,7,28,8,3,15,23,10,43,18.948562303357836,3.8364658623705843
North CaroliNA A & T State University,10339,9347,North CaroliNA,Large City,NA,100.0,99.99,100.0,14,6,29,6,3,14,20,9,43,11.974442640409402,7.765168995729645
North CaroliNA Central University,6355,5363,North CaroliNA,Large City,NA,100.0,99.65,100.0,8,4,17,4,2,8,12,6,25,7.102573516407279,4.704200735963331
North CaroliNA State University,24149,21384,North CaroliNA,Large City,NA,100.0,100.0,100.0,29,14,62,13,6,29,42,20,91,29.26877320642244,12.364742552440468
North CaroliNA Wesleyan College,2090,1754,North CaroliNA,Small City,NA,99.87,95.5,100.0,4,2,9,2,1,5,6,3,14,1.6565964669996203,4.982116318894922
North Central College,2772,2634,Illinois,Midsize City,NA,98.97,91.43,99.99,3,2,6,1,1,3,4,3,9,3.983832837839306,0.5836021853099929
North Central University,1081,912,Minnesota,Large City,NA,79.92,52.58,97.17,1,1,2,1,0,1,2,1,3,0.3226435015605997,1.2792636356789386
North Dakota State University - Main Campus,11981,10782,North Dakota,Midsize City,NA,100.0,100.0,100.0,26,11,66,15,5,42,41,16,108,34.96584962840492,6.340794840252311
North Greenville University,2359,2080,South CaroliNA,Rural,NA,100.0,100.0,100.0,20,10,40,10,5,22,30,15,62,28.902377041810055,1.752441880620197
North Park University,2033,1812,Illinois,Large City,NA,98.98,90.33,99.99,3,2,6,1,1,3,4,3,9,1.983300185884609,2.59454127415947
Northcentral University,90,14,California,Large City,NA,38.61,18.68,69.15,0,0,1,0,0,0,0,0,1,0.0,0.4854532725452225
Northeastern Illinois University,7113,4164,Illinois,Large City,NA,100.0,99.77,100.0,8,4,15,3,2,7,11,6,22,11.132173081276488,0.020001138157735333
Northeastern State University,6830,4753,Oklahoma,Town,NA,100.0,99.98,100.0,14,6,34,7,3,18,21,9,52,18.378134683973077,2.9200270288589456
Northeastern University,13824,13786,Massachusetts,Large City,private,100.0,100.0,100.0,39,21,75,18,9,37,57,30,112,18.54644650249516,38.187721608166385
Northern ArizoNA University,27092,21990,ArizoNA,Small City,NA,100.0,100.0,100.0,129,69,250,57,30,115,186,99,365,128.6025624094884,57.24394371449427
Northern Illinois University,13456,11788,Illinois,Suburb,public,100.0,100.0,100.0,15,8,31,7,4,14,22,12,45,20.45337063736924,1.5428467155413488
Northern Kentucky University,12326,8962,Kentucky,Suburb,public,100.0,100.0,100.0,22,10,49,10,5,24,32,15,73,21.78211019785671,9.96490058834532
Northern Michigan University,7018,6207,Michigan,Town,NA,100.0,99.99,100.0,14,7,31,7,3,16,21,10,47,17.98764191973419,2.944335497940576
Northern State University,3164,1346,South Dakota,Town,NA,100.0,99.54,100.0,7,4,13,3,2,7,10,6,20,6.321963450709509,3.6178952748122155
Northland College,631,594,Wisconsin,Town,private,63.42,40.08,87.63,1,0,1,0,0,1,1,0,2,0.14292317237875177,0.8595780585441581
Northwest Christian University,604,444,Oregon,Midsize City,NA,85.19,63.21,98.29,1,1,3,1,0,1,2,1,4,0.642664616995588,1.25883828731325
Northwest Missouri State University,5478,4806,Missouri,Town,NA,99.99,97.37,100.0,7,3,17,3,1,8,10,4,25,7.002372276809185,2.805663124091668
Northwest Nazarene University,1482,1125,Idaho,Suburb,NA,99.5,89.27,100.0,3,2,9,2,1,6,5,3,15,2.5351146772588065,2.759697787801767
Northwest University,946,929,Washington,Suburb,NA,96.84,85.13,99.99,2,1,6,1,1,4,3,2,10,2.4407060341228655,1.0057970020586093
Northwestern College - 2,1039,997,Iowa,Town,private,95.87,73.69,99.96,2,1,5,1,0,3,3,1,8,1.4960204191059787,1.6821728963705125
University of Northwestern - St Paul,3325,2033,Minnesota,Suburb,NA,97.84,82.81,99.99,3,1,6,1,1,3,4,2,9,1.236256918437584,2.5892942537123815
Northwestern Oklahoma State University,1881,1329,Oklahoma,Town,NA,99.95,95.75,100.0,5,2,12,3,1,6,8,3,18,4.152819543263567,3.498081680840742
Northwestern State University of LouisiaNA,9440,5471,LouisiaNA,Town,public,100.0,100.0,100.0,53,24,117,25,10,58,78,34,175,60.45209420617784,16.84183884930872
Northwestern University,8699,8205,Illinois,Small City,NA,100.0,100.0,100.0,25,13,52,12,6,26,37,19,78,3.8553726362259266,33.12585709525187
Norwich University,3229,2542,Vermont,Town,private,100.0,99.79,100.0,8,4,17,4,2,8,12,6,25,0.0022053499771077212,12.259909630977422
Notre Dame College,1736,1216,Ohio,Suburb,NA,98.41,88.64,99.96,3,2,5,1,1,3,4,3,8,3.9628922548695313,0.1728204298493688
Notre Dame de Namur University,922,718,California,Suburb,private,99.82,96.11,100.0,4,2,9,2,1,4,6,3,13,5.920618672230646,0.35950938853868214
Nova Southeastern University,4501,3154,Florida,Suburb,NA,100.0,100.0,100.0,37,19,74,18,9,37,55,28,111,46.29638650093389,8.457090233823703
Nyack College,1397,1131,New York,Suburb,NA,99.31,93.94,99.99,3,2,6,2,1,3,5,3,9,2.624747417978176,2.336277541066749
Oakland City University,1112,572,IndiaNA,Town,NA,95.66,83.09,99.72,2,1,4,1,1,2,3,2,6,2.9201661710293587,0.21250947311986768
Oakland University,15902,12549,Michigan,Suburb,NA,100.0,100.0,100.0,35,17,78,17,8,40,52,25,118,51.54731131043361,0.8977084698947863
Oakwood University,1648,1521,Alabama,Midsize City,private,99.99,98.94,100.0,6,3,13,3,1,7,9,4,20,1.3472010051506973,7.943266429116565
Oberlin College,2828,2790,Ohio,Town,NA,100.0,99.75,100.0,8,4,16,4,2,8,12,6,24,0.4766686438640238,11.21576403587667
Occidental College,1976,1952,California,Large City,private,100.0,99.63,100.0,7,4,15,3,2,7,10,6,22,6.981792599886325,3.8892132929495493
Oglethorpe University,1253,1166,Georgia,Suburb,NA,99.49,85.8,100.0,4,1,9,2,1,5,6,2,14,2.6934224350329856,2.5654367419626944
Ohio Christian University,3988,2429,Ohio,Town,NA,100.0,99.81,100.0,8,4,16,4,2,8,12,6,24,7.21311815494236,5.036438063115484
Ohio Dominican University,1176,957,Ohio,Large City,NA,95.65,80.57,99.77,2,1,4,1,0,2,3,1,6,2.4884907142901245,0.6400126778671048
Ohio Northern University,2315,2092,Ohio,Town,private,99.84,96.39,100.0,4,2,8,2,1,4,6,3,12,4.299364238773548,2.09947266046873
Ohio State University - Lima Campus,1007,844,Ohio,Rural,public,90.56,71.38,98.82,2,1,3,1,0,1,3,1,4,2.3436208323314505,0.013496260304112172
Ohio State University - Main Campus,45943,42003,Ohio,Large City,NA,100.0,100.0,100.0,85,45,162,39,20,79,124,65,241,90.53432978017385,33.647307112051614
Ohio State University - Newark Campus,2605,2218,Ohio,Suburb,NA,99.78,96.09,100.0,4,2,8,2,1,4,6,3,12,6.0424760442763015,0.07175066865191831
Ohio University - Main Campus,23167,17695,Ohio,Town,public,100.0,100.0,100.0,38,21,71,18,9,34,56,30,105,49.04079165401045,6.79514326000794
Ohio Valley University,528,435,West Virginia,Small City,NA,75.91,50.0,95.1,1,0,2,0,0,1,1,0,3,0.050266601392205026,1.3657622708772996
Ohio Wesleyan University,1557,1545,Ohio,Suburb,private,99.37,92.23,100.0,3,2,7,2,1,3,5,3,10,1.7875074144900893,3.2716323020008886
Oklahoma Baptist University,1962,1835,Oklahoma,Town,NA,100.0,99.39,100.0,8,3,19,4,2,10,12,5,29,3.496962406410505,8.817452255414258
Oklahoma Christian University,1976,1846,Oklahoma,Large City,NA,100.0,99.69,100.0,9,4,21,5,2,12,14,6,33,2.2333066298013735,11.388701884580243
Oklahoma City University,1715,1579,Oklahoma,Large City,NA,100.0,98.77,100.0,7,3,16,3,1,9,10,4,25,2.397270914014639,7.967267325111399
Oklahoma Panhandle State University,1136,852,Oklahoma,Rural,public,99.95,96.06,100.0,5,2,11,3,1,6,8,3,17,1.4728515875019186,6.064851448465229
Oklahoma State University - Main Campus,20992,18221,Oklahoma,Town,NA,100.0,100.0,100.0,86,37,202,44,17,110,130,54,312,41.56494604806278,89.20229032303438
Oklahoma Wesleyan University,1005,609,Oklahoma,Town,NA,99.69,91.56,100.0,4,2,9,2,1,5,6,3,14,1.4926403804242092,4.240130165561318
Old Dominion University,19543,15036,Virginia,Midsize City,public,100.0,100.0,100.0,66,29,121,35,14,66,101,43,187,94.97350790343769,5.218651920924463
Olivet College,1178,1032,Michigan,Rural,private,97.98,83.84,99.98,3,1,6,1,1,3,4,2,9,3.795497329273359,0.09926195194017368
Olivet Nazarene University,3377,3113,Illinois,Suburb,NA,99.96,98.11,100.0,5,3,11,2,1,5,7,4,16,3.1754735203697493,4.521127302592307
Oral Roberts University,3384,2866,Oklahoma,Large City,private,100.0,99.99,100.0,14,6,32,7,3,18,21,9,50,2.9994156129357687,17.792813607695816
Oregon Institute of Technology,5380,2284,Oregon,Town,NA,100.0,99.75,100.0,7,4,13,3,2,8,10,6,21,7.081102798272488,3.0829618221732744
Oregon State University,25835,18829,Oregon,Small City,NA,100.0,100.0,100.0,42,25,80,21,12,42,63,37,122,28.9434917874435,33.878665798344
Ottawa University - Online,156,85,Kansas,Town,NA,66.28,37.06,92.31,1,0,2,0,0,1,1,0,3,0.03683499220752527,1.0401865268465222
Ottawa University - Ottawa,669,646,Kansas,Town,NA,79.16,50.31,96.97,1,0,2,1,0,1,2,0,3,0.3230145470506062,1.2361829807913098
Otterbein University,2483,2294,Ohio,Suburb,private,99.85,96.58,100.0,4,2,8,2,1,4,6,3,12,5.241018471504928,1.2305325803021854
Ouachita Baptist University,1542,1500,Arkansas,Town,private,100.0,99.5,100.0,8,4,19,4,2,10,12,6,29,1.483439967577436,11.157721697628643
University of Holy Cross,912,457,LouisiaNA,Large City,private,99.84,94.58,100.0,4,2,10,2,1,5,6,3,15,6.385181027920958,0.05899736781253926
Our Lady of the Lake University,1344,1221,Texas,Large City,NA,100.0,100.0,100.0,17,7,39,9,3,22,26,10,61,25.52083063975984,0.20640622332758446
Pace University - New York,8670,7878,New York,Large City,NA,100.0,100.0,100.0,22,12,40,10,5,19,32,17,59,15.513562363276533,16.192373049848477
Pacific Lutheran University,2764,2655,Washington,Suburb,NA,100.0,99.69,100.0,7,4,15,4,2,9,11,6,24,7.270965580695362,2.823585032609078
Pacific Union College,1227,1077,California,Rural,NA,99.98,98.74,100.0,6,3,12,3,1,6,9,4,18,7.655089160881652,0.9029928839390027
Pacific University,1876,1818,Oregon,Suburb,NA,99.16,92.37,100.0,3,2,7,2,1,4,5,3,11,1.136455091063299,3.625759369292713
Paine College,425,328,Georgia,Midsize City,NA,83.63,50.37,99.09,1,0,3,1,0,2,2,0,5,0.9367124690725828,0.8666686661260717
Palm Beach Atlantic University,3005,2350,Florida,Midsize City,NA,100.0,100.0,100.0,19,10,39,9,5,20,28,15,59,24.13510534141599,4.5992551983859435
Park University,9864,4134,Missouri,Suburb,NA,100.0,99.94,100.0,13,5,31,6,2,15,19,7,46,14.068748450417267,4.544534418998108
Paul Quinn College,518,492,Texas,Large City,private,99.98,97.21,100.0,6,2,13,3,1,7,9,3,20,7.738322307308497,0.6873421986164262
Paul Smiths College of Arts and Science,768,760,New York,Rural,private,87.11,69.21,97.46,1,1,2,1,0,1,2,1,3,1.3892309538249128,0.655391189106801
William Peace University,932,814,North CaroliNA,Large City,NA,78.41,51.48,96.48,1,1,2,0,0,1,1,1,3,1.1562640927560104,0.3742560839746714
Peirce College,1388,307,Pennsylvania,Large City,NA,95.82,82.31,99.82,2,1,4,1,1,2,3,2,6,2.645477615487863,0.5233581186559803
Pennsylvania State University - Brandywine,1439,1245,Pennsylvania,Suburb,NA,96.04,83.3,99.82,2,1,4,1,1,2,3,2,6,2.777751496262256,0.4469837493429928
Pennsylvania State University - University Park,40833,39785,Pennsylvania,Small City,NA,100.0,100.0,100.0,86,47,167,40,21,81,126,68,248,54.317029072372286,71.32365660795503
Pennsylvania State University - Abington,3891,3312,Pennsylvania,Suburb,NA,99.99,99.37,100.0,6,3,12,3,2,6,9,5,18,7.394936647043417,1.754071680080696
Pennsylvania State University - AltooNA,3478,3374,Pennsylvania,Small City,NA,99.99,99.4,100.0,6,4,12,3,2,6,9,6,18,5.8469188861055965,3.398082580699238
Pennsylvania State University - Beaver,652,563,Pennsylvania,Suburb,NA,79.48,57.88,95.58,1,1,2,1,0,1,2,1,3,1.1821978094211387,0.39841472135737027
Pennsylvania State University - Berks,2718,2411,Pennsylvania,Suburb,public,99.84,97.22,100.0,4,2,9,2,1,4,6,3,13,5.0636094983947375,1.3836152533706447
Pennsylvania State University - Erie - Behrend College,4341,4138,Pennsylvania,Suburb,NA,100.0,99.64,100.0,7,4,13,3,2,6,10,6,19,7.932299287689389,2.2568842808157665
Pennsylvania State University - Greater Allegheny,497,453,Pennsylvania,Suburb,public,69.7,47.83,90.44,1,0,2,0,0,1,1,0,3,0.9197168272594524,0.2721783763915952
Pennsylvania State University - Harrisburg,4288,3960,Pennsylvania,Suburb,public,100.0,99.85,100.0,8,5,16,4,2,8,12,7,24,6.342945939009571,5.710792631844344
Pennsylvania State University - Lehigh Valley,899,739,Pennsylvania,Suburb,public,87.28,68.13,98.21,1,1,3,1,0,1,2,1,4,1.7856973904543074,0.27324610345294936
Pennsylvania State University - New Kensington,597,484,Pennsylvania,Rural,NA,72.71,50.92,92.23,1,0,2,0,0,1,1,0,3,1.2028656032921377,0.09382026302158361
Pennsylvania State University - Schuylkill,733,595,Pennsylvania,Town,NA,85.35,65.65,97.5,1,1,2,1,0,1,2,1,3,1.1408622216791409,0.7760638588296146
Pennsylvania State University - SheNAngo,490,241,Pennsylvania,Suburb,NA,64.3,43.52,86.33,1,0,1,0,0,1,1,0,2,0.888715136452954,0.140196659960007
Pennsylvania State University - Wilkes - Barre,456,387,Pennsylvania,Rural,NA,64.51,43.63,86.79,1,0,1,0,0,1,1,0,2,0.8928486952271537,0.14137490729841762
Pennsylvania State University - Worthington Scranton,1030,904,Pennsylvania,Suburb,public,88.4,69.92,98.46,1,1,3,1,0,1,2,1,4,2.0977810779063915,0.0544377267448548
Pennsylvania State University - York,966,793,Pennsylvania,Suburb,NA,88.95,70.16,98.65,2,1,3,1,0,1,3,1,4,1.7670963759704084,0.4318500037831176
Pepperdine University,3603,3300,California,Suburb,NA,100.0,100.0,100.0,17,8,36,8,4,18,25,12,54,14.519786706681833,10.319933332330653
Peru State College,2046,1105,Nebraska,Rural,public,81.49,54.64,97.64,1,1,3,1,0,1,2,1,4,0.25329895696046,1.4296999042111977
Pfeiffer University,812,733,North CaroliNA,Rural,NA,92.95,71.53,99.67,2,1,4,1,0,2,3,1,6,0.7954345788913156,1.8436405616064895
Cairn University,770,727,Pennsylvania,Suburb,private,90.24,71.83,98.95,2,1,3,1,0,1,3,1,4,0.9093829303239529,1.4125118036596596
Thomas Jefferson University,2690,2279,Pennsylvania,Large City,private,99.99,99.48,100.0,7,4,13,3,2,6,10,6,19,2.5483389842941677,7.10831968798211
Philander Smith College,893,845,Arkansas,Midsize City,private,95.07,73.02,99.9,2,1,5,1,0,2,3,1,7,0.5940874690298125,2.4005244728422923
Piedmont College,1281,1160,Georgia,Town,NA,98.33,70.23,100.0,3,1,8,1,0,4,4,1,12,3.666047203239341,0.419598726422004
University of Pikeville,1562,1049,Kentucky,Town,NA,99.23,88.14,100.0,3,1,8,2,1,4,5,2,12,3.1301426319827903,1.7210702776380633
Pine Manor College,419,417,Massachusetts,Suburb,NA,80.05,59.43,95.07,1,1,2,1,0,1,2,1,3,1.3851412508163625,0.2233470518611589
Pittsburg State University,5709,5109,Kansas,Town,NA,99.82,94.68,100.0,4,2,9,2,1,4,6,3,13,2.9623834117667442,3.360546958690805
Pitzer College,1070,1046,California,Suburb,NA,99.42,93.22,100.0,3,2,7,2,1,3,5,3,10,3.1249742559239633,2.001500013551011
Platt College - Aurora,236,236,Colorado,Large City,private,20.67,8.03,49.0,0,0,0,0,0,0,0,0,0,0.23140312540387206,0.0
Plymouth State University,4148,3971,New Hampshire,Town,NA,99.96,96.47,100.0,5,2,10,2,1,5,7,3,15,1.7634023954525782,5.98266046159546
Point Loma Nazarene University,3097,2571,California,Large City,private,100.0,100.0,100.0,14,7,29,7,3,14,21,10,43,18.40587881416573,2.413849519042767
Point Park University,3282,2758,Pennsylvania,Large City,private,100.0,99.47,100.0,7,4,14,3,2,7,10,6,21,4.410507212071171,5.613207279272603
PomoNA College,1600,1578,California,Suburb,private,99.98,98.57,100.0,6,3,12,3,1,6,9,4,18,3.79827081691929,4.6847401329799245
Portland State University,21163,13990,Oregon,Large City,NA,100.0,100.0,100.0,30,18,59,15,8,33,45,26,92,24.63940765527121,20.221952904983976
Post University,7845,2617,Connecticut,Suburb,private,100.0,100.0,100.0,20,10,42,10,4,22,30,14,64,1.4962264302263821,27.67028432449331
University of the Potomac - VA Campus,37,37,Virginia,Suburb,NA,17.68,7.96,30.47,0,0,0,0,0,0,0,0,0,0.19399468877261755,0.0
Prairie View A & M University,7977,7341,Texas,Town,NA,100.0,100.0,100.0,96,42,223,50,20,123,146,62,346,142.72905589035673,3.4411187876008986
Pratt Institute - Main,3642,3537,New York,Large City,NA,100.0,99.99,100.0,12,6,23,5,3,12,17,9,35,2.848068469010573,14.223081128387468
Presbyterian College,1014,975,South CaroliNA,Town,NA,100.0,99.72,100.0,8,4,16,4,2,9,12,6,25,10.565285776082835,1.5161277569285203
Prescott College,386,291,ArizoNA,Small City,NA,81.02,55.95,97.74,1,1,2,1,0,1,2,1,3,0.29269034470567423,1.3627046084995933
Presentation College,762,475,South Dakota,Town,private,82.88,61.62,96.28,1,1,2,1,0,1,2,1,3,1.2103331451952173,0.5509481594465993
Princeton University,5397,5260,New Jersey,Suburb,private,100.0,100.0,100.0,19,10,40,9,4,20,28,14,60,5.80406280927507,22.701028628883073
Principia College,456,441,Illinois,Rural,private,88.64,65.59,99.05,1,1,3,1,0,2,2,1,5,0.05639716168392254,2.107237664748404
Providence Christian College,165,161,California,Midsize City,private,61.18,38.57,85.63,1,0,1,0,0,1,1,0,2,0.7611178515599348,0.18190422466733372
Providence College,4076,3826,Rhode Island,Midsize City,private,100.0,99.92,100.0,9,5,17,4,2,8,13,7,25,0.331875598034129,12.575074199129151
Purdue University - Main Campus,32130,30277,IndiaNA,Small City,NA,100.0,100.0,100.0,70,38,134,33,17,66,103,55,200,63.55504514892957,39.162251070042515
Queens University of Charlotte,1717,1449,North CaroliNA,Large City,private,99.5,92.12,100.0,4,2,7,2,1,4,6,3,11,1.4057595930490705,3.877343252292096
Quincy University,992,874,Illinois,Town,NA,96.82,82.5,99.93,2,1,5,1,1,2,3,2,7,0.9838171538195376,2.448879789743881
Quinnipiac University,7311,6959,Connecticut,Suburb,private,100.0,100.0,100.0,16,9,30,7,4,15,23,13,45,0.7615219192159616,22.985212573810102
Radford University,8419,8049,Virginia,Small City,NA,100.0,100.0,100.0,28,12,52,15,6,28,43,18,80,41.210763614939836,1.8092730505816965
Ramapo College of New Jersey,5616,4910,New Jersey,Suburb,NA,100.0,100.0,100.0,26,14,52,12,6,25,38,20,77,37.67827029859966,0.32680370769920036
Randolph College,666,645,Virginia,Small City,NA,95.64,75.63,99.77,2,1,4,1,0,2,3,1,6,2.1182122774091217,1.0037260174524139
Randolph - Macon College,1452,1428,Virginia,Suburb,private,99.88,94.98,100.0,4,2,8,2,1,4,6,3,12,5.500011581688535,1.2238894456314569
Reed College,1446,1408,Oregon,Large City,NA,99.95,97.83,100.0,5,3,11,2,1,6,7,4,17,0.14740014151274952,7.491351339889369
Regent University,4280,2263,Virginia,Large City,NA,100.0,99.99,100.0,14,7,29,7,3,15,21,10,44,9.972375622851853,11.687590597299902
Regis University,4084,2378,Colorado,Large City,NA,99.99,98.29,100.0,6,3,15,3,1,8,9,4,23,2.5454343794425927,6.783402221858398
Reinhardt University,1408,1260,Georgia,Rural,NA,98.85,73.2,100.0,3,1,9,1,0,5,4,1,14,4.076045951683251,0.37850510018898087
Rensselaer Polytechnic Institute,6366,6340,New York,Small City,NA,100.0,100.0,100.0,15,8,30,7,4,15,22,12,45,6.131177946525816,16.633111716392484
Rhode Island College,7079,5461,Rhode Island,Suburb,public,99.98,99.19,100.0,6,3,11,3,1,5,9,4,16,4.505606333310961,4.198034580293209
Rhodes College,1984,1979,Tennessee,Large City,NA,100.0,99.67,100.0,9,4,20,4,2,10,13,6,30,1.8189845901349682,11.186113722065112
Rice University,4004,3916,Texas,Large City,NA,100.0,100.0,100.0,34,15,76,17,7,41,51,22,117,41.27105230564532,9.457268542913415
Rider University,4092,3711,New Jersey,Suburb,private,100.0,100.0,100.0,16,9,32,7,4,16,23,13,48,20.62367815760182,3.056058237608901
Ripon College,759,739,Wisconsin,Town,NA,61.39,38.38,86.33,1,0,1,0,0,1,1,0,2,0.2777943350460246,0.6706254773052216
Rivier University,1427,908,New Hampshire,Small City,private,96.03,77.37,99.81,2,1,4,1,0,2,3,1,6,0.5872540070437423,2.6321410140707795
Roanoke College,2036,1973,Virginia,Suburb,NA,99.98,98.34,100.0,6,3,11,3,1,6,9,4,17,5.374177188971162,3.368315797083959
Robert Morris University,4245,3840,Pennsylvania,Suburb,NA,99.99,99.48,100.0,7,4,13,3,2,6,10,6,19,7.492075278237111,2.0184705948773973
Roberts Wesleyan College,1322,1248,New York,Suburb,NA,97.87,89.83,99.88,3,2,5,1,1,2,4,3,7,3.19900154920434,0.6453741430443194
Rochester College,1152,762,Michigan,Suburb,NA,97.71,82.94,99.98,3,1,6,1,1,3,4,2,9,3.559507858023202,0.21157272252265016
Rochester Institute of Technology,13510,12447,New York,Suburb,private,100.0,100.0,100.0,31,17,57,14,8,28,45,25,85,20.32221564394815,24.909393211423815
Rockford University,1059,918,Illinois,Midsize City,NA,90.41,68.08,99.46,2,1,3,1,0,2,3,1,5,1.279902252660131,1.0562770455024415
Rockhurst University,2208,1445,Missouri,Large City,NA,97.94,78.94,99.99,3,1,6,1,0,3,4,1,9,2.591292902831067,1.2808392866459934
Rocky Mountain College,898,868,MontaNA,Midsize City,private,99.44,55.33,100.0,3,1,23,2,0,20,5,1,43,3.455447239528832,1.7027777496456098
Roger Williams University,4704,4042,Rhode Island,Suburb,private,100.0,99.94,100.0,9,5,17,4,2,8,13,7,25,0.3113309181558258,12.971993389310738
Rollins College,2614,2453,Florida,Suburb,private,100.0,100.0,100.0,15,8,31,7,4,16,22,12,47,18.336146020805042,4.341857054199271
Roosevelt University,2576,2117,Illinois,Large City,NA,99.8,95.62,100.0,4,2,9,2,1,4,6,3,13,2.7524948077403306,3.423549656641645
Rosemont College,634,520,Pennsylvania,Suburb,NA,84.18,63.82,97.32,1,1,2,1,0,1,2,1,3,1.0127218996789475,0.8273665805863128
Rowan University,15399,13634,New Jersey,Suburb,NA,100.0,100.0,100.0,71,39,141,33,17,68,104,56,209,102.60262691277731,1.2198727836359768
Rust College,862,792,Mississippi,Town,NA,99.84,95.32,100.0,4,2,9,2,1,4,6,3,13,4.366118746473439,2.010298695697017
Rutgers University - Camden,5489,4493,New Jersey,Small City,NA,100.0,100.0,100.0,25,14,50,12,6,24,37,20,74,35.959057381160356,1.1458153206257862
Rutgers University - New Brunswick,35638,33677,New Jersey,Small City,NA,100.0,100.0,100.0,164,90,324,75,39,157,239,129,481,226.78481436525269,11.552310622154408
Rutgers University - Newark,8549,7162,New Jersey,Large City,NA,100.0,100.0,100.0,40,22,79,18,9,38,58,31,117,56.238892955274316,1.686157073700967
Sacred Heart University,5605,4982,Connecticut,Suburb,NA,100.0,99.99,100.0,12,7,21,5,3,10,17,10,31,0.7208334378006582,16.16763511953449
SagiNAw Valley State University,7850,6559,Michigan,Suburb,public,100.0,100.0,100.0,17,8,38,8,4,20,25,12,58,25.421310264114137,0.20899354844353257
Saint Ambrose University,2369,2215,Iowa,Midsize City,private,99.28,88.73,100.0,3,2,8,2,1,4,5,3,12,2.1977465637964078,2.7341761846159414
Saint Anselm College,1965,1926,New Hampshire,Suburb,NA,99.62,94.58,100.0,4,2,7,2,1,3,6,3,10,0.3641630993399743,5.207964425026913
Saint Augustine's University,972,961,North CaroliNA,Large City,private,95.2,77.38,99.79,2,1,4,1,0,2,3,1,6,0.6760523233747439,2.3505984495262315
St. BoNAventure University,1621,1586,New York,Town,NA,99.37,94.83,99.99,3,2,6,2,1,3,5,3,9,3.6833472053395395,1.375843361788272
Saint Cloud State University,13133,8373,Minnesota,Small City,NA,99.99,99.17,100.0,7,3,14,3,1,7,10,4,21,6.263846565651238,3.542246810654485
Saint Edward's University,3941,3528,Texas,Large City,NA,100.0,100.0,100.0,48,21,110,25,10,61,73,31,171,70.8173738426414,1.3026895465734591
Saint Francis University,2119,1526,Pennsylvania,Town,private,99.33,93.61,99.99,3,2,7,2,1,3,5,3,10,3.8152747485864023,1.188285199080172
St. John Fisher College,2746,2624,New York,Suburb,NA,99.97,99.23,100.0,5,3,9,3,1,4,8,4,13,7.78143350545353,0.2518163155156736
Saint Johns University,1724,1703,Minnesota,Rural,NA,84.45,58.57,98.58,1,1,3,1,0,1,2,1,4,0.7995475324868733,1.0554651019632626
University of Saint Joseph,808,654,Connecticut,Small City,NA,52.79,36.34,73.76,1,0,1,0,0,0,1,0,1,0.3227336366804743,0.4269142979661842
St. Joseph's College - New York,928,798,New York,Large City,NA,94.01,81.62,99.19,2,1,3,1,1,2,3,2,5,2.6363485115383,0.17458232424273695
Saint Joseph's College of Maine,1537,960,Maine,Rural,private,92.94,72.29,99.39,2,1,3,1,0,2,3,1,5,0.6687398786181437,1.9767534838787426
Saint Joseph's University,5143,4481,Pennsylvania,Large City,NA,100.0,100.0,100.0,13,7,26,6,3,13,19,10,39,3.9578825262962947,15.563360187507467
Saint Leo University,9672,6732,Florida,Suburb,private,100.0,100.0,100.0,70,37,140,34,17,69,104,54,209,93.69539202761774,9.815539260621263
Saint Louis University,9900,6625,Missouri,Large City,NA,100.0,100.0,100.0,16,8,36,8,3,18,24,11,54,5.902197185887584,17.92994348251546
Saint Martin's University,1318,1121,Washington,Suburb,NA,98.96,94.36,99.97,3,2,5,2,1,3,5,3,8,4.041049212185463,0.5132566130812005
Saint Mary - of - the - Woods College,662,491,IndiaNA,Rural,private,87.0,66.67,98.22,1,1,3,1,0,1,2,1,4,1.4029369764925783,0.6324088497779663
Saint Mary's College,1533,1486,IndiaNA,Suburb,NA,99.54,93.47,100.0,4,2,7,2,1,4,6,3,11,1.2429278712306957,4.121730580548612
Saint Mary's College of California,2776,2614,California,Suburb,NA,100.0,100.0,100.0,13,7,27,6,3,13,19,10,40,17.98140924310346,1.4501397278356836
Saint Mary's University of Minnesota,1501,1129,Minnesota,Town,NA,78.06,53.3,95.81,1,1,2,0,0,1,1,1,3,0.5404550236579069,0.9731751742576203
Saint Michael's College,1790,1766,Vermont,Suburb,private,98.29,88.83,99.95,3,2,5,1,1,2,4,3,7,0.0023775394648098253,4.058437882831154
Saint Norbert College,2068,2021,Wisconsin,Suburb,private,91.73,72.91,99.41,2,1,3,1,0,2,3,1,5,0.7060606015753125,1.7795234073185398
Saint Peter's University,2633,2387,New Jersey,Large City,NA,100.0,99.98,100.0,11,6,21,5,3,10,16,9,31,13.437368162705553,2.0442539310210455
St. Thomas AquiNAs College,1777,1091,New York,Suburb,NA,99.89,98.04,100.0,5,3,8,2,1,4,7,4,12,3.8225603280610336,2.9622029702303463
St. Thomas University,2907,935,Florida,Suburb,NA,100.0,100.0,100.0,25,13,51,12,6,25,37,19,76,36.01888817449899,1.245079780907608
Saint Vincent College,1667,1617,Pennsylvania,Suburb,NA,98.88,91.13,99.99,3,2,6,1,1,3,4,3,9,2.777751496262256,1.7067278192475124
Saint Xavier University,2942,2638,Illinois,Large City,NA,99.19,92.54,99.99,3,2,7,1,1,3,4,3,10,4.29871699057454,0.5078404101702237
Salem College,817,673,North CaroliNA,Midsize City,private,94.14,71.74,99.84,2,1,4,1,0,2,3,1,6,0.7216590277293893,2.100659387855457
Salem InterNAtioNAl University,892,892,West Virginia,Rural,private,98.62,87.22,99.99,3,1,6,1,1,3,4,2,9,0.033811615286236565,4.2268038926981735
Salem State University,7110,5792,Massachusetts,Suburb,NA,100.0,100.0,100.0,20,11,37,9,5,18,29,16,55,28.807538897346436,0.7757829605653842
Salisbury University,7783,7191,Maryland,Suburb,public,100.0,100.0,100.0,16,9,29,7,4,14,23,13,43,17.707352073565954,5.359133596485449
Salve RegiNA University,2180,2087,Rhode Island,Suburb,NA,99.6,95.24,100.0,4,2,7,2,1,3,6,3,10,0.2433754385583613,5.25979369676808
Sam Houston State University,18416,14808,Texas,Town,public,100.0,100.0,100.0,235,102,544,122,48,302,357,150,846,355.66970786697465,1.058256410138387
Samford University,3375,3266,Alabama,Suburb,private,100.0,99.97,100.0,13,6,28,6,3,14,19,9,42,5.875868999388041,12.905226305725074
San Diego Christian College,656,504,California,Suburb,private,98.82,89.8,99.99,3,2,6,1,1,3,4,3,9,3.878773666603514,0.5414170878080581
San Diego State University,30267,27060,California,Large City,NA,100.0,100.0,100.0,149,77,302,69,34,145,218,111,447,202.31097969733497,15.191476284486667
San Francisco State University,26676,22263,California,Large City,public,100.0,100.0,100.0,133,70,267,61,31,127,194,101,394,193.51421375911343,0.5587405933739397
San Jose State University,27777,23097,California,Large City,NA,100.0,100.0,100.0,139,73,280,64,32,133,203,105,413,202.77204147279917,0.2157029130192196
Santa Clara University,5498,5411,California,Midsize City,private,100.0,100.0,100.0,23,12,47,11,5,23,34,17,70,24.663145766894043,8.575894699822749
Sarah Lawrence College,1401,1384,New York,Suburb,NA,99.83,96.34,100.0,4,2,9,2,1,4,6,3,13,0.8004754556485928,5.578344266447174
SavanNAh State University,4237,3687,Georgia,Midsize City,NA,100.0,99.01,100.0,10,3,28,5,1,14,15,4,42,11.69543875123212,2.80276830617312
Schreiner University,1249,1137,Texas,Town,NA,100.0,100.0,100.0,16,7,36,8,3,20,24,10,56,23.723038588566958,0.14319446359938984
Scripps College,1064,1060,California,Suburb,NA,99.63,94.35,100.0,4,2,8,2,1,4,6,3,12,3.1615664603258833,2.4232664768986933
Seattle Pacific University,2898,2783,Washington,Large City,private,100.0,99.8,100.0,7,4,14,4,2,8,11,6,22,6.152917606980397,4.67355382196118
Seattle University,4563,4325,Washington,Large City,private,100.0,100.0,100.0,13,7,27,7,3,15,20,10,42,7.113854264127574,12.519436836042775
Seton Hall University,5972,5554,New Jersey,Suburb,NA,100.0,100.0,100.0,24,13,47,11,6,23,35,19,70,28.133200180976672,6.4317277755895335
Seton Hill University,2091,1551,Pennsylvania,Suburb,NA,99.53,94.5,100.0,4,2,7,2,1,3,6,3,10,3.315114136908228,2.0302584107940707
Sewanee - The University of the South,1700,1687,Tennessee,Rural,NA,100.0,98.9,100.0,7,3,15,3,1,8,10,4,23,1.4105710689537208,8.696955631573454
Shaw University,1545,1466,North CaroliNA,Large City,private,98.62,87.48,99.99,3,1,6,1,1,3,4,2,9,1.329301294572165,2.9410736925819805
Shawnee State University,3408,2832,Ohio,Town,public,99.97,98.55,100.0,6,3,11,3,1,5,9,4,16,7.222464598939694,0.893073397398686
SheNAndoah University,2060,1991,Virginia,Small City,NA,99.99,98.66,100.0,6,3,12,3,1,6,9,4,18,6.637764215841455,2.741737725606883
Shepherd University,3419,2614,West Virginia,Town,NA,99.52,92.43,100.0,4,2,7,2,1,3,6,3,10,0.46321912942144094,4.862213982603315
Shippensburg University of Pennsylvania,5573,5160,Pennsylvania,Town,NA,100.0,99.89,100.0,8,5,16,4,2,8,12,7,24,10.676982313758046,1.6463424831537115
Shorter University,1402,1140,Georgia,Small City,NA,99.41,82.12,100.0,4,1,10,2,1,5,6,2,15,3.6181641377276437,1.495739474255637
Shorter University - College of Adult & ProfessioNAl Programs,113,56,Georgia,Small City,NA,28.73,8.87,65.48,0,0,1,0,0,0,0,0,1,0.33817415017636376,0.0
SieNA College,3161,3039,New York,Suburb,NA,99.99,99.65,100.0,7,4,11,3,2,5,10,6,16,7.308688942878456,2.2405949231220443
SieNA Heights University,2301,1290,Michigan,Town,NA,99.95,97.11,100.0,5,2,11,2,1,6,7,3,17,6.932190717973363,0.5886394413701462
Sierra Nevada College,452,410,Nevada,Town,private,95.7,75.32,99.96,2,1,5,1,0,3,3,1,8,1.0330885290829073,2.0947790816561582
Silver Lake College of the Holy Family,393,267,Wisconsin,Town,NA,34.69,19.36,59.18,0,0,1,0,0,0,0,0,1,0.1781507148664723,0.2458451420150009
Simmons College,1743,1553,Massachusetts,Large City,NA,99.77,96.21,100.0,4,2,8,2,1,4,6,3,12,4.495335715839606,1.5543946426843636
Simpson College,1433,1280,Iowa,Town,NA,98.61,77.25,100.0,3,1,8,1,0,4,4,1,12,3.7475162195169722,0.5185007019700947
Simpson University,779,619,California,Small City,NA,99.48,93.26,100.0,4,2,7,2,1,3,6,3,10,4.427656732632313,0.8012687868917596
Skidmore College,2682,2636,New York,Suburb,private,99.99,99.37,100.0,6,4,12,3,2,6,9,6,18,2.4855342952566812,6.651018842703766
Slippery Rock University of Pennsylvania,7613,7125,Pennsylvania,Town,NA,100.0,99.99,100.0,12,7,22,5,3,11,17,10,33,13.454733810020302,3.614601609340161
Smith College,2526,2505,Massachusetts,Suburb,private,100.0,99.63,100.0,7,4,15,4,2,7,11,6,22,2.319899150140288,8.559008952637965
Soka University of America,409,412,California,Suburb,NA,93.24,74.18,99.64,2,1,4,1,0,2,3,1,6,2.049163446507517,0.6337690560427404
Sonoma State University,8670,7887,California,Suburb,NA,100.0,100.0,100.0,43,23,87,20,10,42,63,33,129,63.10691571155113,0.21181589186349428
South CaroliNA State University,2523,2281,South CaroliNA,Town,NA,100.0,100.0,100.0,21,10,42,11,5,22,32,15,64,28.37177184773795,3.2189502621720396
South College,1410,1410,Tennessee,Midsize City,NA,99.22,83.5,100.0,3,1,8,1,1,4,4,2,12,4.839185419038312,0.0
South Dakota State University,10886,8425,South Dakota,Town,NA,100.0,100.0,100.0,18,11,33,9,5,17,27,16,50,20.725828870948373,6.547726308712115
South University - Columbia,806,556,South CaroliNA,Suburb,NA,100.0,99.8,100.0,8,4,16,4,2,9,12,6,25,12.578464306532886,0.0
South University - SavanNAh,499,396,Georgia,Midsize City,NA,96.05,77.06,99.93,2,1,5,1,0,2,3,1,7,0.20948841161367665,3.0027333816247923
South University - Tampa,543,424,Florida,Large City,private,99.94,97.85,100.0,5,3,10,2,1,5,7,4,15,7.391631246694238,0.0
South University - West Palm Beach,699,535,Florida,Suburb,NA,99.99,99.25,100.0,6,3,13,3,2,6,9,5,19,9.392680589721959,0.03088841756832965
Southeast Missouri State University,10462,7779,Missouri,Small City,NA,100.0,99.93,100.0,13,5,31,6,2,15,19,7,46,15.213899252602959,3.1431619577096286
Southeastern LouisiaNA University,13317,8998,LouisiaNA,Small City,NA,100.0,100.0,100.0,66,30,146,30,13,70,96,43,216,92.9208111557625,3.3801363398350075
Southeastern Oklahoma State University,3122,2374,Oklahoma,Town,NA,100.0,99.98,100.0,14,6,32,7,3,17,21,9,49,6.592495013540257,13.945298439101729
Southeastern University,6241,4288,Florida,Midsize City,private,100.0,100.0,100.0,44,23,89,21,10,45,65,33,134,55.87964321856325,9.010175255873625
Southern Adventist University,2596,2173,Tennessee,Suburb,NA,100.0,99.86,100.0,10,5,21,5,2,11,15,7,32,2.1244367194217837,12.128896981965456
Southern Arkansas University Main Campus,3478,2924,Arkansas,Town,public,100.0,99.93,100.0,12,5,27,6,2,14,18,7,41,4.724240472284976,12.727729975982161
Southern Connecticut State University,7944,6814,Connecticut,Midsize City,NA,99.76,97.52,100.0,4,3,7,2,1,3,6,4,10,3.3979505672848216,2.6427544620824017
Southern Illinois University Carbondale,10990,9455,Illinois,Small City,NA,100.0,100.0,100.0,14,7,28,6,3,13,20,10,41,15.598514969078241,4.3616726522902125
Southern Illinois University Edwardsville,11408,9550,Illinois,Suburb,NA,100.0,99.99,100.0,13,7,26,6,3,12,19,10,38,16.466404623880827,2.065122446769655
Southern Methodist University,6454,6240,Texas,Suburb,NA,100.0,100.0,100.0,53,24,119,27,11,65,80,35,184,62.043366984102214,17.55206060368836
Southern Nazarene University,1517,1483,Oklahoma,Suburb,NA,100.0,98.82,100.0,7,3,16,4,1,9,11,4,25,2.6658331036742977,7.987491059478036
Southern New Hampshire University,70662,19935,New Hampshire,Suburb,NA,100.0,100.0,100.0,124,63,233,57,28,111,181,91,344,19.12594439979473,161.22025965918561
Southern Oregon University,5522,3640,Oregon,Suburb,public,100.0,99.98,100.0,11,6,23,5,3,12,16,9,35,5.25481504492952,10.886707026376186
Southern University and A & M College,5152,4530,LouisiaNA,Midsize City,NA,100.0,100.0,100.0,28,13,61,13,5,30,41,18,91,29.940356676783733,10.49090962066792
Southern University at New Orleans,2108,1520,LouisiaNA,Large City,NA,100.0,99.9,100.0,10,5,23,5,2,11,15,7,34,14.584496262879862,0.6872208774328128
Southern Utah University,8549,6279,Utah,Town,public,100.0,100.0,100.0,40,14,109,21,7,59,61,21,168,39.39170566530441,21.53734886730494
Southern Virginia University,908,853,Virginia,Town,NA,99.45,88.9,100.0,3,2,8,2,1,4,5,3,12,0.7550063563042413,4.4271833430722785
Southern Wesleyan University,1360,820,South CaroliNA,Suburb,NA,100.0,99.97,100.0,11,5,22,6,3,12,17,8,34,14.341946275066654,2.149799718897987
Southwest Baptist University,2827,1835,Missouri,Town,private,99.97,96.41,100.0,6,2,13,3,1,7,9,3,20,3.4319927364598373,4.683931150110712
Southwest Minnesota State University,6711,1932,Minnesota,Town,public,99.91,96.94,100.0,5,2,10,2,1,5,7,3,15,2.9977600759477263,4.055360503909794
Southwestern Adventist University,802,652,Texas,Town,private,100.0,99.17,100.0,7,3,17,4,2,9,11,5,26,10.180974550777089,1.0438677395624774
Southwestern Assemblies of God University,1788,1492,Texas,Suburb,private,100.0,100.0,100.0,16,7,36,8,3,20,24,10,56,20.967726857934387,2.5711796448458446
Southwestern Christian University,620,539,Oklahoma,Suburb,NA,92.41,65.7,99.79,2,1,4,1,0,2,3,1,6,1.552006759191081,1.015713560179699
Southwestern College - Winfield,1148,577,Kansas,Town,NA,98.77,84.7,100.0,3,1,7,1,1,4,4,2,11,0.43776971508174267,3.9269331664300307
Southwestern Oklahoma State University,4626,3713,Oklahoma,Town,public,100.0,99.92,100.0,12,5,28,6,2,15,18,7,43,11.924161220888852,5.698459990381702
Southwestern University,1398,1367,Texas,Suburb,NA,100.0,100.0,100.0,17,7,38,9,3,21,26,10,59,24.6219346141634,0.46866932083689317
Spalding University,1250,916,Kentucky,Large City,NA,96.31,76.94,99.96,2,1,5,1,0,3,3,1,8,2.8565839481792525,0.43746190158799864
Spelman College,2139,2086,Georgia,Large City,NA,100.0,99.35,100.0,8,3,17,4,2,8,12,5,25,1.6010900030473858,9.515125151961097
Spring Arbor University,1958,1380,Michigan,Suburb,NA,99.82,94.92,100.0,4,2,9,2,1,5,6,3,14,5.558863100559255,0.760720301385675
Spring Hill College,1376,1363,Alabama,Midsize City,NA,99.99,98.62,100.0,6,3,13,3,1,6,9,4,19,3.1037438541741067,6.020115786998452
Springfield College,2230,2188,Massachusetts,Midsize City,private,99.83,97.12,100.0,4,2,8,2,1,4,6,3,12,3.4798487252104326,2.857608937688438
St. Andrews University,641,567,North CaroliNA,Town,NA,94.39,74.42,99.85,2,1,4,1,0,2,3,1,6,0.33131929339992405,2.5363914255357587
St Catherine University,3157,2124,Minnesota,Large City,private,94.3,75.57,99.82,2,1,4,1,0,2,3,1,6,1.5132740662421391,1.3452815101388014
St. Francis College,2286,2097,New York,Large City,NA,99.9,98.4,100.0,5,3,8,2,1,4,7,4,12,6.241388335346999,0.644795431247558
St John's College MD,466,458,Maryland,Suburb,NA,89.36,65.9,99.13,1,1,3,1,0,2,2,1,5,0.2480021298818761,1.9807578270236497
St. John's College,319,309,New Mexico,Rural,NA,79.12,51.7,97.0,1,1,2,1,0,1,2,1,3,0.16311149742461806,1.3963960577962569
St John's University - New York,16760,11526,New York,Large City,NA,100.0,100.0,100.0,43,25,81,20,11,40,63,36,121,33.79108526725273,30.072143044888126
St Lawrence University,2411,2372,New York,Town,private,99.84,97.3,100.0,4,2,8,2,1,4,6,3,12,3.0336859659725657,3.3912241829292404
St Mary's College of Maryland,1574,1516,Maryland,Suburb,NA,99.04,91.67,99.99,3,2,6,1,1,3,4,3,9,3.725543106669961,0.9077142820237931
St. Mary's University,2323,2228,Texas,Large City,NA,100.0,100.0,100.0,28,12,65,15,6,36,43,18,101,42.20903076713726,0.7948635796059185
St Olaf College,3039,3003,Minnesota,Town,NA,99.61,92.99,100.0,4,2,8,2,1,4,6,3,12,0.8500624241453509,4.681301601230086
Stanford University,7064,7064,California,Suburb,NA,100.0,100.0,100.0,29,15,62,14,7,31,43,22,93,21.699177210338526,21.55708879103006
SUNY New Paltz,6733,6235,New York,Suburb,NA,100.0,100.0,100.0,14,8,23,6,4,11,20,12,34,18.492143134838507,1.6249951937517675
Stephen F Austin State University,10988,9567,Texas,Town,NA,100.0,100.0,100.0,140,60,323,72,28,179,212,88,502,210.8497416562088,0.9891137562176756
Stephens College,654,542,Missouri,Midsize City,NA,81.11,49.76,98.57,1,0,3,1,0,1,2,0,4,0.7715064316840159,0.8895379918142756
Sterling College Kansas,698,599,Kansas,Rural,private,95.22,74.45,99.9,2,1,4,1,0,2,3,1,6,0.2571365802179168,2.7636467187728853
Sterling College Vermont,155,120,Vermont,Rural,private,40.92,22.99,66.38,0,0,1,0,0,0,0,0,1,6.62267260392709e-05,0.5248194819690848
Stetson University,3068,3028,Florida,Suburb,private,100.0,100.0,100.0,25,13,51,12,6,26,37,19,77,35.58328559642493,2.0401065224324864
Stevens Institute of Technology,3125,3113,New Jersey,Suburb,NA,100.0,99.99,100.0,12,7,24,6,3,12,18,10,36,14.262590363076416,3.790879515845763
Stevenson University,3401,2926,Maryland,Rural,NA,99.99,99.52,100.0,7,4,12,3,2,6,10,6,18,8.035269008172785,1.7757014261091513
Stillman College,675,552,Alabama,Midsize City,NA,96.76,77.42,99.95,2,1,5,1,0,2,3,1,7,2.217700116171148,1.198722148217744
Stonehill College,2494,2482,Massachusetts,Suburb,private,99.97,98.87,100.0,6,3,10,3,1,5,9,4,15,5.608547395943554,2.495187683166654
Stony Brook University,17369,16212,New York,Suburb,NA,100.0,100.0,100.0,36,22,63,17,10,31,53,32,94,44.82372524293117,8.350747776662862
Stratford University,1979,471,Virginia,Suburb,NA,99.99,98.49,100.0,6,3,11,3,1,6,9,4,17,7.350825774573238,1.9888000780697053
Strayer University - District of Columbia,691,107,District of Columbia,Large City,NA,86.49,67.84,96.82,1,1,2,1,0,1,2,1,3,1.0645578100042798,0.9343515001413332
Suffolk University,5028,4762,Massachusetts,Large City,private,100.0,100.0,100.0,13,7,24,6,3,12,19,10,36,13.600727435163119,5.024537256838
Sul Ross State University,2292,1378,Texas,Town,NA,100.0,100.0,100.0,29,12,67,15,6,37,44,18,104,43.55737480553192,0.281622603996425
Sullivan University,2596,1321,Kentucky,Large City,NA,99.87,94.77,100.0,5,2,11,2,1,5,7,3,16,4.797798454400512,1.847000944949961
Summit Christian College,32,17,Nebraska,Town,NA,1.35,0.58,3.35,0,0,0,0,0,0,0,0,0,0.0013366699575749867,0.012220422112693582
University at Albany,13510,12740,New York,Small City,public,100.0,100.0,100.0,28,17,47,13,7,23,41,24,70,37.19310595375926,3.198847690991064
Binghamton University,13739,13345,New York,Suburb,public,100.0,100.0,100.0,30,18,53,14,8,26,44,26,79,34.07241178608575,10.404442239778591
SUNY Fredonia,4393,4281,New York,Town,NA,100.0,99.96,100.0,9,5,15,4,2,7,13,7,22,12.549482958664713,0.21066631322629817
SUNY Geneseo,5558,5452,New York,Town,NA,100.0,99.99,100.0,11,7,19,5,3,9,16,10,28,15.777487241769366,0.43075743106748443
Purchase College,4062,3712,New York,Suburb,public,100.0,99.95,100.0,9,5,16,4,2,8,13,7,24,9.31277785538997,3.702095610060458
The College at Brockport,7182,6419,New York,Town,NA,100.0,100.0,100.0,14,9,24,7,4,12,21,13,36,20.42372521259924,0.6734707564788975
Buffalo State,8527,7665,New York,Large City,NA,100.0,100.0,100.0,17,11,29,8,5,14,25,16,43,24.15637706556931,0.933369136750769
SUNY Cortland,6345,6196,New York,Town,public,100.0,100.0,100.0,13,8,22,6,3,11,19,11,33,17.601759204098947,1.185914484678153
SUNY Old Westbury,4634,4056,New York,Suburb,public,100.0,99.97,100.0,9,6,15,4,2,7,13,8,22,13.23394747871206,0.06822610829993775
SUNY Oneonta,5940,5828,New York,Town,NA,100.0,100.0,100.0,12,7,20,5,3,10,17,10,30,17.010103432532595,0.2569163165883063
SUNY Oswego,7123,6836,New York,Town,NA,100.0,100.0,100.0,14,9,24,7,4,12,21,13,36,20.336717010898308,0.4919877639701063
SUNY Plattsburgh,5353,4894,New York,Town,public,100.0,99.99,100.0,10,6,17,5,3,8,15,9,25,14.773992648818593,0.4730892502419327
SUNY Potsdam,3323,3196,New York,Town,public,99.99,99.72,100.0,7,4,11,3,2,5,10,6,16,9.306977308609907,0.3814888836986664
SUNY College of Environmental Science and Forestry,1791,1737,New York,Midsize City,NA,99.69,96.53,100.0,4,2,7,2,1,3,6,3,10,4.382313092337043,1.3916557079701264
SUNY Empire State College,9810,3772,New York,Suburb,NA,100.0,100.0,100.0,20,12,34,9,5,17,29,17,51,26.705717375406675,2.706860018585315
SUNY Polytechnic Institute,2179,1859,New York,Suburb,NA,99.82,97.86,100.0,4,3,7,2,1,3,6,4,10,6.319695716877839,0.0
SUNY Maritime College,1640,1581,New York,Large City,public,99.74,96.56,100.0,4,2,7,2,1,4,6,3,11,3.497729708377547,2.426849404684282
SusquehanNA University,2354,2283,Pennsylvania,Town,NA,99.98,98.92,100.0,6,3,11,3,1,5,9,4,16,2.31892647232608,6.010840630151275
Swarthmore College,1581,1573,Pennsylvania,Suburb,NA,99.9,96.92,100.0,5,2,10,2,1,5,7,3,15,0.4340236712909775,6.477898892376242
Sweet Briar College,320,314,Virginia,Suburb,NA,78.41,49.87,96.26,1,0,2,1,0,1,2,0,3,0.8336528517525997,0.6943558223880125
Syracuse University,15248,14675,New York,Midsize City,NA,100.0,100.0,100.0,41,22,77,19,10,38,60,32,115,18.439938213817946,41.172468969782926
Tabor College,712,554,Kansas,Town,private,96.59,78.76,99.95,2,1,5,1,0,3,3,1,8,0.22313504894943195,3.133152653610702
Talladega College,782,762,Alabama,Town,NA,98.4,84.87,99.99,3,1,6,1,1,3,4,2,9,2.310967878066196,1.8115470913620344
Tarleton State University,11290,8429,Texas,Town,NA,100.0,100.0,100.0,144,62,333,74,29,185,218,91,518,217.57192063023436,0.6846657939908014
Taylor University,2111,1840,IndiaNA,Town,NA,99.79,95.96,100.0,4,2,8,2,1,4,6,3,12,2.168694837388731,3.961486547793198
Temple University,29583,26643,Pennsylvania,Large City,NA,100.0,100.0,100.0,54,30,105,25,13,50,79,43,155,46.45500028384429,32.94439974993786
Tennessee State University,6504,5431,Tennessee,Large City,NA,100.0,99.99,100.0,16,7,39,7,3,18,23,10,57,16.171802620218813,7.1880607469745845
Tennessee Technological University,9365,8259,Tennessee,Town,NA,100.0,100.0,100.0,23,9,56,10,3,25,33,12,81,31.368904063837,1.1561767308975626
Tennessee Wesleyan University,931,863,Tennessee,Town,NA,97.2,75.36,99.98,2,1,6,1,0,3,3,1,9,2.8863510194405815,0.6814151941279037
Texas A&M InterNAtioNAl University,6800,5191,Texas,Large City,public,100.0,100.0,100.0,87,38,201,45,18,112,132,56,313,131.94230358319942,0.15854005040439278
Texas A&M University - College Station,53069,46724,Texas,Midsize City,public,100.0,100.0,100.0,665,288,1539,344,135,853,1009,423,2392,1001.3701725144359,8.26454836258046
Texas A&M University - Commerce,8490,6068,Texas,Town,NA,100.0,100.0,100.0,107,46,248,56,22,138,163,68,386,161.74266095351624,1.0268467762686684
Texas A&M University - Corpus Christi,10174,8355,Texas,Large City,NA,100.0,100.0,100.0,129,56,299,67,26,166,196,82,465,195.64667409286028,0.4994058686768784
Texas A&M University - Kingsville,6782,5020,Texas,Town,NA,100.0,100.0,100.0,87,38,201,45,18,111,132,56,312,131.21927851913273,0.3898874891886366
Texas A&M University - TexarkaNA,1611,1166,Texas,Rural,NA,100.0,100.0,100.0,17,7,39,9,3,22,26,10,61,25.22771237054361,0.5849095803761017
Texas Christian University,9009,8738,Texas,Large City,NA,100.0,100.0,100.0,85,37,195,44,17,107,129,54,302,114.6092432635463,14.195972412562826
Texas College,993,940,Texas,Midsize City,NA,100.0,99.89,100.0,11,5,24,5,2,13,16,7,37,14.128300576222331,1.7764553496042421
Texas Lutheran University,1359,1305,Texas,Town,private,100.0,100.0,100.0,17,7,40,9,4,22,26,11,62,26.087525960244555,0.17617145131796785
Texas Southern University,7971,6695,Texas,Large City,NA,100.0,100.0,100.0,89,39,205,46,18,113,135,57,318,126.1581030706658,8.549600006023
Texas State University,34177,28019,Texas,Suburb,NA,100.0,100.0,100.0,436,188,1008,226,88,559,662,276,1567,659.9264713134223,1.4481799267605877
Texas Tech University,30737,27318,Texas,Large City,public,100.0,100.0,100.0,380,164,880,197,77,488,577,241,1368,569.2943024717638,7.230641942067764
Texas Wesleyan University,1675,1497,Texas,Large City,NA,100.0,100.0,100.0,21,9,49,11,4,27,32,13,76,31.637231857405194,0.34762585040410054
Texas Woman's University,10311,6968,Texas,Midsize City,NA,100.0,100.0,100.0,131,57,303,68,27,168,199,84,471,198.5387743491271,0.465462330774916
The College of Idaho,938,896,Idaho,Suburb,NA,97.7,72.8,100.0,2,1,7,1,0,4,3,1,11,2.907817126171673,0.8535839073520426
The College of New Jersey,6956,6728,New Jersey,Suburb,NA,100.0,100.0,100.0,32,17,63,14,8,30,46,25,93,45.13277750861645,1.0852804977919115
The College of Saint Rose,2504,2426,New York,Small City,NA,99.93,98.74,100.0,5,3,8,2,1,4,7,4,12,6.661927976901513,0.5770298321328617
The College of Saint Scholastica,2678,2179,Minnesota,Small City,NA,86.85,63.09,98.9,1,1,3,1,0,2,2,1,5,1.206925691022984,0.8189832396082217
The College of Wooster,1979,1962,Ohio,Town,NA,99.86,96.26,100.0,4,2,9,2,1,5,6,3,14,1.6893697525180844,4.8650288001107445
The Evergreen State College,3615,3330,Washington,Suburb,NA,100.0,99.98,100.0,10,6,18,5,3,10,15,9,28,7.5998032200232934,6.912078275523958
The King's College,555,542,New York,Large City,NA,97.52,82.71,99.97,2,1,5,1,1,3,3,2,8,0.1827172235719614,3.492476450978881
The Master's College and SemiNAry,1353,975,California,Suburb,NA,99.98,98.67,100.0,6,3,12,3,1,6,9,4,18,6.62318899674751,1.9340715887114985
The New School,7124,6224,New York,Large City,private,100.0,100.0,100.0,25,13,51,12,6,25,37,19,76,4.884060388812428,32.16792957560568
Stockton University,8276,7809,New Jersey,Suburb,NA,100.0,100.0,100.0,39,21,76,18,9,37,57,30,113,55.6474837116752,0.5554159703669242
The University of Alabama,33303,29923,Alabama,Midsize City,NA,100.0,100.0,100.0,133,61,281,63,27,142,196,88,423,98.7342890505636,97.08850309396786
The University of Findlay,3563,2499,Ohio,Town,private,99.99,99.12,100.0,6,3,12,3,1,6,9,4,18,6.572886741124995,2.441245408663064
The University of MontaNA,9322,7444,MontaNA,Small City,NA,100.0,99.55,100.0,31,4,280,25,2,260,56,6,540,45.86827545374562,10.400117972509161
The University of MontaNA - Western,1540,1230,MontaNA,Town,public,99.99,57.75,100.0,5,1,47,4,0,43,9,1,90,7.572724091467419,1.92721670924333
The University of Tampa,7970,7728,Florida,Large City,NA,100.0,100.0,100.0,36,19,72,17,9,36,53,28,108,35.079620115526794,18.68555012690605
The University of Tennessee - Knoxville,22315,20965,Tennessee,Midsize City,NA,100.0,100.0,100.0,55,22,135,25,9,62,80,31,197,68.62033565124256,11.209446647136552
The University of Tennessee - Chattanooga,10172,8962,Tennessee,Midsize City,NA,100.0,100.0,100.0,25,9,61,11,4,28,36,13,89,33.73701607740894,1.5525730835362135
The University of Tennessee - Martin,6327,4950,Tennessee,Town,NA,100.0,99.97,100.0,15,6,38,7,2,17,22,8,55,21.02814827123953,0.9492521061466037
The University of Texas at Arlington,33305,17819,Texas,Large City,public,100.0,100.0,100.0,423,183,978,219,86,543,642,269,1521,638.7828734939583,3.2520092449039746
The University of Texas at Austin,40489,37740,Texas,Large City,NA,100.0,100.0,100.0,490,212,1131,253,100,626,743,312,1757,727.7931212459537,15.177341813073609
The University of Texas at Dallas,18474,15294,Texas,Midsize City,NA,100.0,100.0,100.0,231,100,534,120,47,297,351,147,831,346.93478344433095,3.585187981075943
The University of Texas at El Paso,21335,14025,Texas,Large City,NA,100.0,100.0,100.0,271,117,627,140,55,348,411,172,975,409.25172747970163,2.1779342899704797
The University of Texas at San Antonio,26437,21510,Texas,Large City,NA,100.0,100.0,100.0,336,146,778,174,68,432,510,214,1210,508.6774443978472,1.7573850599783734
The University of Texas at Tyler,7440,4842,Texas,Midsize City,NA,100.0,100.0,100.0,94,41,218,49,19,121,143,60,339,142.084195698081,0.6198217511633776
The University of Texas of the Permian Basin,6066,2192,Texas,Midsize City,public,100.0,100.0,100.0,77,33,177,40,16,98,117,49,275,115.72309268656798,0.48939329791495007
The University of Texas Rio Grande Valley,24216,18647,Texas,Small City,public,100.0,100.0,100.0,310,134,718,161,63,398,471,197,1116,469.8295031177227,1.0887921391652589
The University of Virginia's College at Wise,2093,1210,Virginia,Town,NA,100.0,99.07,100.0,7,3,13,4,2,7,11,5,20,10.601547586438722,0.3262818513582568
The University of West Florida,10000,6906,Florida,Small City,public,100.0,100.0,100.0,87,46,175,42,21,88,129,67,263,125.65773119380204,3.661089595776642
Thiel College,764,751,Pennsylvania,Town,NA,85.67,65.02,97.73,1,1,3,1,0,1,2,1,4,0.9465849592917509,0.9922576583126032
Thomas AquiNAs College,364,369,California,Rural,private,86.18,60.67,99.38,1,1,3,1,0,2,2,1,5,1.1563136591006702,0.8153587641937545
Thomas College,1660,774,Maine,Rural,NA,92.55,71.21,99.37,2,1,3,1,0,2,3,1,5,0.947114852014213,1.6443724245804154
Thomas More College,1878,1356,Kentucky,Suburb,NA,99.23,89.88,100.0,3,2,7,2,1,4,5,3,11,2.6487845633669496,2.2144918734778907
Thomas More College of Liberal Arts,90,90,New Hampshire,Suburb,private,22.27,10.41,43.51,0,0,0,0,0,0,0,0,0,0.0,0.2513804791295549
Thomas University,1118,438,Georgia,Town,NA,99.91,95.41,100.0,5,2,11,2,1,6,7,3,17,2.3103579109394055,4.709952875425794
Tiffin University,2243,1772,Ohio,Town,private,100.0,99.4,100.0,7,4,15,3,2,8,10,6,23,2.0024756264287666,8.761388910709965
Toccoa Falls College,1420,872,Georgia,Town,NA,99.75,91.18,100.0,4,2,10,2,1,5,6,3,15,2.5407951637144497,3.4405828139751566
Tougaloo College,794,766,Mississippi,Midsize City,private,100.0,99.31,100.0,7,3,13,3,2,6,10,5,19,9.230385269390155,0.6504309423897096
Touro College,6428,4232,New York,Large City,NA,100.0,100.0,100.0,15,9,28,7,4,14,22,13,42,16.804184021840385,5.349176727936702
Towson University,19592,17106,Maryland,Small City,NA,100.0,100.0,100.0,44,24,81,20,11,39,64,35,120,38.67730994468903,24.91590002201648
Transylvania University,962,963,Kentucky,Large City,private,92.98,69.0,99.82,2,1,4,1,0,2,3,1,6,2.0227560369703914,0.629531887057953
Trevecca Nazarene University,2216,1317,Tennessee,Large City,NA,100.0,98.72,100.0,7,3,15,3,1,7,10,4,22,4.6229664960600045,5.377570596782499
Trident University InterNAtioNAl,4368,1862,California,Suburb,private,100.0,99.99,100.0,15,7,32,7,3,17,22,10,49,1.0831292502968304,20.613154276701106
Trine University,4099,1938,IndiaNA,Town,NA,100.0,99.88,100.0,9,5,17,4,2,8,13,7,25,6.826102722689958,5.7265191888253835
Trine University - RegioNAl/Non - TraditioNAl Campuses,368,210,IndiaNA,Large City,NA,57.72,36.66,80.21,1,0,1,0,0,1,1,0,2,0.0,0.8598728477547096
Trinity Christian College,1109,907,Illinois,Suburb,private,90.5,69.6,99.36,2,1,3,1,0,2,3,1,5,1.10914417978381,1.2407414974489248
Trinity College,2218,2117,Connecticut,Midsize City,NA,99.96,98.48,100.0,5,3,10,2,1,5,7,4,15,0.16599050941015797,7.544460409703029
Trinity InterNAtioNAl University - Florida,156,64,Florida,Suburb,NA,88.21,66.8,98.74,1,1,3,1,0,1,2,1,4,2.1235625681110517,0.0
Trinity InterNAtioNAl University - Illinois,936,592,Illinois,Suburb,NA,92.61,73.41,99.57,2,1,4,1,0,2,3,1,6,0.7002647575753715,1.8950725482930242
Trinity University,2389,2353,Texas,Large City,NA,100.0,100.0,100.0,23,10,54,12,5,30,35,15,84,32.399339357367396,3.094978956587754
Trinity Washington University,1530,1075,District of Columbia,Large City,NA,98.86,92.19,99.95,3,2,5,1,1,2,4,3,7,2.5543440189767495,1.9162292617643397
Troy University,14006,9491,Alabama,Town,public,100.0,100.0,100.0,52,23,109,24,10,55,76,33,164,50.38013605030858,25.378174022508215
Truett McConnell University,2574,780,Georgia,Town,NA,99.96,88.75,100.0,5,2,16,2,1,8,7,3,24,7.400926313151748,0.2965065617389338
Truman State University,5895,5134,Missouri,Town,NA,100.0,98.53,100.0,7,3,18,3,1,9,10,4,27,8.320506583856764,2.4212090883918047
Tufts University,5543,5483,Massachusetts,Suburb,NA,100.0,100.0,100.0,16,9,32,8,4,16,24,13,48,5.060439354976343,18.565774229476656
Tulane University of LouisiaNA,7872,6716,LouisiaNA,Large City,private,100.0,100.0,100.0,31,15,66,15,7,34,46,22,100,7.577938557745119,38.397439193660446
Tusculum College,1485,1376,Tennessee,Town,NA,99.9,94.33,100.0,5,2,11,2,1,5,7,3,16,3.3393811437760834,3.518427946548795
Tuskegee University,2830,2722,Alabama,Town,NA,100.0,99.86,100.0,10,5,21,5,2,11,15,7,32,4.005332219159573,10.37935740171079
Union College Kentucky,1096,918,Kentucky,Town,private,96.24,75.72,99.96,2,1,5,1,0,3,3,1,8,2.2252946778633955,1.0483470709751475
Union College Nebraska,779,707,Nebraska,Large City,private,94.64,72.54,99.89,2,1,4,1,0,2,3,1,6,0.011862945873478007,2.898845334892254
Union College New York,2265,2176,New York,Small City,NA,99.94,98.46,100.0,5,3,9,2,1,4,7,4,13,2.676952338998736,4.734820914841078
Union Institute & University,814,434,Ohio,Large City,NA,99.88,96.86,100.0,5,2,9,2,1,4,7,3,13,0.6005090268286967,6.09126219973599
Union University,2179,1599,Tennessee,Small City,NA,99.98,96.74,100.0,6,2,14,3,1,6,9,3,20,5.124045269946241,3.253374591744007
United States Air Force Academy,4279,4276,Colorado,Town,NA,100.0,100.0,100.0,18,8,40,9,4,21,27,12,61,0.3304358189029868,26.39373237299339
United States Coast Guard Academy,1047,1044,Connecticut,Small City,NA,99.76,94.38,100.0,4,2,8,2,1,4,6,3,12,0.016645287851715006,5.998973698224722
United States Merchant Marine Academy,952,954,New York,Suburb,public,99.58,92.29,100.0,4,2,8,2,1,4,6,3,12,0.43794128189470116,4.99615285302024
United States Military Academy,4487,4491,New York,Town,public,100.0,100.0,100.0,18,9,38,9,4,20,27,13,58,0.913586117859807,25.552047735505653
United States Naval Academy,4495,4495,Maryland,Suburb,NA,100.0,100.0,100.0,17,8,36,8,4,19,25,12,55,1.1022316883638936,24.22631556882847
Unity College,706,694,Maine,Rural,private,86.06,62.74,98.26,1,1,3,1,0,1,2,1,4,0.1919827402731513,1.7717579059737547
Polytechnic University of Puerto Rico - Orlando,124,53,Florida,Suburb,NA,81.72,58.37,96.91,1,1,2,1,0,1,2,1,3,1.6879599900369897,0.0
University at Buffalo,21016,19401,New York,Suburb,NA,100.0,100.0,100.0,44,27,74,20,12,36,64,39,110,57.239795625654445,6.8406640109430095
University of Advancing Technology,775,508,ArizoNA,Midsize City,NA,99.04,88.44,100.0,3,1,7,2,1,4,5,2,11,0.7108194085709232,3.9085504143244276
University of Akron Main Campus,16874,13563,Ohio,Midsize City,public,100.0,100.0,100.0,27,15,51,12,6,24,39,21,75,38.16153084111391,1.5813197969417707
University of Alabama at Birmingham,13130,9677,Alabama,Midsize City,NA,100.0,100.0,100.0,47,22,96,22,10,47,69,32,143,61.53599668142185,7.443988340938534
University of Alabama in Huntsville,7089,5903,Alabama,Midsize City,NA,100.0,100.0,100.0,24,11,50,11,5,25,35,16,75,30.493376597353283,4.859509963956366
University of Alaska Anchorage,14954,6974,Alaska,Large City,NA,96.73,79.38,99.98,2,1,6,1,0,3,3,1,9,0.22296824761068082,3.18285299700554
University of Alaska Fairbanks,6633,3022,Alaska,Suburb,public,93.93,73.55,99.8,2,1,4,1,0,2,3,1,6,0.09501470118308397,2.6938887166065606
University of Alaska Southeast,2060,629,Alaska,Town,NA,68.03,43.79,90.83,1,0,2,0,0,1,1,0,3,0.028934453935222523,1.106358938692268
University of ArizoNA,34099,29325,ArizoNA,Large City,NA,100.0,100.0,100.0,156,85,300,69,37,138,225,122,438,155.57885584652803,69.66193594840419
University of Arkansas,23037,20464,Arkansas,Small City,NA,100.0,100.0,100.0,83,36,192,41,16,102,124,52,294,25.193577578857077,99.73814115719912
University of Arkansas at Little Rock,8794,4603,Arkansas,Midsize City,NA,100.0,99.92,100.0,12,5,27,5,2,13,17,7,40,15.215042545152743,2.348168067365695
University of Arkansas at Pine Bluff,2517,2341,Arkansas,Small City,public,99.98,97.71,100.0,6,3,13,3,1,7,9,4,20,2.475957355956584,6.24840990648149
University of Baltimore,2950,1716,Maryland,Large City,NA,99.97,98.75,100.0,6,3,10,3,1,5,9,4,15,7.660510234129061,0.4076490635333826
University of Bridgeport,3124,2300,Connecticut,Midsize City,private,99.97,99.09,100.0,6,3,10,3,1,5,9,4,15,0.48132624037875893,7.6441421433773264
University of California - Berkeley,30577,29351,California,Midsize City,public,100.0,100.0,100.0,149,77,304,69,34,147,218,111,451,187.8058298724139,30.438283399419248
University of California - Davis,30067,29284,California,Suburb,NA,100.0,100.0,100.0,150,79,302,69,35,144,219,114,446,216.7429451134522,2.307594405932604
University of California - Irvine,29310,28855,California,Large City,public,100.0,100.0,100.0,147,77,295,67,34,140,214,111,435,212.1250089179299,1.8194865471718105
University of California - Los Angeles,31001,30458,California,Large City,NA,100.0,100.0,100.0,153,80,309,70,35,148,223,115,457,210.74182359153733,12.991768388111131
University of California - Riverside,20077,19719,California,Large City,public,100.0,100.0,100.0,101,53,202,46,23,96,147,76,298,146.50786798440706,0.33054727256603417
University of California - San Diego,28582,27880,California,Large City,NA,100.0,100.0,100.0,143,75,288,65,33,137,208,108,425,202.36952722437806,5.881929526978372
University of California - Santa Barbara,22182,21777,California,Suburb,NA,100.0,100.0,100.0,110,58,222,50,25,106,160,83,328,156.4536291408489,4.123845977778428
University of California - Santa Cruz,17573,17082,California,Small City,NA,100.0,100.0,100.0,88,46,177,40,20,84,128,66,261,127.18718406019335,1.1740942405630221
University of Central Arkansas,9549,8070,Arkansas,Small City,NA,100.0,100.0,100.0,18,7,40,8,3,20,26,10,60,15.625923399481744,10.055766763340024
University of Central Florida,56854,39962,Florida,Suburb,NA,100.0,100.0,100.0,500,263,1009,244,122,504,744,385,1513,728.8584011818592,14.901714652959964
University of Central Missouri,9800,7701,Missouri,Town,NA,100.0,99.85,100.0,12,5,29,5,2,14,17,7,43,15.744958612528952,1.2973784731236015
University of Central Oklahoma,14340,10448,Oklahoma,Suburb,public,100.0,100.0,100.0,29,12,69,15,6,37,44,18,106,39.31185062533911,4.234754884630615
University of Charleston,1833,1220,West Virginia,Small City,NA,98.12,85.66,99.97,3,1,5,1,1,3,4,2,8,0.2224804285834366,3.735997332650431
University of Chicago,6305,6288,Illinois,Large City,private,100.0,100.0,100.0,19,10,40,9,4,20,28,14,60,1.9269030242006866,26.481200111915584
University of CincinNAti - Main Campus,26558,22622,Ohio,Large City,NA,100.0,100.0,100.0,46,25,88,21,11,43,67,36,131,55.22112774724742,12.602005985727446
University of Colorado at Colorado Springs,10804,8171,Colorado,Large City,public,100.0,99.8,100.0,11,4,28,5,2,14,16,6,42,9.516943793093144,6.048607762771503
University of Colorado Boulder,29057,26977,Colorado,Midsize City,NA,100.0,100.0,100.0,59,28,134,28,12,67,87,40,201,16.780648678651975,70.51626567602055
University of Colorado Denver/Anschutz Medical Campus,15589,8671,Colorado,Large City,NA,100.0,99.98,100.0,15,6,39,7,3,19,22,9,58,14.177363517858415,7.470452571555448
University of Connecticut,19243,18555,Connecticut,Suburb,NA,100.0,100.0,100.0,21,12,38,9,5,18,30,17,56,5.977507815193656,23.953458763926335
University of Dallas,1456,1421,Texas,Midsize City,private,100.0,99.89,100.0,11,5,25,5,2,14,16,7,39,12.545461922454685,3.4554526428261485
University of Dayton,8498,8079,Ohio,Midsize City,NA,100.0,100.0,100.0,15,8,29,7,3,14,22,11,43,10.832528592909874,10.683173759917908
University of Delaware,19752,18195,Delaware,Suburb,NA,100.0,100.0,100.0,34,19,64,16,8,31,50,27,95,5.2841286164686085,44.11265023278875
University of Denver,5768,5494,Colorado,Large City,NA,100.0,99.97,100.0,12,6,29,6,2,16,18,8,45,2.623876116867634,15.474045185403282
University of Detroit Mercy,2839,2338,Michigan,Large City,private,99.99,98.76,100.0,6,3,14,3,1,7,9,4,21,8.747998593981515,0.5950100220186636
University of Dubuque,1953,1709,Iowa,Small City,NA,99.58,90.91,100.0,4,2,9,2,1,4,6,3,13,1.9230282433218568,3.523063640982578
University of Evansville,2346,2024,IndiaNA,Midsize City,NA,99.98,98.49,100.0,6,3,12,3,1,6,9,4,18,3.680209421023301,4.648027277338798
University of Florida,35251,31384,Florida,Midsize City,NA,100.0,100.0,100.0,314,165,632,153,76,316,467,241,948,459.39736890135754,7.004124002670847
University of Georgia,28844,27142,Georgia,Midsize City,NA,100.0,100.0,100.0,69,23,195,32,10,99,101,33,294,76.31064296767345,25.036728790741503
University of Providence,930,469,MontaNA,Small City,private,99.62,52.93,100.0,3,1,26,2,0,23,5,1,49,4.040643949449037,1.5187649293586363
University of Hartford,5073,4460,Connecticut,Midsize City,NA,100.0,99.95,100.0,9,5,17,4,2,8,13,7,25,0.8160814738410274,12.61829177373785
University of Hawaii at Hilo,2972,2340,Hawaii,Town,public,95.33,76.26,99.97,2,1,5,1,0,3,3,1,8,0.005221370248512628,3.0465006629059737
University of Hawaii at Manoa,12877,10702,Hawaii,Large City,NA,100.0,100.0,100.0,14,7,30,7,3,15,21,10,45,0.020321546469115857,20.80232916181477
University of Hawaii - West Oahu,3083,1611,Hawaii,Suburb,NA,14.08,8.66,24.11,0,0,0,0,0,0,0,0,0,0.006689811521283651,0.1448586309617531
University of Houston,37217,27159,Texas,Large City,public,100.0,100.0,100.0,470,203,1087,243,95,603,713,298,1690,709.4243763750699,3.9660038573938645
University of Houston - Downtown,12402,6320,Texas,Large City,public,100.0,100.0,100.0,158,68,366,82,32,203,240,100,569,239.3212962060787,0.8085733086115692
University of Houston - Victoria,3273,1722,Texas,Small City,public,100.0,100.0,100.0,42,18,97,22,9,54,64,27,151,63.95840634298159,0.0
University of Idaho,9889,7166,Idaho,Town,NA,100.0,100.0,100.0,24,10,63,13,5,39,37,15,102,23.779154265292213,13.724814326108481
University of Illinois at Chicago,19446,17961,Illinois,Large City,public,100.0,100.0,100.0,22,12,44,10,5,20,32,17,64,29.954725793285633,1.4968764155765424
University of Illinois at Springfield,2932,1903,Illinois,Midsize City,public,99.18,92.52,99.99,3,2,7,1,1,3,4,3,10,4.4992402321173754,0.2957988188011548
University of Illinois at UrbaNA - Champaign,33955,32613,Illinois,Small City,NA,100.0,100.0,100.0,43,23,86,19,10,40,62,33,126,48.852474720873346,13.20127852048718
University of IndiaNApolis,4486,3828,IndiaNA,Large City,NA,100.0,99.93,100.0,9,5,16,4,2,8,13,7,24,11.614946658742019,1.1142572318700474
University of Iowa,24506,21222,Iowa,Small City,public,100.0,100.0,100.0,41,17,101,19,7,51,60,24,152,36.81225494358983,22.97215560113996
University of Kansas,19344,17151,Kansas,Small City,public,100.0,100.0,100.0,23,11,48,11,5,25,34,16,73,9.945447896031824,24.74622020080404
University of Kentucky,22420,20657,Kentucky,Large City,NA,100.0,100.0,100.0,43,19,100,20,9,49,63,28,149,45.17400803501886,17.97356460796305
University of La Verne,5169,3759,California,Suburb,NA,100.0,100.0,100.0,25,13,51,12,6,24,37,19,75,35.926226281805,1.0715175287997278
University of LouisiaNA at Lafayette,15665,12767,LouisiaNA,Midsize City,NA,100.0,100.0,100.0,79,36,174,36,16,84,115,52,258,108.24810252703584,6.693010444254205
University of LouisiaNA at Monroe,7946,5212,LouisiaNA,Small City,NA,100.0,100.0,100.0,41,19,90,19,8,43,60,27,133,53.0384276435582,6.4068446380804
University of Louisville,15543,12025,Kentucky,Large City,NA,100.0,100.0,100.0,29,13,69,14,6,34,43,19,103,34.23429105483699,9.05349133419609
University of Maine,9277,8204,Maine,Suburb,NA,100.0,99.37,100.0,7,4,14,4,2,7,11,6,21,6.044256606266379,4.962456586540007
University of Maine at Augusta,4013,1317,Maine,Town,public,96.07,73.68,99.83,2,1,4,1,0,2,3,1,6,3.193312913210083,0.04304642828143114
University of Maine at Farmington,1810,1673,Maine,Town,public,86.88,58.82,98.29,1,1,3,1,0,1,2,1,4,1.2182904726500392,0.8095366450982842
University of Maine at Fort Kent,1762,582,Maine,Rural,NA,80.82,51.37,96.12,1,1,2,1,0,1,2,1,3,1.3326801887294584,0.31730311761098573
University of Maine at Machias,698,367,Maine,Rural,public,64.84,39.42,87.13,1,0,1,0,0,1,1,0,2,0.42796152519223307,0.614547947380735
University of Maine at Presque Isle,1413,716,Maine,Rural,NA,71.69,41.47,91.73,1,0,2,0,0,1,1,0,3,1.067903992769404,0.19325726340833632
University of Mary,2234,1794,North Dakota,Rural,NA,100.0,99.58,100.0,10,4,30,6,2,21,16,6,51,12.13535104117119,3.5978518852878167
University of Mary Hardin - Baylor,3329,3045,Texas,Suburb,NA,100.0,100.0,100.0,42,18,98,22,9,54,64,27,152,63.743452945556356,0.383047601207875
University of Mary Washington,4399,3905,Virginia,Suburb,NA,100.0,99.99,100.0,14,6,27,7,3,14,21,9,41,18.93807610396472,2.8462033141818552
University of Maryland - Baltimore County,11238,9543,Maryland,Suburb,public,100.0,100.0,100.0,22,12,41,10,5,20,32,17,61,28.564334203950306,3.600762102203317
University of Maryland - College Park,29870,27708,Maryland,Suburb,public,100.0,100.0,100.0,68,37,129,32,16,63,100,53,192,55.326519597425644,44.31154165852901
University of Maryland Eastern Shore,2860,2573,Maryland,Town,public,99.98,98.99,100.0,6,3,11,3,1,5,9,4,16,5.996140384699582,2.527997752828078
University of Maryland - University College,45609,9714,Maryland,Suburb,NA,100.0,100.0,100.0,110,57,215,52,25,109,162,82,324,84.51912586374337,77.32646860426635
University of Massachusetts Amherst,23386,21577,Massachusetts,Suburb,NA,100.0,100.0,100.0,64,36,118,30,16,57,94,52,175,73.42523299189436,20.452239187718504
University of Massachusetts - Boston,12658,9574,Massachusetts,Large City,NA,100.0,100.0,100.0,36,21,67,17,9,33,53,30,100,50.18800139461005,3.1838113382874047
University of Massachusetts - Dartmouth,6764,5790,Massachusetts,Suburb,NA,100.0,100.0,100.0,19,11,35,9,5,17,28,16,52,27.532869034631993,0.5136934461320413
University of Massachusetts - Lowell,14015,10495,Massachusetts,Suburb,NA,100.0,100.0,100.0,38,22,71,18,10,34,56,32,105,53.35343155368425,2.9208946350918366
University of Memphis,17392,12400,Tennessee,Large City,NA,100.0,100.0,100.0,47,19,111,21,8,51,68,27,162,54.4150956162074,12.776640195686841
University of Miami,10834,10216,Florida,Suburb,NA,100.0,100.0,100.0,58,31,118,28,14,59,86,45,177,60.68488415794275,26.02251874872725
University of Michigan - Ann Arbor,29819,28702,Michigan,Midsize City,NA,100.0,100.0,100.0,75,37,159,36,17,81,111,54,240,62.471657250388795,48.346553709317995
University of Michigan - Dearborn,7132,5137,Michigan,Small City,NA,100.0,100.0,100.0,16,8,35,8,3,18,24,11,53,23.297405022862726,0.0747791824954358
University of Michigan - Flint,6432,3809,Michigan,Small City,public,100.0,99.99,100.0,14,7,31,7,3,16,21,10,47,20.816237943190934,0.3230918694001985
University of Minnesota - Crookston,2832,1195,Minnesota,Town,public,99.28,89.16,100.0,3,2,7,2,1,4,5,3,11,1.1379429895108693,3.7742419607754236
University of Minnesota - Duluth,10124,8906,Minnesota,Small City,NA,99.81,95.72,100.0,4,2,9,2,1,4,6,3,13,4.918955471604025,1.3394918566817131
University of Minnesota - Morris,1627,1526,Minnesota,Town,NA,76.43,51.13,94.87,1,1,2,0,0,1,1,1,3,0.7827092352673807,0.6589595347985894
University of Minnesota - Twin Cities,35429,29991,Minnesota,Large City,NA,100.0,100.0,100.0,22,11,46,10,5,23,32,16,69,13.169177938277338,19.54884843828673
University of Mississippi,18734,17511,Mississippi,Town,NA,100.0,100.0,100.0,137,67,276,66,31,139,203,98,415,141.63513396697562,61.81094271881451
University of Missouri - Columbia,23800,22197,Missouri,Midsize City,NA,100.0,100.0,100.0,38,16,91,18,7,44,56,23,135,29.559421310799245,26.299837301703782
University of Missouri - Kansas City,11369,6760,Missouri,Large City,public,100.0,99.98,100.0,15,6,36,7,3,17,22,9,53,15.691333726021767,5.717681375122766
University of Missouri - St Louis,13791,5492,Missouri,Suburb,public,100.0,100.0,100.0,18,7,44,8,3,21,26,10,65,22.112481426495012,3.6123361292603233
University of Mobile,1442,1152,Alabama,Rural,NA,99.99,98.76,100.0,6,3,13,3,1,6,9,4,19,5.419893274567805,4.010483775754372
University of Montevallo,2352,2101,Alabama,Suburb,NA,100.0,99.71,100.0,9,4,18,4,2,9,13,6,27,11.326851527920862,1.4697848959873328
University of Mount Union,2093,2046,Ohio,Town,NA,99.62,94.79,100.0,4,2,7,2,1,3,6,3,10,4.091405859832871,1.481340721277855
University of Nebraska at Kearney,4846,4063,Nebraska,Town,NA,89.26,64.71,99.48,2,1,3,1,0,2,3,1,5,0.7316597180276083,1.4909935932295035
University of Nebraska at Omaha,12620,9820,Nebraska,Large City,NA,98.8,86.7,100.0,3,1,7,1,1,3,4,2,10,1.9590569065708399,2.460863003137275
University of Nebraska - Lincoln,20955,19534,Nebraska,Large City,public,100.0,99.98,100.0,12,6,27,6,3,14,18,9,41,2.8713341526157685,15.508226846088299
University of Nevada - Las Vegas,25281,18958,Nevada,Midsize City,NA,100.0,100.0,100.0,296,106,828,155,50,456,451,156,1284,435.80742138180455,14.771959752197771
University of Nevada - Reno,18354,15572,Nevada,Midsize City,NA,100.0,100.0,100.0,202,74,559,105,35,306,307,109,865,283.8264541882304,23.707340550204968
University of New England,4427,2361,Maine,Suburb,NA,99.98,98.72,100.0,6,3,11,3,1,6,9,4,17,1.3262807640536867,7.434039219980938
University of New Hampshire at Manchester,737,575,New Hampshire,Midsize City,NA,46.17,1.23,75.77,0,0,1,0,0,0,0,0,1,0.598736627293201,0.020301913730217933
University of New Hampshire - Main Campus,13010,12677,New Hampshire,Suburb,NA,100.0,100.0,100.0,17,7,33,8,3,16,25,10,49,5.891404375132963,18.841431644730708
University of New Haven,5214,4831,Connecticut,Suburb,NA,100.0,99.98,100.0,10,6,20,5,3,10,15,9,30,0.8877486854248003,14.322392650039491
University of New Mexico - Main Campus,20359,15093,New Mexico,Large City,public,100.0,100.0,100.0,77,26,207,35,11,104,112,37,311,92.08663476478593,20.27877912620738
University of New Orleans,6468,4737,LouisiaNA,Large City,NA,100.0,100.0,100.0,32,15,70,14,6,33,46,21,103,44.13202860349396,1.918738078276852
University of North Alabama,6061,5141,Alabama,Small City,public,100.0,100.0,100.0,22,10,45,10,4,22,32,14,67,27.944057772221964,4.386206162498163
University of North CaroliNA at Asheville,3820,3285,North CaroliNA,Small City,NA,99.93,96.78,100.0,5,2,11,2,1,5,7,3,16,4.323247298088888,2.9542043901756454
University of North CaroliNA at Chapel Hill,18863,18303,North CaroliNA,Small City,public,100.0,100.0,100.0,28,14,61,13,6,29,41,20,90,20.9267704304948,20.234724242767385
University of North CaroliNA at Charlotte,23915,20597,North CaroliNA,Large City,public,100.0,100.0,100.0,27,13,59,12,6,28,39,19,87,29.064884410484026,10.499472395068494
University of North CaroliNA at Greensboro,16441,14136,North CaroliNA,Large City,NA,100.0,100.0,100.0,19,9,41,8,4,19,27,13,60,20.349979757774282,6.929118871466633
University of North CaroliNA at Pembroke,5478,4483,North CaroliNA,Town,NA,99.98,98.02,100.0,6,3,13,3,1,6,9,4,19,7.0355048335328005,1.3401132232831068
University of North CaroliNA at Wilmington,14499,12346,North CaroliNA,Midsize City,NA,100.0,100.0,100.0,18,9,39,8,4,19,26,13,58,16.070997790382552,10.737193780146026
University of North Dakota,10999,8525,North Dakota,Small City,public,100.0,100.0,100.0,27,11,68,15,5,43,42,16,111,33.23924202915534,9.011706282719048
University of North Florida,14251,10223,Florida,Large City,NA,100.0,100.0,100.0,128,67,258,62,31,129,190,98,387,189.35099565656878,1.3426047582654905
University of North Texas,31444,25592,Texas,Midsize City,NA,100.0,100.0,100.0,394,171,912,204,80,506,598,251,1418,594.5415560602551,3.8843665075681932
University of Northern Colorado,10103,8328,Colorado,Midsize City,NA,100.0,99.46,100.0,9,4,25,4,2,12,13,6,37,8.989423108909742,4.269609409982319
University of Northern Iowa,9959,9100,Iowa,Small City,NA,100.0,99.99,100.0,20,7,54,9,3,28,29,10,82,28.060087581514733,0.8867408071938792
University of Notre Dame,8577,8557,IndiaNA,Suburb,private,100.0,100.0,100.0,26,13,55,13,6,28,39,19,83,1.6115202744232469,37.10085607196068
University of Oklahoma Norman Campus,22028,19065,Oklahoma,Suburb,NA,100.0,100.0,100.0,105,45,245,54,21,134,159,66,379,39.9083413834253,118.65512862867553
University of Oregon,19336,17801,Oregon,Midsize City,NA,100.0,100.0,100.0,49,27,100,24,12,51,73,39,151,15.14683854185014,57.854907827035326
University of Pennsylvania,11719,10496,Pennsylvania,Large City,NA,100.0,100.0,100.0,38,20,77,18,9,39,56,29,116,4.387772638813073,52.18357868545268
University of Phoenix - New Mexico,216,217,New Mexico,Large City,private,97.16,76.62,99.98,2,1,5,1,0,3,3,1,8,0.23957001184240778,3.288167714918344
University of Phoenix - Hawaii,661,661,Hawaii,Large City,NA,7.56,4.18,13.69,0,0,0,0,0,0,0,0,0,0.0013998845266024963,0.07715621818547255
University of Phoenix - New Jersey,111,111,New Jersey,Large City,NA,48.01,30.17,72.72,0,0,1,0,0,0,0,0,1,0.5707786885898469,0.08120765492087173
University of Phoenix - Kentucky,18,18,Kentucky,Suburb,NA,4.7,2.16,10.72,0,0,0,0,0,0,0,0,0,0.03945557939474106,0.008571916353315143
University of Phoenix - Utah,122,122,Utah,Suburb,NA,50.69,20.61,86.15,0,0,1,0,0,1,0,0,2,0.7050745438918922,0.0
University of Pittsburgh - Bradford,1337,1229,Pennsylvania,Town,NA,96.35,84.06,99.83,2,1,4,1,1,2,3,2,6,2.1535841213580884,1.1497515321077756
University of Pittsburgh - Greensburg,1524,1436,Pennsylvania,Suburb,NA,95.88,83.01,99.8,2,1,4,1,1,2,3,2,6,3.069167389843341,0.11791261437824467
University of Pittsburgh - Johnstown,2785,2713,Pennsylvania,Suburb,NA,99.73,96.29,100.0,4,2,8,2,1,4,6,3,12,5.644374506169807,0.26849313267819996
University of Pittsburgh - Pittsburgh Campus,19329,18390,Pennsylvania,Large City,public,100.0,100.0,100.0,36,20,71,17,9,34,53,29,105,27.55636956820287,25.661525631796284
University of Portland,3888,3792,Oregon,Large City,private,100.0,99.95,100.0,9,5,19,5,2,11,14,7,30,1.7466916769260818,12.287772663720446
University of Puget Sound,2415,2390,Washington,Midsize City,NA,100.0,99.49,100.0,7,4,15,3,2,8,10,6,23,1.622265687351126,8.623251919936624
University of Redlands,3133,2518,California,Small City,private,100.0,100.0,100.0,14,7,28,6,3,14,20,10,42,15.881016710433256,4.1559023271130595
University of Rhode Island,15100,12629,Rhode Island,Suburb,NA,100.0,100.0,100.0,21,12,39,9,5,18,30,17,57,6.7860657998026195,23.52853225010353
University of Richmond,3265,3035,Virginia,Midsize City,NA,100.0,99.9,100.0,9,5,18,5,2,9,14,7,27,3.3398545067069563,10.554643551596529
University of Rio Grande,1755,1269,Ohio,Rural,NA,98.33,88.5,99.96,3,2,5,1,1,3,4,3,8,3.9395261448761967,0.14549754767411602
University of Rochester,6542,6250,New York,Midsize City,private,100.0,100.0,100.0,16,9,31,8,4,15,24,13,46,8.552906227201813,14.998475746015796
University of Saint Francis - Fort Wayne,1906,1523,IndiaNA,Large City,NA,99.51,95.12,99.99,4,2,7,2,1,3,6,3,10,4.671694412556753,0.6436695897109794
University of Saint Mary,750,641,Kansas,Town,NA,95.94,74.86,99.96,2,1,5,1,0,3,3,1,8,0.2528863888093562,2.9287124628556014
University of San Diego,5776,5605,California,Large City,NA,100.0,100.0,100.0,26,13,54,12,6,27,38,19,81,24.73633017569788,13.363594206488388
University of San Francisco,6847,6586,California,Large City,NA,100.0,100.0,100.0,31,16,63,14,7,31,45,23,94,37.26550096291527,7.7349623312100375
University of Science and Arts of Oklahoma,881,727,Oklahoma,Town,public,93.78,67.23,99.89,2,1,4,1,0,2,3,1,6,2.397270914014639,0.3745757540521569
University of Scranton,3809,3630,Pennsylvania,Small City,private,100.0,99.97,100.0,10,6,19,5,3,9,15,9,28,3.0381656990368424,11.693654866962971
University of Sioux Falls,1214,1036,South Dakota,Midsize City,private,97.25,83.18,99.96,2,1,5,1,1,3,3,2,8,1.7689484429776252,1.814090620148133
University of South Alabama,10986,9090,Alabama,Midsize City,public,100.0,100.0,100.0,48,23,96,23,10,47,71,33,143,45.90328347934626,25.131228550216317
University of South CaroliNA - Aiken,3352,2716,South CaroliNA,Suburb,public,100.0,100.0,100.0,32,16,64,17,8,34,49,24,98,47.22386227241751,1.468662577221698
University of South CaroliNA - Beaufort,2078,1797,South CaroliNA,Town,NA,100.0,100.0,100.0,19,9,38,10,5,21,29,14,59,28.23131753166004,0.8886778377802075
University of South CaroliNA - Columbia,26363,25243,South CaroliNA,Midsize City,NA,100.0,100.0,100.0,183,90,364,94,45,194,277,135,558,237.47703641750735,39.17332050287808
University of South CaroliNA - Upstate,5776,4583,South CaroliNA,Suburb,public,100.0,100.0,100.0,57,28,112,30,14,60,87,42,172,84.28819568186616,1.931642422369933
University of South Dakota,7652,4908,South Dakota,Town,public,100.0,100.0,100.0,14,8,26,7,4,13,21,12,39,15.818423513010444,5.379042218882287
University of South Florida - Main Campus,31773,24672,Florida,Large City,NA,100.0,100.0,100.0,279,147,563,136,68,281,415,215,844,407.4109237243312,7.8611095077651445
University of South Florida - St. Petersburg,4251,2845,Florida,Large City,NA,100.0,100.0,100.0,38,20,76,18,9,38,56,29,114,55.280689673711414,0.6034766355334151
University of Southern California,19174,18631,California,Large City,private,100.0,100.0,100.0,86,44,178,40,19,88,126,63,266,84.11815947913357,42.31860104678611
University of Southern IndiaNA,9689,6588,IndiaNA,Suburb,NA,100.0,100.0,100.0,19,11,34,9,5,17,28,16,51,25.721463670847637,1.7650013585896613
University of Southern Maine,6110,3901,Maine,Small City,NA,99.82,93.94,100.0,4,2,8,2,1,4,6,3,12,4.119629635028038,2.207018772640882
University of Southern Mississippi,11809,10384,Mississippi,Small City,NA,100.0,100.0,100.0,104,52,201,50,24,99,154,76,300,136.58039917659528,17.064388899008737
University of St Francis,1600,1291,Illinois,Suburb,NA,96.5,82.48,99.91,2,1,5,1,1,2,3,2,7,2.2245547108658332,1.118423041272241
University of St Thomas Minnesota,6197,5945,Minnesota,Large City,NA,99.52,92.45,100.0,4,2,8,2,1,4,6,3,12,2.6153677778018305,2.7141513567911146
University of St. Thomas - Houston,1815,1434,Texas,Large City,NA,100.0,100.0,100.0,22,10,52,12,5,29,34,15,81,33.51318878038907,0.43381717182009766
University of the Cumberlands,3317,1828,Kentucky,Town,NA,100.0,98.64,100.0,7,3,16,3,1,8,10,4,24,5.24759205950056,4.829298380431747
University of the District of Columbia,3858,1830,District of Columbia,Large City,public,100.0,99.94,100.0,9,5,16,4,2,8,13,7,24,7.85929131799249,5.496317820898171
University of the IncarNAte Word,5996,4461,Texas,Large City,NA,100.0,100.0,100.0,75,33,174,39,15,96,114,48,270,112.81145121235342,1.1015768731857927
University of the Ozarks,756,747,Arkansas,Town,NA,98.67,83.29,100.0,3,1,7,1,1,3,4,2,10,0.8911312035447188,3.3950286249561965
University of the Pacific,3552,3452,California,Large City,private,100.0,100.0,100.0,17,9,35,8,4,17,25,13,52,23.528787430434523,1.6607134594870758
University of the Southwest,509,417,New Mexico,Rural,NA,97.81,78.07,99.99,3,1,6,1,0,3,4,1,9,1.4731007111160819,2.3275287211068845
University of the West,185,148,California,Suburb,NA,74.31,50.45,93.75,1,0,2,0,0,1,1,0,3,1.3539115628710379,0.0
University of Toledo,16191,13056,Ohio,Large City,public,100.0,100.0,100.0,27,15,52,13,6,25,40,21,77,33.70795027638435,6.097168225750658
University of Tulsa,3347,3203,Oklahoma,Large City,private,100.0,99.95,100.0,12,5,28,6,2,15,18,7,43,4.9387173193202525,13.1338441657671
University of Utah,24637,18066,Utah,Midsize City,NA,100.0,100.0,100.0,95,34,253,48,16,137,143,50,390,113.19336079234918,29.75142303779526
University of Vermont,11341,10395,Vermont,Small City,NA,100.0,100.0,100.0,19,10,35,9,5,17,28,15,52,0.018583219326619414,27.197614141834357
University of Virginia - Main Campus,16658,15766,Virginia,Suburb,public,100.0,100.0,100.0,57,26,110,30,12,59,87,38,169,63.32091503532168,23.857979019508463
University of Washington - Bothell Campus,5365,4641,Washington,Suburb,NA,100.0,100.0,100.0,13,9,22,7,4,12,20,13,34,19.291808173905284,0.7423899070422522
University of Washington - Seattle Campus,31328,28759,Washington,Large City,public,100.0,100.0,100.0,83,51,148,43,25,80,126,76,228,95.02677026267588,30.491739704696364
University of Washington - Tacoma Campus,4436,3945,Washington,Midsize City,NA,100.0,100.0,100.0,11,7,18,6,4,10,17,11,28,15.988816774433621,0.30504204461451806
University of West Alabama,2111,1843,Alabama,Rural,NA,100.0,99.67,100.0,8,4,17,4,2,8,12,6,25,10.078099826992716,2.2771153639022432
University of West Georgia,11230,8938,Georgia,Town,public,100.0,99.99,100.0,24,7,70,11,3,35,35,10,105,32.88968062334723,1.4094581763973844
University of Wisconsin - Eau Claire,10184,9476,Wisconsin,Small City,public,99.54,95.19,100.0,4,2,7,2,1,3,6,3,10,3.760791785867648,1.6085572839577362
University of Wisconsin - Green Bay,6812,4095,Wisconsin,Midsize City,public,98.14,89.81,99.94,3,2,5,1,1,2,4,3,7,3.231875397944873,0.7523131972318772
University of Wisconsin - La Crosse,9701,9094,Wisconsin,Small City,NA,99.64,95.78,100.0,4,2,7,2,1,4,6,3,11,4.065761653689914,1.5675810230153466
University of Wisconsin - Madison,31358,28977,Wisconsin,Large City,NA,100.0,100.0,100.0,26,14,50,12,6,24,38,20,74,9.816406339506804,27.668623650000434
University of Wisconsin - Milwaukee,20356,17076,Wisconsin,Large City,NA,100.0,99.85,100.0,8,5,14,3,2,7,11,7,21,9.683548179267401,1.511279132046468
University of Wisconsin - Oshkosh,12410,7994,Wisconsin,Small City,NA,99.86,97.9,100.0,5,3,8,2,1,4,7,4,12,6.086816091271136,0.5177173356523993
University of Wisconsin - Parkside,4135,3275,Wisconsin,Suburb,NA,92.8,77.92,99.27,2,1,3,1,0,2,3,1,5,1.878634515809438,0.7504602878067664
University of Wisconsin - Platteville,7614,6723,Wisconsin,Town,NA,99.86,96.65,100.0,5,2,9,2,1,5,7,3,14,2.9671655786800017,3.592283595662471
University of Wisconsin - River Falls,5680,5014,Wisconsin,Town,NA,95.81,82.07,99.77,2,1,4,1,1,2,3,2,6,1.3482083760657606,1.8219487865624127
University of Wisconsin - Stevens Point,7896,7224,Wisconsin,Town,NA,99.13,93.16,99.99,3,2,6,1,1,3,4,3,9,3.651083153548747,1.0910241409820736
University of Wisconsin - Stout,8129,6605,Wisconsin,Town,public,99.06,92.37,99.99,3,2,6,1,1,3,4,3,9,2.6138836525888616,2.045262689106112
University of Wisconsin - Superior,2373,1829,Wisconsin,Suburb,NA,80.6,57.33,96.4,1,1,2,1,0,1,2,1,3,0.6688200566597222,0.9689786406647911
University of Wisconsin - Whitewater,11128,9830,Wisconsin,Town,NA,99.94,98.55,100.0,5,3,10,2,1,4,7,4,14,4.88304063940503,2.570013170669143
University of Wyoming,9796,8281,Wyoming,Town,NA,100.0,98.37,100.0,7,3,19,3,1,11,10,4,30,0.022296331670678342,10.051342534658303
Upper Iowa University,4275,2107,Iowa,Rural,private,100.0,99.56,100.0,9,4,21,4,2,11,13,6,32,6.378242744930879,6.61336278045934
Ursinus College,1507,1489,Pennsylvania,Suburb,private,99.53,94.37,100.0,4,2,7,2,1,3,6,3,10,1.6699577447767133,3.6690325290007375
Ursuline College,620,455,Ohio,Suburb,private,77.1,54.0,93.86,1,1,2,0,0,1,1,1,3,1.329531658620733,0.14276927218103325
Utah State University,24621,17188,Utah,Small City,public,100.0,100.0,100.0,90,32,244,46,14,134,136,46,378,109.76623616507138,26.667362382548575
Utah Valley University,36870,18404,Utah,Small City,NA,100.0,100.0,100.0,142,50,380,72,23,204,214,73,584,190.26032015954905,23.6450154024195
Utica College,3686,2901,New York,Small City,NA,100.0,99.85,100.0,8,4,13,3,2,6,11,6,19,8.721122083823618,2.257763199465092
Valdosta State University,8774,7166,Georgia,Small City,NA,100.0,99.97,100.0,19,6,56,9,2,28,28,8,84,25.680286572242277,1.9541899061331602
Valley City State University,1373,834,North Dakota,Town,NA,99.99,96.62,100.0,6,2,14,3,1,9,9,3,23,7.749276760613025,1.2189166465520775
University of Valley Forge,700,589,Pennsylvania,Suburb,NA,91.01,70.8,99.15,2,1,3,1,0,2,3,1,5,0.5931656840976692,1.8087848152285022
Valparaiso University,3228,3153,IndiaNA,Suburb,NA,99.98,98.86,100.0,6,3,12,3,1,6,9,4,18,3.5087710939569985,5.028501365582775
Vanderbilt University,6888,6805,Tennessee,Large City,NA,100.0,100.0,100.0,24,11,52,12,5,27,36,16,79,3.2535799838640562,32.604144145245584
Vanguard University of Southern California,1842,1524,California,Midsize City,NA,100.0,99.9,100.0,9,5,20,4,2,10,13,7,30,11.043527288499439,2.79522656582335
Vassar College,2352,2334,New York,Suburb,private,100.0,99.45,100.0,7,4,13,3,2,7,10,6,20,1.7546654009688356,8.188054770593942
Villanova University,6948,6525,Pennsylvania,Suburb,NA,100.0,100.0,100.0,19,11,38,9,5,18,28,16,56,2.2486559731646834,26.265917033042594
Virginia Commonwealth University,23666,20036,Virginia,Midsize City,NA,100.0,100.0,100.0,79,35,147,42,17,80,121,52,227,113.00452775989801,8.324246834022329
Virginia Military Institute,1724,1722,Virginia,Town,public,99.98,97.99,100.0,6,3,11,3,1,6,9,4,17,5.431851285633292,3.2603999100665124
Virginia Tech,27189,26603,Virginia,Small City,public,100.0,100.0,100.0,87,40,164,45,19,87,132,59,251,99.92299401698772,31.52292757446989
Virginia State University,4299,3976,Virginia,Suburb,public,100.0,99.99,100.0,14,6,25,7,3,13,21,9,38,13.999076189807807,6.49282735014489
Virginia Union University,1298,1201,Virginia,Midsize City,NA,99.68,93.64,100.0,4,2,7,2,1,4,6,3,11,3.130130518844667,2.5874255244355333
Virginia Wesleyan University,1438,1354,Virginia,Large City,NA,99.89,95.08,100.0,4,2,8,2,1,4,6,3,12,5.468552983509192,1.3085915003310995
Viterbo University,1770,1394,Wisconsin,Small City,NA,83.03,57.3,98.08,1,1,3,1,0,1,2,1,4,0.5948422174355091,1.1736236553912973
Voorhees College,475,464,South CaroliNA,Town,private,99.54,92.53,100.0,4,2,7,2,1,4,6,3,11,4.759840711529194,0.5902986500178793
Wabash College,865,864,IndiaNA,Town,NA,95.05,79.54,99.75,2,1,4,1,0,2,3,1,6,1.6943821325052932,1.302209881608234
Wagner College,1797,1736,New York,Large City,NA,99.95,98.39,100.0,5,3,10,2,1,5,7,4,15,2.442030194406214,5.053875657950737
Wake Forest University,5099,5046,North CaroliNA,Midsize City,NA,100.0,100.0,100.0,16,8,33,8,4,17,24,12,50,1.5466038270854756,21.819293380469208
Walden University,7443,453,Minnesota,Large City,NA,100.0,100.0,100.0,42,21,87,21,10,44,63,31,131,0.029874398292648117,62.978790459180566
Waldorf University,2124,1482,Iowa,Town,private,100.0,99.85,100.0,9,4,20,5,2,10,14,6,30,1.1824832055208934,12.576943995723042
Walla Walla University,1650,1556,Washington,Suburb,NA,99.85,97.47,100.0,4,2,9,2,1,5,6,3,14,2.5941635991425667,3.9194700792200727
Walsh University,2012,1744,Ohio,Suburb,private,99.29,92.71,99.99,3,2,6,2,1,3,5,3,9,4.521342283710226,0.4258615766035723
Warner Pacific College,404,396,Oregon,Large City,NA,62.32,42.55,88.08,1,0,1,0,0,1,1,0,2,0.3685003537818738,0.6051162082439795
Warner University,1003,869,Florida,Rural,NA,100.0,99.86,100.0,9,4,17,4,2,9,13,6,26,12.441898636240392,0.29155963578404265
Warren Wilson College,589,579,North CaroliNA,Suburb,private,90.69,67.47,99.47,2,1,3,1,0,2,3,1,5,0.14218560769389454,2.2212391156312377
Wartburg College,1525,1474,Iowa,Town,NA,98.32,77.3,100.0,3,1,7,1,0,4,4,1,11,3.2100238533711116,0.868046720119362
Washburn University,5877,3944,Kansas,Midsize City,NA,99.23,92.46,99.98,3,2,6,2,1,3,5,3,9,3.9349688790923634,0.9306654587229113
Washington Adventist University,875,655,Maryland,Suburb,NA,97.36,84.74,99.93,2,1,5,1,1,2,3,2,7,1.264810862397568,2.356617520936564
Washington & Jefferson College,1411,1398,Pennsylvania,Suburb,NA,97.56,86.21,99.94,3,1,5,1,1,2,4,2,7,2.0523119313901934,1.6509235639552995
Washington and Lee University,1824,1823,Virginia,Town,private,99.99,98.93,100.0,6,3,13,3,1,7,9,4,20,1.4366093168566814,8.046431433825951
Washington College,1489,1456,Maryland,Town,NA,99.22,92.48,99.99,3,2,6,2,1,3,5,3,9,2.226508010495065,2.612285075658475
Washington State University,25279,22166,Washington,Town,NA,100.0,100.0,100.0,62,39,107,33,20,59,95,59,166,83.74398548217975,10.833284853855176
Washington University in St Louis,7673,7074,Missouri,Suburb,NA,100.0,100.0,100.0,25,12,53,12,6,27,37,18,80,1.1105541012133142,35.901721494091916
Wayland Baptist University,3563,990,Texas,Town,NA,100.0,100.0,100.0,42,18,98,22,9,54,64,27,152,62.45373256100494,1.611536075176581
Wayne State College,2756,2404,Nebraska,Town,public,78.74,48.01,97.71,1,0,2,0,0,1,1,0,3,0.4041755784217366,1.1403826184602293
Wayne State University,17300,12389,Michigan,Large City,public,100.0,100.0,100.0,38,18,85,19,8,43,57,26,128,56.00161258028032,0.8740249188767437
Waynesburg University,1374,1330,Pennsylvania,Town,private,95.21,81.28,99.72,2,1,4,1,1,2,3,2,6,2.368529177616477,0.6669387637444886
Webber InterNAtioNAl University,626,584,Florida,Town,NA,99.97,98.61,100.0,6,3,11,3,1,6,9,4,17,8.140323177759031,0.09354773068706608
Weber State University,27106,11311,Utah,Small City,NA,100.0,100.0,100.0,103,36,278,52,16,150,155,52,428,142.29791327628007,13.199034942410734
Webster University,3080,2297,Missouri,Suburb,private,99.99,98.22,100.0,6,3,15,3,1,8,9,4,23,3.5236739940366375,6.041041344480852
Wellesley College,2513,2374,Massachusetts,Suburb,private,100.0,99.62,100.0,7,4,15,4,2,8,11,6,23,1.2959143604263514,9.621219951381722
Wells College,486,481,New York,Rural,NA,80.14,59.13,95.18,1,1,2,1,0,1,2,1,3,0.9831926792205542,0.6289549781226709
Wentworth Institute of Technology,4263,3904,Massachusetts,Large City,private,100.0,99.96,100.0,10,5,18,5,2,9,15,7,27,11.862927522329093,2.5437903098404973
Wesley College,1447,1303,Delaware,Small City,private,99.33,93.36,99.99,3,2,7,2,1,3,5,3,10,0.2620839202020756,4.730165564431374
Wesleyan College,565,431,Georgia,Midsize City,NA,90.75,58.52,99.83,2,1,4,1,0,2,3,1,6,1.2718939276544654,1.1001290039441243
Wesleyan University,2975,2896,Connecticut,Small City,private,100.0,99.86,100.0,9,5,17,4,2,9,13,7,26,0.09894698889630588,12.588476524504543
West Chester University of Pennsylvania,14450,13020,Pennsylvania,Suburb,NA,100.0,100.0,100.0,27,15,52,12,7,25,39,22,77,24.941893643521507,14.197258354950437
West Liberty University,2174,1869,West Virginia,Rural,NA,86.73,64.17,97.84,1,1,3,1,0,1,2,1,4,0.34623094053106246,1.670124021686301
West Texas A&M University,7393,5615,Texas,Town,public,100.0,100.0,100.0,89,38,205,46,18,114,135,56,319,132.2549630703634,2.249569712480524
West Virginia State University,3754,1786,West Virginia,Suburb,NA,97.2,82.59,99.92,2,1,5,1,1,2,3,2,7,0.704859473333745,2.8576833018032777
West Virginia University,22507,20712,West Virginia,Small City,public,100.0,100.0,100.0,32,17,62,15,7,31,47,24,93,2.31587023633863,45.09659906255754
West Virginia University Institute of Technology,1621,1111,West Virginia,Small City,public,68.62,42.35,89.85,1,0,2,0,0,1,1,0,3,0.3302267759622438,0.8249427475233466
West Virginia Wesleyan College,1322,1289,West Virginia,Town,private,84.72,61.65,97.34,1,1,2,1,0,1,2,1,3,0.1895704563714997,1.6838389495840724
Western CaroliNA University,9408,8040,North CaroliNA,Town,NA,100.0,99.97,100.0,12,6,26,5,2,12,17,8,38,11.669950820159269,5.402824052799865
Western Connecticut State University,5082,4089,Connecticut,Small City,NA,97.47,89.96,99.83,3,2,4,1,1,2,4,3,6,2.144930287336275,1.5283528646171547
Western Governors University,72383,72385,Utah,Suburb,NA,100.0,100.0,100.0,303,139,673,149,64,352,452,203,1025,38.18961136096413,413.4002333843053
Western Illinois University,7596,6668,Illinois,Town,NA,100.0,99.87,100.0,9,5,17,4,2,8,13,7,25,11.481522166151896,0.8415810584583122
Western InterNAtioNAl University,593,597,ArizoNA,Midsize City,NA,98.35,86.04,99.99,3,1,6,1,1,3,4,2,9,1.1498549256294346,2.927467250527963
Western Kentucky University,17655,12919,Kentucky,Small City,NA,100.0,100.0,100.0,34,15,82,16,7,40,50,22,122,38.20352234194794,12.249741954160598
Western Michigan University,17938,15063,Michigan,Small City,NA,100.0,100.0,100.0,39,19,85,19,8,43,58,27,128,52.29133367118063,5.00178283142939
Western New England University,2737,2613,Massachusetts,Midsize City,private,99.95,98.59,100.0,5,3,9,2,1,5,7,4,14,4.797007583348692,2.760551897087358
Western New Mexico University,2170,1266,New Mexico,Town,public,100.0,98.81,100.0,9,3,23,4,1,11,13,4,34,9.129146621484091,3.517767429568369
Western Oregon University,4758,4065,Oregon,Town,public,99.98,99.46,100.0,6,4,10,3,2,5,9,6,15,6.187857940705225,2.111499003226611
Western Colorado University,2427,1832,Colorado,Town,NA,99.7,90.87,100.0,4,2,10,2,1,5,6,3,15,1.7070883107124628,4.07705554230121
Western Washington University,14961,13728,Washington,Small City,NA,100.0,100.0,100.0,36,23,63,19,11,36,55,34,99,49.37314466931479,5.108842236188872
Westfield State University,5585,4800,Massachusetts,Suburb,NA,100.0,100.0,100.0,15,9,28,7,4,14,22,13,42,22.18775341031609,0.3673133163796125
Westminster College Missouri,765,760,Missouri,Town,NA,87.72,58.03,99.35,1,1,3,1,0,2,2,1,5,1.0015744931503254,1.0877756741283082
Westminster College Pennsylvania,1193,1170,Pennsylvania,Town,private,93.95,77.94,99.58,2,1,4,1,0,2,3,1,6,1.7071597737445114,1.0937093660586055
Westminster College Utah,2033,1906,Utah,Midsize City,NA,100.0,98.51,100.0,7,3,19,4,1,11,11,4,30,6.657753070192293,4.606808348270091
Westmont College,1295,1294,California,Suburb,private,99.98,98.58,100.0,6,3,12,3,1,6,9,4,18,6.652462760269046,1.8853684229455554
Wheaton College Illinois,2386,2310,Illinois,Suburb,private,99.99,98.79,100.0,6,3,13,3,1,6,9,4,19,0.8193254322414302,8.228841909131328
Wheaton College Massachusetts,1686,1675,Massachusetts,Suburb,private,99.41,93.54,100.0,3,2,7,2,1,3,5,3,10,2.5833309217679403,2.531991657983567
Wheeling Jesuit University,721,670,West Virginia,Small City,NA,75.75,52.21,93.59,1,1,2,0,0,1,1,1,3,0.05116824446650467,1.3624437687378939
Boston University Wheelock College of Education and Human Development,613,593,Massachusetts,Large City,NA,86.97,67.42,97.83,1,1,3,1,0,1,2,1,4,1.5805906297659107,0.45278226852761316
Whitman College,1512,1455,Washington,Small City,NA,99.82,96.73,100.0,4,2,8,2,1,4,6,3,12,2.060715873121701,4.230191331395715
Whittier College,1684,1640,California,Suburb,NA,100.0,99.67,100.0,8,4,16,4,2,8,12,6,24,9.221235509283826,2.064263750638206
Whitworth University,2252,2211,Washington,Suburb,private,99.99,99.26,100.0,6,3,13,3,2,7,9,5,20,4.815644540380145,4.062409763923406
Wichita State University,12403,8749,Kansas,Large City,NA,100.0,99.71,100.0,8,4,14,4,2,7,12,6,21,8.338875543595913,2.8881655343917974
Widener University,3438,2919,Pennsylvania,Suburb,private,100.0,99.9,100.0,9,5,17,4,2,8,13,7,25,3.9082798210058973,8.625451368305695
Wilberforce University,613,489,Ohio,Rural,private,86.87,63.35,98.66,1,1,3,1,0,1,2,1,4,0.4439560898733555,1.5806199941944545
Wiley College,1325,1188,Texas,Town,NA,100.0,99.97,100.0,13,6,29,6,3,16,19,9,45,16.41462307610893,2.7769302174374033
Wilkes University,2489,2233,Pennsylvania,Small City,NA,99.92,98.05,100.0,5,3,9,2,1,4,7,4,13,3.9206804973284965,3.1917705102610716
Willamette University,1950,1901,Oregon,Midsize City,private,99.96,98.52,100.0,5,3,11,3,1,6,8,4,17,0.80038276841423,7.076707186986143
William Carey University,3099,1676,Mississippi,Small City,private,100.0,100.0,100.0,28,14,55,14,7,27,42,21,82,38.75296672624914,3.250745665696802
William Jewell College,922,909,Missouri,Suburb,NA,87.82,56.92,99.43,1,1,3,1,0,2,2,1,5,0.9496794416917594,1.1477457000106044
William Paterson University of New Jersey,8839,7285,New Jersey,Suburb,NA,100.0,100.0,100.0,41,23,82,19,10,40,60,33,122,59.65668823514364,0.6395319318006593
William Penn University,1284,1068,Iowa,Town,NA,99.64,89.79,100.0,4,2,9,2,1,5,6,3,14,1.791641220486202,3.8217306712211543
William Woods University,959,794,Missouri,Town,NA,88.54,61.07,99.38,1,1,3,1,0,2,2,1,5,1.08633641053265,1.0765059565702069
Williams Baptist College,492,447,Arkansas,Rural,NA,70.05,38.94,93.94,1,0,2,0,0,1,1,0,3,0.7328264588032417,0.4686978038855009
Williams College,2073,2047,Massachusetts,Town,private,99.99,99.12,100.0,6,3,12,3,1,6,9,4,18,1.1981896709515776,7.901885268400486
Wilmington College,1168,1098,Ohio,Town,NA,94.54,78.57,99.6,2,1,4,1,0,2,3,1,6,2.476807659293457,0.4262689405473543
Wilmington University,8441,3035,Delaware,Suburb,private,100.0,99.59,100.0,7,4,13,3,2,6,10,6,19,4.409285108188441,5.724166182122863
Wilson College,827,565,Pennsylvania,Small City,NA,86.21,65.69,97.84,1,1,3,1,0,1,2,1,4,1.2007988239050378,0.7770826637262225
Wingate University,2588,2537,North CaroliNA,Suburb,NA,99.73,94.11,100.0,4,2,9,2,1,4,6,3,13,2.924194573327265,2.9655741736312815
WinoNA State University,7463,6522,Minnesota,Town,public,99.15,91.71,99.99,3,2,7,1,1,3,4,3,10,2.4969565263873346,2.2688039278388956
Winston - Salem State University,4688,4072,North CaroliNA,Midsize City,NA,99.99,98.5,100.0,6,3,13,3,1,6,9,4,19,5.562676557609252,3.268299212569191
Winthrop University,5014,4488,South CaroliNA,Small City,public,100.0,100.0,100.0,48,24,96,25,12,51,73,36,147,71.95942793724956,1.4356061554956097
Wisconsin Lutheran College,992,921,Wisconsin,Large City,NA,79.01,56.6,95.54,1,1,2,0,0,1,1,1,3,0.38247046129525125,1.1724285865952424
Wittenberg University,1860,1775,Ohio,Small City,NA,99.23,91.93,99.99,3,2,7,2,1,3,5,3,10,3.1450784051028235,1.7101990593890513
Wofford College,1679,1663,South CaroliNA,Small City,private,100.0,99.99,100.0,12,6,24,6,3,13,18,9,37,15.621641154887618,2.5152719308848086
Woodbury University,1023,923,California,Large City,private,99.92,97.51,100.0,5,3,10,2,1,5,7,4,15,6.872015986680565,0.2567229717185421
Worcester Polytechnic Institute,4435,4301,Massachusetts,Midsize City,NA,100.0,99.98,100.0,11,6,20,5,3,10,16,9,30,8.84195994769586,6.704454456842618
Worcester State University,5496,4153,Massachusetts,Midsize City,NA,100.0,100.0,100.0,16,9,29,7,4,14,23,13,43,22.451185181943742,0.4225277655155101
Wright State University - Main Campus,12120,9423,Ohio,Suburb,public,100.0,100.0,100.0,20,11,37,9,5,18,29,16,55,27.483218574160038,1.4080740597882908
Xavier University,4629,4370,Ohio,Large City,private,100.0,99.89,100.0,9,5,18,4,2,9,13,7,27,5.7387166143629535,7.5622219429546975
Xavier University of LouisiaNA,2289,2155,LouisiaNA,Large City,NA,100.0,99.96,100.0,12,5,26,6,2,13,18,7,39,7.6136498610332675,9.578645769125988
Yale University,5751,5743,Connecticut,Midsize City,NA,100.0,100.0,100.0,19,10,39,9,4,20,28,14,59,0.18957133386675423,28.176106653716122
Yeshiva University,2755,2646,New York,Large City,NA,100.0,99.9,100.0,9,5,17,4,2,8,13,7,25,3.306311664635492,9.398641171191349
York College,431,398,Nebraska,Town,NA,69.86,39.38,96.2,1,0,2,0,0,1,1,0,3,0.02305755676816852,1.1687192526790426
York College of Pennsylvania,4169,3814,Pennsylvania,Suburb,NA,100.0,99.9,100.0,9,5,16,4,2,8,13,7,24,4.129425215425586,8.36524878478669
Youngstown State University,11272,8834,Ohio,Small City,NA,100.0,100.0,100.0,18,10,34,8,4,16,26,14,50,23.609117537265178,3.056881636480288
