school,real_size,size,state,setting,status,meanprob,lowprob,highprob,meaNActive,lowactive,highactive,meanincub,lowincub,highincub,meantot,lowtot,hightot,instate,outstate
Abilene Christian University,3669,3508,Texas,Midsize City,private,100.0,100.0,100.0,55,17,147,30,9,79,85,26,226,82.80204216216559,1.8449543580348724
Adams State University,1956,1514,Colorado,Town,NA,97.97,69.84,100.0,3,1,8,1,0,4,4,1,12,1.209733447533696,2.6671456614590756
Adelphi University,5269,4874,New York,Suburb,private,100.0,99.91,100.0,9,5,19,5,2,10,14,7,29,11.497350109580594,2.4643738136918194
Adrian College,1673,1606,Michigan,Town,private,99.55,84.84,100.0,4,1,10,2,1,5,6,2,15,4.5047662120543785,0.8915098483966956
Agnes Scott College,923,913,Georgia,Suburb,private,98.37,68.56,100.0,3,1,9,1,0,5,4,1,14,1.5212394159062925,2.569924852446232
Alabama A & M University,5032,4714,Alabama,Midsize City,public,100.0,99.92,100.0,13,5,34,7,2,18,20,7,52,13.728666658032573,6.538058545097972
Alabama State University,4212,3866,Alabama,Midsize City,NA,100.0,99.88,100.0,12,4,32,6,2,17,18,6,49,11.29348289359787,7.394760496626821
Alaska Pacific University,298,203,Alaska,Large City,private,60.89,30.18,90.25,1,0,1,0,0,1,1,0,2,8.03706589931471e-05,0.9307117897225038
Albany State University,6266,3927,Georgia,Small City,NA,100.0,95.95,100.0,11,2,47,6,1,27,17,3,74,14.584852377541388,2.6677296533122297
Albertus Magnus College,1130,1012,Connecticut,Midsize City,NA,62.43,40.65,87.41,1,0,1,0,0,1,1,0,2,0.3484575241023485,0.6272756153478583
Albion College,1565,1554,Michigan,Town,NA,99.41,82.97,100.0,3,1,9,2,1,5,5,2,14,4.630845145372088,0.5003596195517346
Albright College,2019,1993,Pennsylvania,Small City,NA,99.73,93.78,100.0,4,2,9,2,1,5,6,3,14,2.2057294392082256,3.703024016819612
Alcorn State University,3169,2893,Mississippi,Rural,NA,100.0,100.0,100.0,25,11,55,13,5,29,38,16,84,33.42802770614062,4.045339307380061
Alderson Broaddus University,950,903,West Virginia,Town,private,62.12,29.21,89.31,1,0,1,0,0,1,1,0,2,0.11221767616573741,0.8563236927874693
Alfred University,1704,1600,New York,Town,NA,98.83,89.08,99.99,3,1,6,2,1,3,5,2,9,3.278261809833214,1.160473696982209
Alice Lloyd College,598,584,Kentucky,Rural,private,77.67,38.88,98.53,1,0,3,1,0,1,2,0,4,1.1911236034942756,0.3056077867725296
Allegheny College,1800,1752,Pennsylvania,Town,NA,99.11,88.62,100.0,3,1,7,2,1,4,5,2,11,1.6796087287085588,3.0287885394473992
Allen University,590,563,South CaroliNA,Midsize City,private,100.0,98.45,100.0,7,3,15,4,1,8,11,4,23,9.9244678197923,0.2667728612387998
Alma College,1427,1386,Michigan,Town,NA,99.27,80.99,100.0,3,1,9,2,1,5,5,2,14,4.630845145372088,0.2786421106181812
Alvernia University,2252,1670,Pennsylvania,Small City,NA,99.72,94.11,100.0,4,2,9,2,1,5,6,3,14,2.8294807970171094,3.034861694726201
Alverno College,1312,1036,Wisconsin,Large City,NA,51.12,29.96,79.26,0,0,1,0,0,1,0,0,2,0.4954323933676822,0.21838448651809286
American InterContinental University - Atlanta,1905,932,Georgia,Midsize City,private,99.51,65.97,100.0,3,1,14,2,0,8,5,1,22,4.1364038050485705,1.1786928776460632
American InterNAtioNAl College,1374,1254,Massachusetts,Midsize City,private,99.12,88.75,100.0,3,1,7,2,1,4,5,2,11,3.2199259743285595,1.5015604422485156
American Jewish University,68,63,California,Large City,NA,34.17,15.6,64.67,0,0,1,0,0,0,0,0,1,0.2953636635141748,0.12073918808932713
American Public University System,37910,2914,West Virginia,Town,NA,100.0,100.0,100.0,166,57,454,89,29,244,255,86,698,0.10832573363975807,254.4374605853011
American University,8124,7764,District of Columbia,Large City,NA,100.0,100.0,100.0,24,10,60,13,5,32,37,15,92,0.4247667798283949,36.464259912006334
Amherst College,1832,1836,Massachusetts,Suburb,private,99.99,97.57,100.0,6,2,14,3,1,8,9,3,22,0.9253623411269332,8.186321631603859
Amridge University,321,147,Alabama,Midsize City,NA,87.09,54.39,99.35,1,1,3,1,0,2,2,1,5,0.683039348560953,1.3538214257333712
Anderson University IndiaNA,1565,1431,IndiaNA,Small City,NA,98.94,88.17,100.0,3,1,7,2,1,4,5,2,11,3.174094876879973,1.3610441685873467
Anderson University South CaroliNA,2984,2550,South CaroliNA,Small City,private,100.0,100.0,100.0,34,14,77,18,7,42,52,21,119,49.49930850615416,2.465667935609095
Andrews University,1704,1344,Michigan,Town,NA,99.98,96.13,100.0,6,2,14,3,1,8,9,3,22,1.5265773547657804,7.0131142107841224
Angelo State University,8721,5332,Texas,Midsize City,NA,100.0,100.0,100.0,145,44,390,80,23,209,225,67,599,224.6735576162272,0.5109909928703551
AnNA Maria College,1121,866,Massachusetts,Rural,NA,98.22,84.91,99.98,3,1,6,1,1,3,4,2,9,3.714010844251537,0.3077517036982085
Antioch University - Seattle,90,17,Washington,Large City,NA,32.72,14.71,62.99,0,0,1,0,0,0,0,0,1,0.017171980620927275,0.3772268537653669
Appalachian State University,17014,16071,North CaroliNA,Town,public,100.0,100.0,100.0,19,7,49,10,4,26,29,11,75,15.220675597335623,13.682768568159895
AquiNAs College Michigan,1553,1317,Michigan,Midsize City,NA,99.4,82.46,100.0,3,1,9,2,1,5,5,2,14,4.855742702100975,0.2539417355479378
Arcadia University,2387,2177,Pennsylvania,Suburb,NA,99.86,95.03,100.0,4,2,11,2,1,6,6,3,17,2.527548980338606,4.037819151696184
ArizoNA Christian University,784,646,ArizoNA,Large City,NA,98.7,88.63,99.99,3,1,6,1,1,3,4,2,9,3.286956311087524,1.0418615581388382
ArizoNA State University - Tempe,42429,38814,ArizoNA,Midsize City,NA,100.0,100.0,100.0,147,73,326,76,37,169,223,110,495,143.84732188491648,79.30093892937033
Arkansas Baptist College,597,496,Arkansas,Midsize City,NA,94.19,62.52,99.94,2,1,5,1,0,3,3,1,8,0.39926028303887,2.426319857981746
Arkansas State University - Main Campus,9608,6894,Arkansas,Small City,public,100.0,98.46,100.0,10,3,27,5,1,14,15,4,41,9.92248599065296,5.01692166540468
Arkansas Tech University,10780,6729,Arkansas,Town,public,100.0,98.7,100.0,11,3,29,5,1,15,16,4,44,11.96855028170433,3.91873200552195
Armstrong State University,6283,4513,Georgia,Midsize City,public,100.0,96.26,100.0,11,2,47,6,1,27,17,3,74,14.706942218304333,2.6964059352570953
Asbury University,1731,1325,Kentucky,Town,NA,99.86,89.92,100.0,4,2,11,2,1,6,6,3,17,2.0977278037247364,4.424887257441324
Ashford University,31543,31545,California,Large City,private,100.0,100.0,100.0,140,50,380,75,26,203,215,76,583,8.81955899253326,206.35423615406268
Ashland University,4812,3380,Ohio,Town,NA,100.0,98.0,100.0,7,3,15,3,1,8,10,4,23,8.67477855326687,1.291420880223722
Assumption College,2085,1937,Massachusetts,Midsize City,private,99.91,95.9,100.0,5,2,10,2,1,6,7,3,16,5.1711424945328615,1.7953761505412769
Point University,1925,1119,Georgia,Town,NA,99.85,78.75,100.0,4,1,16,2,1,9,6,2,25,4.238959271289444,2.2711115434112124
Auburn University,23968,21762,Alabama,Small City,public,100.0,100.0,100.0,87,31,226,46,15,121,133,46,347,56.92135987355471,76.075311521569
Auburn University at Montgomery,4312,3239,Alabama,Midsize City,NA,100.0,99.87,100.0,12,4,30,6,2,16,18,6,46,17.131135959559803,1.4834835058496303
Augsburg University,2428,2033,Minnesota,Large City,NA,86.5,53.56,99.48,1,1,3,1,0,2,2,1,5,0.6972752913047005,1.2963398249909488
AugustaNA College,2650,2637,Illinois,Small City,NA,97.22,80.15,99.99,2,1,6,1,1,3,3,2,9,2.639041957045073,0.9371139775346752
AugustaNA University,1746,1679,South Dakota,Midsize City,NA,95.73,72.71,99.95,2,1,5,1,0,3,3,1,8,2.0024917129889097,1.1448924746933156
Aurora University,3935,3461,Illinois,Suburb,private,99.78,93.99,100.0,4,2,10,2,1,5,6,3,15,3.9107871760004143,2.2113187263534617
Austin College,1218,1204,Texas,Small City,NA,100.0,99.98,100.0,19,6,51,10,3,27,29,9,78,28.65720788529236,0.5161451115409141
Austin Peay State University,9591,7065,Tennessee,Midsize City,NA,100.0,99.51,100.0,14,4,46,7,2,23,21,6,69,19.06394211813506,1.9962332017481574
Ave Maria University,1071,1035,Florida,Rural,NA,100.0,98.13,100.0,7,3,20,4,1,10,11,4,30,7.144120342970484,3.262547422401374
Averett University,929,890,Virginia,Town,NA,99.85,88.22,100.0,4,1,9,2,1,5,6,2,14,4.179389259928753,2.2953016662744257
Averett University - Non - TraditioNAl Programs,344,87,Virginia,Town,NA,94.4,55.54,99.83,2,1,4,1,0,2,3,1,6,2.8696804499311197,0.0
Avila University,1274,1077,Missouri,Large City,NA,96.97,66.54,100.0,2,1,7,1,0,3,3,1,10,0.964894652263988,2.507201121371938
Azusa Pacific University,5674,5075,California,Suburb,private,100.0,100.0,100.0,21,9,52,11,5,28,32,14,80,25.070467759083158,6.531771589797016
Bacone College,936,864,Oklahoma,Town,private,99.95,91.1,100.0,5,2,13,3,1,7,8,3,20,1.8696317481076319,5.634991288622391
Baker University,1774,1062,Kansas,Town,NA,98.95,77.34,100.0,3,1,8,2,0,4,5,1,12,0.6542277704176047,3.8685026083541096
Baldwin Wallace University,3191,2958,Ohio,Suburb,NA,99.93,94.38,100.0,5,2,11,2,1,6,7,3,17,5.1978587830391705,2.0506739870707373
Ball State University,17000,15203,IndiaNA,Small City,NA,100.0,100.0,100.0,30,15,65,16,8,35,46,23,100,41.22211818082721,5.11190864517254
Bard College,1941,1862,New York,Town,NA,99.92,95.47,100.0,5,2,11,2,1,6,7,3,17,1.4010930835103579,5.701627818409937
BarNArd College,2549,2514,New York,Large City,NA,100.0,99.06,100.0,7,3,17,4,2,9,11,5,26,2.2274419972004456,8.75809229630989
Barry University,3504,2991,Florida,Suburb,NA,100.0,100.0,100.0,25,10,57,13,5,32,38,15,89,32.771058253750496,5.076042373985786
Barton College,888,830,North CaroliNA,Town,private,81.35,44.43,98.57,1,0,3,1,0,1,2,0,4,0.724794076063601,0.949370379391421
Bates College,1788,1787,Maine,Small City,NA,99.68,90.96,100.0,4,2,9,2,1,5,6,3,14,0.14710675338936333,5.565503409870261
Bay Path University,1946,1367,Massachusetts,Suburb,NA,99.7,93.59,100.0,4,2,8,2,1,4,6,3,12,5.141832375130651,0.6491787324835518
Baylor University,14311,14100,Texas,Midsize City,private,100.0,100.0,100.0,200,61,537,110,32,288,310,93,825,299.45996393479186,10.414875594159671
Beacon College,349,344,Florida,Suburb,private,93.05,67.59,99.8,2,1,4,1,0,2,3,1,6,1.4673608173321118,1.1805310361616042
Becker College,1885,1530,Massachusetts,Midsize City,private,99.79,94.11,100.0,4,2,9,2,1,5,6,3,14,5.1627681747036585,1.0054925685251237
Belhaven University,2479,1248,Mississippi,Midsize City,private,100.0,99.99,100.0,15,6,36,8,3,19,23,9,55,9.779188008036275,12.964001022175474
Bellarmine University,2539,2410,Kentucky,Large City,NA,99.81,89.62,100.0,4,2,11,2,1,6,6,3,17,4.058018268584749,2.1740418614700436
Bellevue University,5743,4919,Nebraska,Suburb,NA,99.99,95.89,100.0,6,2,16,3,1,9,9,3,25,0.5450727766246379,8.700296820241153
Belmont Abbey College,1552,1381,North CaroliNA,Suburb,private,99.58,87.89,100.0,4,1,9,2,1,5,6,2,14,0.8948075013130877,4.540069302293238
Belmont University,6496,6161,Tennessee,Large City,NA,100.0,100.0,100.0,23,8,62,12,4,33,35,12,95,4.101037581507565,30.89604503320972
Beloit College,1407,1346,Wisconsin,Small City,NA,96.15,73.25,99.97,2,1,5,1,0,3,3,1,8,0.11687736816161906,3.1224170269339786
Bemidji State University,4819,3333,Minnesota,Town,NA,97.33,68.91,100.0,2,1,8,1,0,4,3,1,12,1.4762104518109551,2.130347192800507
Benedict College,2089,2077,South CaroliNA,Midsize City,NA,100.0,100.0,100.0,16,7,37,9,3,20,25,10,57,21.0587364688568,3.477455186069632
Benedictine College,2080,1821,Kansas,Town,NA,99.76,87.02,100.0,4,1,11,2,1,6,6,2,17,0.34195674911007434,5.645934167041247
Benedictine University,2883,2473,Illinois,Suburb,private,97.98,84.9,99.99,3,1,6,1,1,3,4,2,9,3.0633362027251647,0.8313583878216562
Bennett College,490,400,North CaroliNA,Large City,private,73.28,40.79,95.8,1,0,2,0,0,1,1,0,3,0.17498457803455938,1.1416296337698517
Bennington College,775,724,Vermont,Town,NA,95.95,73.99,99.96,2,1,5,1,0,3,3,1,8,3.624249647145446e-05,3.190647351828164
Bentley University,4270,4171,Massachusetts,Small City,private,100.0,99.89,100.0,10,4,22,5,2,12,15,6,34,7.850924839877827,7.034599474925831
Berea College,1668,1615,Kentucky,Town,NA,99.54,84.0,100.0,4,1,9,2,1,5,6,2,14,1.8879550233522628,3.4680040272414687
Berry College,1976,1945,Georgia,Suburb,private,99.96,88.21,100.0,5,1,17,3,1,9,8,2,26,3.4942112426354806,4.205577775738445
Bethany College Kansas,777,710,Kansas,Town,NA,94.9,59.59,99.97,2,1,5,1,0,3,3,1,8,0.29856991616789463,2.643932822812456
Bethany College West Virginia,598,594,West Virginia,Rural,private,79.19,47.82,97.27,1,0,2,1,0,1,2,0,3,0.022540833796296966,1.5408150039551907
Bethany Lutheran College,651,522,Minnesota,Small City,NA,51.99,23.28,86.22,0,0,1,0,0,1,0,0,2,0.16131990487164197,0.5679876104500572
Bethel College - Mishawaka,1330,1044,IndiaNA,Small City,NA,98.2,83.13,100.0,3,1,7,1,1,4,4,2,11,2.6670071806599425,1.3373749818785432
Bethel College - North Newton,502,489,Kansas,Town,NA,69.62,31.28,95.82,1,0,2,0,0,1,1,0,3,0.20665833585617183,0.9743815480765348
Bethel University Minnesota,2898,2407,Minnesota,Suburb,NA,94.14,60.58,100.0,2,1,7,1,0,3,3,1,10,0.7289393222195888,2.0946769328159505
Bethel University Tennessee,4830,3454,Tennessee,Town,NA,100.0,98.83,100.0,10,3,37,5,1,18,15,4,55,8.754622746998987,6.800154124069512
Bethune - Cookman University,3988,3755,Florida,Small City,private,100.0,100.0,100.0,32,13,75,17,7,41,49,20,116,39.989287728909474,8.419858125665533
Biola University,4047,3882,California,Suburb,private,100.0,100.0,100.0,16,7,40,8,3,21,24,10,61,18.135328939770332,5.522894301355004
Birmingham Southern College,1287,1272,Alabama,Midsize City,NA,99.9,90.54,100.0,5,2,12,2,1,6,7,3,18,3.0630708674596776,3.788839278150516
Black Hills State University,3951,2195,South Dakota,Town,NA,100.0,98.92,100.0,8,3,30,4,2,15,12,5,45,8.48230599894596,3.70986371736731
Blackburn College,557,546,Illinois,Town,private,57.86,31.48,89.51,1,0,1,0,0,1,1,0,2,0.5801342233159428,0.2810152707849531
Bloomfield College,1839,1700,New Jersey,Suburb,NA,100.0,98.83,100.0,7,3,16,3,1,9,10,4,25,10.101099387411292,0.017266992226360044
Bloomsburg University of Pennsylvania,8578,7863,Pennsylvania,Small City,public,100.0,99.99,100.0,13,6,28,7,3,15,20,9,43,13.393478430864375,5.8853735530528795
Blue Mountain College,590,531,Mississippi,Rural,NA,99.77,92.13,100.0,4,2,9,2,1,5,6,3,14,5.282386874147018,0.7334193488687517
Bluefield College,949,829,Virginia,Town,NA,99.87,85.66,100.0,4,1,9,2,1,6,6,2,15,5.672624145212679,0.9235168187044842
Bluefield State College,1380,1099,West Virginia,Town,NA,68.01,27.2,92.26,1,0,2,0,0,1,1,0,3,0.20562429678924138,0.9299739067554651
Bluffton University,735,660,Ohio,Town,NA,79.64,46.67,97.88,1,0,2,1,0,1,2,0,3,1.158324335546182,0.4311453859144815
Boise State University,20744,12477,Idaho,Midsize City,public,100.0,100.0,100.0,94,20,342,54,10,199,148,30,541,106.26114239031921,42.44622705080235
Boston College,9924,9681,Massachusetts,Small City,private,100.0,100.0,100.0,26,12,60,14,6,33,40,18,93,10.823808379244896,28.98644244244056
Boston University,18086,16840,Massachusetts,Large City,private,100.0,100.0,100.0,51,22,122,27,11,66,78,33,188,16.88262877567328,61.42227714740339
Bowdoin College,1819,1813,Maine,Town,private,99.94,94.42,100.0,5,2,13,3,1,7,8,3,20,0.1605519942905417,7.156262319865986
Bowie State University,5185,4389,Maryland,Suburb,NA,100.0,99.73,100.0,9,4,21,5,2,11,14,6,32,11.499460547661034,2.1158152080119916
Bowling Green State University - Main Campus,14679,13104,Ohio,Town,public,100.0,100.0,100.0,21,8,51,11,4,27,32,12,78,24.756992563261846,7.099885268844997
Bradley University,4645,4512,Illinois,Midsize City,NA,99.83,94.97,100.0,4,2,11,2,1,6,6,3,17,4.510259206760222,1.8411307763617173
Brandeis University,3630,3620,Massachusetts,Small City,NA,100.0,99.84,100.0,10,4,23,5,2,12,15,6,35,3.6009575265572966,11.18268722334001
BreNAu University,1737,1080,Georgia,Small City,NA,99.43,66.52,100.0,3,1,13,2,0,8,5,1,21,3.9288510757515644,1.2198128388586769
Brescia University,1177,715,Kentucky,Small City,NA,94.45,63.77,99.97,2,1,5,1,0,3,3,1,8,2.2568657750417853,0.6304005611591645
Brevard College,673,656,North CaroliNA,Town,NA,97.57,75.59,99.99,2,1,6,1,0,3,3,1,9,0.35891723108224965,3.331711302512012
Brewton - Parker College,782,438,Georgia,Rural,NA,96.81,64.21,100.0,2,1,7,1,0,4,3,1,11,1.533448399982587,1.8955640188103653
Briar Cliff University,943,720,Iowa,Small City,NA,97.39,65.98,100.0,2,1,7,1,0,4,3,1,11,1.0900243073947231,2.529270267629386
Bridgewater College,1880,1876,Virginia,Suburb,private,100.0,98.04,100.0,8,3,18,5,1,11,13,4,29,12.50479940246148,0.9147057702308089
Bridgewater State University,9562,7858,Massachusetts,Suburb,NA,100.0,100.0,100.0,26,12,56,14,6,31,40,18,87,38.69773193074713,0.9319659949024501
Brigham Young University - Hawaii,3138,2702,Hawaii,Town,private,100.0,99.81,100.0,13,4,39,7,2,21,20,6,60,3.4304614177892554e-05,19.708034485887772
Brigham Young University - Idaho,51883,17230,Idaho,Town,NA,100.0,100.0,100.0,233,67,807,127,35,436,360,102,1243,74.90023632636729,284.7363440853562
Brigham Young University - Provo,31232,28156,Utah,Midsize City,NA,100.0,100.0,100.0,149,43,482,81,22,265,230,65,747,73.41893348267536,156.33748694277978
Brown University,6986,6666,Rhode Island,Midsize City,NA,100.0,100.0,100.0,21,9,51,11,4,27,32,13,78,0.14693291326662958,31.678425462598288
Bryan College - Dayton,1238,833,Tennessee,Town,NA,99.13,76.72,100.0,3,1,9,2,0,5,5,1,14,1.5694032138248721,3.1481758633582357
Bryant University,3476,3418,Rhode Island,Suburb,private,100.0,99.06,100.0,7,3,15,4,2,8,11,5,23,0.12718127574554167,10.063631439873946
Bryn Athyn College of the New Church,329,313,Pennsylvania,Suburb,private,54.84,30.96,84.07,1,0,1,0,0,1,1,0,2,0.41221828863891435,0.38148711211531383
Bryn Mawr College,1340,1325,Pennsylvania,Suburb,NA,99.89,93.53,100.0,4,2,11,2,1,6,6,3,17,0.33989929063208724,6.427322243722348
Bucknell University,3608,3585,Pennsylvania,Town,private,100.0,99.59,100.0,8,4,20,4,2,11,12,6,31,1.5693222567481475,11.161558509596668
BueNA Vista University,1805,1522,Iowa,Town,private,99.18,65.55,100.0,3,1,11,2,0,6,5,1,17,3.675338369805284,1.1174176660824169
Butler University,4288,4182,IndiaNA,Large City,NA,100.0,99.42,100.0,7,3,17,4,2,9,11,5,26,6.227585112496803,5.056859775022295
Cabrini University,1687,1479,Pennsylvania,Suburb,private,99.29,90.13,100.0,3,2,8,2,1,4,5,3,12,1.6362173299044627,3.3074802807010037
Caldwell University,1605,1440,New Jersey,Suburb,NA,99.98,97.43,100.0,5,2,13,3,1,7,8,3,20,7.785345161039707,0.4872310133988101
California Baptist University,7421,6367,California,Large City,NA,100.0,100.0,100.0,29,13,73,15,6,39,44,19,112,40.4825437212528,4.0432873974416745
California Institute of Technology,962,961,California,Midsize City,NA,99.7,89.64,100.0,4,1,9,2,1,5,6,2,14,1.9021419930312857,3.8809495616904153
California Lutheran University,2968,2858,California,Midsize City,private,100.0,99.96,100.0,12,5,30,6,3,16,18,8,46,14.537799518167684,3.988040660069638
California State University Maritime Academy,1050,1007,California,Midsize City,NA,99.63,92.13,100.0,4,2,9,2,1,5,6,3,14,5.18658593130891,0.40318761577084994
California Polytechnic State University - San Luis Obispo,21348,20584,California,Suburb,NA,100.0,100.0,100.0,85,37,213,43,18,112,128,55,325,112.79347582279308,15.666390409812584
California State Polytechnic University - PomoNA,24318,21668,California,Suburb,NA,100.0,100.0,100.0,96,43,232,49,21,122,145,64,354,142.65474220407614,2.108901557485905
California State University - Bakersfield,8816,7502,California,Large City,NA,100.0,100.0,100.0,35,16,84,18,8,44,53,24,128,51.505515643601804,1.1278472988582604
California State University - Channel Islands,7054,5858,California,Suburb,NA,100.0,100.0,100.0,28,12,67,14,6,35,42,18,102,41.669905648579785,0.0
California State University - Chico,16709,15446,California,Small City,NA,100.0,100.0,100.0,66,29,158,33,15,84,99,44,242,96.83202344648707,1.9835066653296314
California State University - Dominguez Hills,13279,10084,California,Small City,NA,100.0,100.0,100.0,52,23,125,26,12,66,78,35,191,78.05870899352612,0.3776090109968223
California State University - East Bay,13473,11539,California,Midsize City,NA,100.0,100.0,100.0,52,24,127,27,12,67,79,36,194,78.3127217441483,0.8089733579633992
California State University - Fresno,22260,19432,California,Large City,NA,100.0,100.0,100.0,88,39,211,44,20,111,132,59,322,130.47394472075158,1.539919794589622
California State University - Fullerton,35161,28475,California,Suburb,public,100.0,100.0,100.0,138,62,332,70,31,175,208,93,507,206.85498810551718,1.075660209643197
California State University - Long Beach,31564,27507,California,Large City,public,100.0,100.0,100.0,123,56,297,63,28,157,186,84,454,184.37781331208848,1.7420839062533469
California State University - Los Angeles,24820,21004,California,Large City,public,100.0,100.0,100.0,98,44,236,50,22,124,148,66,360,145.79150431059668,1.5787783987978652
California State University - Monterey Bay,6762,6109,California,Suburb,NA,100.0,100.0,100.0,27,12,66,14,6,35,41,18,101,39.182943601790434,1.11050874222557
California State University - Northridge,35836,29739,California,Large City,NA,100.0,100.0,100.0,140,63,338,71,31,178,211,94,516,210.32846478844388,1.2215555908475475
California State University - Sacramento,28449,23491,California,Large City,public,100.0,100.0,100.0,112,50,271,57,25,143,169,75,414,166.66190077450827,1.8985356270504274
California State University - San BerNArdino,18324,16381,California,Midsize City,public,100.0,100.0,100.0,72,32,173,36,16,91,108,48,264,107.7722935430521,0.4518692484986089
California State University - San Marcos,14616,11634,California,Suburb,NA,100.0,100.0,100.0,57,26,138,29,13,73,86,39,211,85.98626972224658,0.5875033592328538
California State University - Stanislaus,9058,7621,California,Suburb,NA,100.0,100.0,100.0,36,16,86,18,8,45,54,24,131,53.2954194444977,0.2720911332655995
California University of Pennsylvania,5553,4534,Pennsylvania,Suburb,public,100.0,99.59,100.0,7,4,16,4,2,9,11,6,25,9.368926191784448,1.596311961428694
Calumet College of Saint Joseph,624,427,IndiaNA,Suburb,private,76.76,52.33,95.79,1,0,2,1,0,1,2,0,3,1.2827948207079682,0.1747808495265632
Calvin College,3737,3524,Michigan,Midsize City,NA,100.0,99.07,100.0,8,3,22,4,2,12,12,5,34,7.251242435137456,5.301057848676697
Cambridge College,750,221,Massachusetts,Large City,private,95.64,77.01,99.89,2,1,4,1,1,2,3,2,6,3.1236212962927246,0.0014656467890740209
Cameron University,4149,2814,Oklahoma,Small City,NA,100.0,99.47,100.0,11,3,34,6,2,19,17,5,53,13.210920847637597,4.545355167677411
Campbell University,4382,3634,North CaroliNA,Town,NA,99.99,97.15,100.0,6,2,16,3,1,9,9,3,25,3.6766645998397762,6.115114078941383
Campbellsville University,3704,2128,Kentucky,Town,private,100.0,97.06,100.0,7,2,19,3,1,10,10,3,29,7.6386226232183505,2.4924292688542455
Canisius College,2397,2303,New York,Large City,private,99.79,95.69,100.0,4,2,8,2,1,4,6,3,12,5.562438210063128,0.5872217233223006
Capella University,9208,1382,Minnesota,Large City,NA,100.0,100.0,100.0,31,11,83,17,6,45,48,17,128,0.10065828775048735,48.06177885127412
Capital University,2703,2493,Ohio,Suburb,NA,99.7,89.5,100.0,4,2,9,2,1,5,6,3,14,4.732582285231544,1.0715419192395172
CardiNAl Stritch University,1542,901,Wisconsin,Suburb,NA,62.35,36.57,89.82,1,0,1,0,0,1,1,0,2,0.5329288869075872,0.4410116964500664
Carleton College,2068,2055,Minnesota,Town,NA,99.94,94.08,100.0,5,2,14,3,1,7,8,3,21,0.1499875148599977,7.22473178163628
Carlos Albizu University - Miami,376,291,Florida,Suburb,NA,99.64,90.45,100.0,4,2,8,2,1,5,6,3,13,5.573006740574486,0.0
Carlow University,1365,1075,Pennsylvania,Large City,NA,92.3,73.05,99.61,2,1,4,1,0,2,3,1,6,2.2762404622648824,0.2852220676783914
Carnegie Mellon University,6530,6298,Pennsylvania,Large City,NA,100.0,100.0,100.0,20,8,49,11,4,26,31,12,75,2.3250557859194907,28.756753723233093
Carroll College,1360,1287,MontaNA,Town,NA,100.0,76.24,100.0,15,1,152,8,1,69,23,2,221,18.831713631488995,3.846137218206489
Carroll University,2983,2737,Wisconsin,Small City,NA,85.78,63.0,98.8,1,1,3,1,0,2,2,1,5,0.8711951265016247,1.0771409151759992
Carson - Newman University,1688,1608,Tennessee,Suburb,NA,99.78,85.09,100.0,4,1,11,2,1,6,6,2,17,2.512725895226971,3.5807031234312228
Carthage College,2740,2596,Wisconsin,Suburb,NA,94.18,74.25,99.92,2,1,5,1,0,2,3,1,7,0.3442497226057244,2.4974065974243276
Case Western Reserve University,5147,4978,Ohio,Large City,private,100.0,99.89,100.0,11,5,29,6,2,15,17,7,44,4.053161792617061,13.484642396015184
Castleton University,1857,1590,Vermont,Town,NA,85.22,58.42,98.65,1,1,3,1,0,1,2,1,4,0.002425982107557983,1.9047126504089742
Catawba College,1322,1268,North CaroliNA,Suburb,NA,95.48,68.7,99.96,2,1,5,1,0,3,3,1,8,1.1185093766413596,1.9611939667701954
Catholic University of America,3308,3194,District of Columbia,Large City,NA,100.0,99.6,100.0,9,4,20,5,2,11,14,6,31,0.06835327491491412,13.37156134746754
Cazenovia College,897,713,New York,Town,NA,92.95,70.96,99.92,2,1,4,1,0,2,3,1,6,1.697098664533673,0.9470478357079576
Cedar Crest College,1432,931,Pennsylvania,Midsize City,NA,95.85,79.14,99.92,2,1,5,1,1,2,3,2,7,1.7935111505693115,1.385208020549473
Cedarville University,3536,3109,Ohio,Town,private,100.0,97.93,100.0,7,3,16,3,1,9,10,4,25,2.3828386331235745,7.641807763035799
CenteNAry University,1366,1125,New Jersey,Suburb,private,99.92,95.58,100.0,5,2,11,2,1,6,7,3,17,6.252536411203278,0.886106411642547
CenteNAry College of LouisiaNA,536,524,LouisiaNA,Midsize City,NA,99.71,84.74,100.0,4,1,10,2,1,5,6,2,15,2.040539705411587,3.7342658509431015
Central Baptist College,745,599,Arkansas,Small City,private,89.93,50.45,99.78,1,0,4,1,0,2,2,0,6,0.7337130998453437,1.5446718402626147
Central Christian College of Kansas,869,730,Kansas,Town,NA,99.85,86.69,100.0,4,1,11,2,1,6,6,2,17,0.17468909053035517,6.23517054285896
Central College,1232,1198,Iowa,Town,NA,97.97,59.35,100.0,3,1,9,1,0,5,4,1,14,2.7865493191603563,1.0966796103052678
Central Connecticut State University,9550,7605,Connecticut,Suburb,NA,99.49,95.91,100.0,3,2,7,2,1,3,5,3,10,3.336911327024277,1.9321033092334228
Central Methodist University - College of Liberal Arts & Sciences,1058,1034,Missouri,Town,NA,85.72,44.79,99.72,1,0,4,1,0,2,2,0,6,1.1145799801808358,0.8225031777396061
Central Michigan University,17801,15585,Michigan,Town,NA,100.0,100.0,100.0,39,14,110,21,7,62,60,21,172,58.122388259464095,1.7112674065196554
Central Penn College,1197,316,Pennsylvania,Suburb,NA,91.77,71.56,99.58,2,1,4,1,0,2,3,1,6,1.7645835513665806,0.7294029124460081
Central State University,1788,1710,Ohio,Rural,public,98.63,80.82,100.0,3,1,7,1,1,4,4,2,11,1.7812886840752213,2.5037288252142362
Central Washington University,12080,10446,Washington,Town,NA,100.0,100.0,100.0,44,24,95,25,13,56,69,37,151,66.63300880273813,2.367189621220754
Centre College,1447,1449,Kentucky,Town,NA,99.08,79.11,100.0,3,1,9,2,1,5,5,2,14,1.907244474420996,2.7591257316894575
Chadron State College,2151,1616,Nebraska,Town,NA,85.45,53.48,99.81,1,1,4,1,0,2,2,1,6,0.1637008808257946,1.75597218297764
ChamiNAde University of Honolulu,1813,1524,Hawaii,Large City,NA,99.3,85.85,100.0,3,1,8,2,1,4,5,2,12,9.035033448411182e-05,4.929030694730192
Champlain College,3933,2603,Vermont,Small City,NA,99.99,98.39,100.0,6,3,15,3,1,8,9,4,23,0.0015131242276832236,9.35318671089111
Chapman University,7023,6515,California,Midsize City,NA,100.0,100.0,100.0,28,12,69,14,6,36,42,18,105,27.917773475359805,14.127363137343202
Charleston Southern University,3062,2804,South CaroliNA,Midsize City,private,100.0,100.0,100.0,34,14,77,18,7,42,52,21,119,48.43304336849052,3.7026261746574094
Chatham University,1207,951,Pennsylvania,Large City,NA,96.77,77.45,99.97,2,1,5,1,1,3,3,2,8,1.4391480603358588,1.9792310732258145
Chestnut Hill College,1363,1118,Pennsylvania,Large City,NA,98.43,85.49,99.99,3,1,6,1,1,3,4,2,9,1.3686370372792025,2.7754511989520214
Cheyney University of Pennsylvania,718,671,Pennsylvania,Suburb,public,80.72,55.4,97.48,1,1,2,1,0,1,2,1,3,0.9292991243877279,0.7142911440689711
Chicago State University,2032,1297,Illinois,Large City,NA,92.47,71.79,99.83,2,1,4,1,0,2,3,1,6,2.2227103379595143,0.35988980910799573
Chowan University,1500,1440,North CaroliNA,Town,private,99.93,90.14,100.0,5,2,10,3,1,6,8,3,16,0.6581806287436268,6.587304617519234
Christian Brothers University,1789,1426,Tennessee,Large City,NA,99.78,85.11,100.0,4,1,12,2,1,6,6,2,18,3.1556139587214966,2.916388023155496
Christopher Newport University,4951,4867,Virginia,Midsize City,NA,100.0,100.0,100.0,25,7,55,15,4,33,40,11,88,39.27458011126661,0.6435832544610145
Citadel Military College of South CaroliNA,2837,2559,South CaroliNA,Midsize City,NA,100.0,100.0,100.0,25,10,58,14,5,32,39,15,90,30.819163498239313,7.750304545031413
City University of Seattle,929,235,Washington,Large City,NA,99.69,95.33,100.0,4,2,7,2,1,4,6,3,11,4.8711185028030375,0.8714505881172045
Claflin University,2040,1955,South CaroliNA,Town,private,100.0,100.0,100.0,21,9,48,11,4,26,32,13,74,30.080979941395256,2.150900131278829
Claremont McKenNA College,1341,1337,California,Suburb,NA,99.96,95.71,100.0,5,2,14,3,1,7,8,3,21,3.692045793927185,4.075040805364439
Clarion University of Pennsylvania,4319,3483,Pennsylvania,Town,public,99.98,98.55,100.0,6,3,12,3,1,7,9,4,19,7.340378297692948,1.0638002282917773
Clark Atlanta University,3305,3187,Georgia,Large City,NA,100.0,99.86,100.0,12,4,33,7,2,18,19,6,51,2.099945261122651,16.81278224735092
Clark University,2240,2199,Massachusetts,Midsize City,private,99.93,95.83,100.0,5,2,11,2,1,6,7,3,17,3.5842088868988906,3.598587443155791
Clarke University,765,708,Iowa,Small City,NA,86.87,42.6,99.97,1,0,5,1,0,3,2,0,8,1.0173560202350749,1.004594826511194
Clarkson University,3086,3021,New York,Town,private,99.95,97.46,100.0,5,2,11,3,1,6,8,3,17,5.3725012955731675,2.1333235998926035
Clayton State University,6553,3743,Georgia,Suburb,NA,100.0,94.41,100.0,11,2,48,6,1,27,17,3,75,15.507851573709251,1.3049206426677369
Clemson University,19409,18642,South CaroliNA,Suburb,public,100.0,100.0,100.0,177,73,407,96,38,223,273,111,630,240.46329364195103,33.04112306773052
Cleveland State University,12077,9268,Ohio,Large City,NA,100.0,99.99,100.0,16,6,37,8,3,20,24,9,57,22.635020251084807,1.5801625590313915
Coastal CaroliNA University,9899,9021,South CaroliNA,Small City,NA,100.0,100.0,100.0,74,31,167,40,16,92,114,47,259,95.75881140171496,17.577567257200204
Coe College,1393,1369,Iowa,Midsize City,private,97.59,62.74,100.0,2,1,8,1,0,4,3,1,12,2.0486867110777744,1.6633231142071976
Cogswell College,606,436,California,Large City,NA,96.34,77.09,99.97,2,1,5,1,0,3,3,1,8,3.154483926331387,0.1433015901554482
Coker College,1025,909,South CaroliNA,Town,private,100.0,99.95,100.0,12,5,28,7,3,15,19,8,43,16.85519121460593,1.8337597468329299
Colby College,1923,1917,Maine,Town,NA,99.67,91.57,100.0,4,2,8,2,1,5,6,3,13,0.16687916647933151,5.530805987420469
Colby - Sawyer College,983,920,New Hampshire,Rural,NA,84.54,54.86,98.61,1,1,3,1,0,2,2,1,5,0.1430003917586145,1.7201119800102551
Colgate University,2882,2854,New York,Town,private,100.0,98.89,100.0,7,3,15,4,2,8,11,5,23,1.9931042455569878,8.201682797606214
College of Charleston,9901,9083,South CaroliNA,Midsize City,public,100.0,100.0,100.0,79,32,183,43,17,100,122,49,283,101.9103410420821,20.524779811995298
College of Mount Saint Vincent,1693,1613,New York,Large City,NA,98.76,89.28,99.99,3,1,6,1,1,3,4,2,9,3.7272036077185753,0.6598074956686115
Mount St. Joseph University,1315,1000,Ohio,Suburb,NA,95.06,69.9,99.93,2,1,5,1,0,3,3,1,8,2.063569404502442,0.9378990848872024
Notre Dame of Maryland University,817,528,Maryland,Large City,NA,90.98,63.53,99.68,2,1,4,1,0,2,3,1,6,1.6998110896870129,0.6992139881629033
College of Our Lady of the Elms,1174,973,Massachusetts,Suburb,private,98.1,84.59,99.98,3,1,6,1,1,3,4,2,9,3.705636524422334,0.24962896384306985
College of Saint Benedict,1940,1916,Minnesota,Suburb,NA,80.81,45.22,98.93,1,0,3,1,0,2,2,0,5,0.5362886920216362,1.1078445090465852
College of Saint Elizabeth,757,587,New Jersey,Suburb,NA,98.45,83.87,100.0,3,1,7,1,1,4,4,2,11,4.135275404234973,0.017575594723499396
College of Saint Mary,833,761,Nebraska,Large City,NA,54.53,19.95,93.08,1,0,2,0,0,1,1,0,3,0.08172254909975214,0.7043931998481294
Northeast Catholic College,69,70,New Hampshire,Rural,NA,13.67,4.61,31.42,0,0,0,0,0,0,0,0,0,0.012434816674662131,0.1341909817074946
College of the Atlantic,352,330,Maine,Town,private,60.17,31.25,88.85,1,0,1,0,0,1,1,0,2,0.06485351493509565,0.8531129629176177
College of the Holy Cross,2852,2827,Massachusetts,Midsize City,private,99.99,98.78,100.0,6,3,14,3,1,8,9,4,22,4.538881347428034,5.315628518656694
College of the Ozarks,1510,1477,Missouri,Town,private,84.65,43.34,99.71,1,0,4,1,0,2,2,0,6,1.4312220200049368,0.44154236740883007
College of William and Mary,6287,6199,Virginia,Suburb,NA,100.0,100.0,100.0,28,9,62,16,5,37,44,14,99,33.6436664377099,10.211189799234385
Colorado Christian University,6541,1840,Colorado,Midsize City,NA,100.0,99.98,100.0,18,6,57,10,3,30,28,9,87,2.402461057466279,25.30380461104632
Colorado College,2106,2091,Colorado,Large City,private,99.96,94.58,100.0,5,2,13,3,1,7,8,3,20,0.3362517889310912,7.487363851445095
Colorado School of Mines,4790,4584,Colorado,Suburb,public,100.0,99.83,100.0,14,4,42,7,2,22,21,6,64,2.4496136071784553,18.582764842179444
Colorado State University - Fort Collins,25523,22154,Colorado,Midsize City,public,100.0,100.0,100.0,30,9,103,16,5,53,46,14,156,16.119215068000102,30.03103559192719
Colorado State University - Pueblo,4627,3292,Colorado,Midsize City,NA,99.89,88.34,100.0,4,1,14,2,1,7,6,2,21,3.1375770374052854,3.665280679405236
Colorado Technical University - Colorado Springs,22305,14445,Colorado,Large City,NA,100.0,99.51,100.0,12,4,41,6,2,22,18,6,63,16.7778047787341,1.6732661239704718
Columbia College Chicago,7029,6436,Illinois,Large City,NA,100.0,99.91,100.0,11,5,28,6,2,15,17,7,43,4.318018650406508,13.012618624288223
Columbia College Missouri,12747,5163,Missouri,Midsize City,private,100.0,100.0,100.0,33,12,88,17,6,47,50,18,135,8.172818904259888,41.55637802089706
Columbia College South CaroliNA,1383,804,South CaroliNA,Midsize City,NA,100.0,100.0,100.0,16,7,37,9,4,20,25,11,57,24.27803698064893,0.8369537990188596
Columbia InterNAtioNAl University,497,454,South CaroliNA,Midsize City,NA,99.93,94.37,100.0,5,2,11,3,1,6,8,3,17,5.925973553553667,1.210932662476444
Columbia Southern University,15049,8567,Alabama,Town,private,100.0,100.0,100.0,77,26,216,41,14,115,118,40,331,3.8436872658150527,114.63429614292659
Columbia University in the City of New York,8157,7592,New York,Large City,NA,100.0,100.0,100.0,28,11,67,15,6,36,43,17,103,4.938359776738973,37.44784619083134
Columbus State University,6798,4693,Georgia,Midsize City,NA,100.0,96.53,100.0,12,2,48,6,1,27,18,3,75,15.007283226581178,2.6503530649704268
Concord University,1853,1696,West Virginia,Town,public,96.31,63.04,99.94,2,1,5,1,0,3,3,1,8,0.23059759466427543,3.0560735341883927
Concordia College at Moorhead,2032,1997,Minnesota,Suburb,NA,99.99,74.3,100.0,6,1,37,3,0,19,9,1,56,0.47029418548323726,8.85225735941078
Concordia College - New York,1131,1024,New York,Suburb,NA,96.19,79.57,99.92,2,1,5,1,1,2,3,2,7,2.247175702602,1.0114356670650007
Concordia University - Ann Arbor,906,780,Michigan,Midsize City,NA,96.2,67.85,99.99,2,1,6,1,0,3,3,1,9,2.559061592475672,0.7036876775019756
Concordia University - Chicago,1458,1299,Illinois,Suburb,private,96.6,74.96,100.0,2,1,6,1,0,3,3,1,9,1.1329680125934882,2.233411297922734
Concordia University - Irvine,1851,1645,California,Large City,private,100.0,99.14,100.0,8,3,19,4,2,10,12,5,29,8.772300806370993,2.6292781035209383
Concordia University - Portland,1378,1124,Oregon,Large City,NA,99.49,90.1,100.0,3,1,10,2,1,5,5,2,15,1.3872002074765732,3.8644797016551315
Concordia University - Saint Paul,2867,1417,Minnesota,Large City,NA,94.37,63.84,99.96,2,1,5,1,0,3,3,1,8,0.6699442330413231,2.19194055233211
Concordia University - Nebraska,1682,1231,Nebraska,Town,NA,98.79,75.9,100.0,3,1,8,2,0,4,5,1,12,0.10218515920297647,4.271033298110277
Concordia University - Texas,1725,1347,Texas,Large City,NA,100.0,100.0,100.0,28,8,75,15,4,40,43,12,115,41.88562651607174,0.7154196970072334
Concordia University - Wisconsin,3713,2616,Wisconsin,Suburb,NA,99.73,90.84,100.0,4,2,9,2,1,5,6,3,14,1.0275634825403779,4.842705617344027
Connecticut College,1815,1766,Connecticut,Small City,private,99.78,92.74,100.0,4,2,9,2,1,5,6,3,14,0.11468686124504214,5.968090242303878
Converse College,920,860,South CaroliNA,Small City,NA,100.0,99.77,100.0,10,4,22,5,2,12,15,6,34,13.594880505211353,1.3911295227528837
Cooper Union for the Advancement of Science and Art,864,859,New York,Large City,NA,98.53,83.45,100.0,3,1,6,1,1,3,4,2,9,1.0656200916839342,3.135912036256681
Coppin State University,2509,1854,Maryland,Large City,NA,99.92,95.2,100.0,5,2,11,2,1,6,7,3,17,5.1948436404171785,1.8848052297364566
Corban University,1021,936,Oregon,Midsize City,private,99.13,84.04,100.0,3,1,11,2,1,6,5,2,17,0.8187056927414789,3.9004779689003644
Cornell College,1006,1002,Iowa,Town,private,98.77,76.19,100.0,3,1,8,2,0,4,5,1,12,0.3884958428919654,3.975508082453756
Cornell University,14907,14898,New York,Small City,NA,100.0,100.0,100.0,44,19,105,23,9,56,67,28,161,13.211715766340628,54.39426965394718
Cornerstone University,1757,1260,Michigan,Midsize City,NA,99.64,85.72,100.0,4,1,10,2,1,6,6,2,16,4.637660222848721,0.9705583325882597
CoveNAnt College,1033,983,Georgia,Rural,private,99.44,83.49,100.0,3,1,10,2,1,5,5,2,15,0.6226581878910186,4.540228056798031
Creighton University,4256,4011,Nebraska,Large City,NA,99.99,94.62,100.0,6,2,17,3,1,9,9,3,26,0.15065596688498908,8.754000934530273
Crown College,1055,698,Minnesota,Rural,NA,91.62,35.82,100.0,2,0,12,1,0,6,3,0,18,0.22798102258719652,2.2271862012411288
Culver - Stockton College,1092,969,Missouri,Rural,NA,89.12,53.93,99.82,1,1,4,1,0,2,2,1,6,0.648252612439887,1.5587227299821034
Cumberland University,1974,1578,Tennessee,Town,NA,98.87,68.41,100.0,3,1,10,1,0,5,4,1,15,3.556893763059583,0.9160656847932983
CUNY BerNArd M Baruch College,15253,11598,New York,Large City,NA,100.0,100.0,100.0,25,13,51,13,7,27,38,20,78,37.27450279036095,0.7829454765351548
CUNY Brooklyn College,14691,10786,New York,Large City,NA,100.0,100.0,100.0,25,13,50,13,6,26,38,19,76,35.246864560351234,1.925125596938483
CUNY City College,13211,10225,New York,Large City,public,100.0,100.0,100.0,22,11,44,11,6,23,33,17,67,32.34107643997236,0.41845231278893436
College of Staten Island CUNY,12509,9710,New York,Large City,public,100.0,100.0,100.0,20,11,41,10,5,22,30,16,63,30.843781542629426,0.027568502694899813
CUNY Graduate School and University Center,2066,418,New York,Large City,NA,99.39,92.96,100.0,3,2,7,2,1,4,5,3,11,5.096229419951407,0.0
CUNY Hunter College,16846,12612,New York,Large City,NA,100.0,100.0,100.0,28,15,58,14,7,31,42,22,89,40.35789425935381,2.4947822887857027
CUNY John Jay College of CrimiNAl Justice,12916,10276,New York,Large City,public,100.0,100.0,100.0,21,11,43,11,6,22,32,17,65,31.810733107305587,0.11027401077959925
CUNY Lehman College,11978,7216,New York,Large City,NA,100.0,100.0,100.0,20,10,40,10,5,21,30,15,61,29.49942286214854,0.1047603102406193
CUNY Queens College,16680,12149,New York,Large City,NA,100.0,100.0,100.0,27,14,55,14,7,29,41,21,84,41.14477576224079,0.0
CUNY York College,8393,5056,New York,Large City,NA,100.0,100.0,100.0,14,7,28,7,4,15,21,11,43,20.703123679405692,0.0
Curry College,2561,2059,Massachusetts,Suburb,private,99.98,98.15,100.0,6,3,12,3,1,7,9,4,19,6.921375338836292,1.6090399350894642
Daemen College,1799,1560,New York,Suburb,NA,99.16,90.68,100.0,3,2,7,2,1,4,5,3,11,4.210679390056656,0.5569916443525057
Dakota State University,2963,1397,South Dakota,Town,public,99.99,98.09,100.0,6,3,15,3,1,8,9,4,23,6.465672395328599,2.8868278101862908
Dakota Wesleyan University,793,668,South Dakota,Town,NA,94.54,69.34,99.89,2,1,4,1,0,2,3,1,6,1.6630863379060439,1.2325322878254554
Dallas Baptist University,3159,2423,Texas,Large City,NA,100.0,100.0,100.0,49,15,132,27,8,71,76,23,203,75.54605808152027,0.9726850692527166
Dartmouth College,4415,4360,New Hampshire,Town,NA,100.0,99.97,100.0,13,5,35,7,3,19,20,8,54,0.05500015067639019,20.57256620759727
Davenport University,5597,2621,Michigan,Suburb,NA,100.0,99.83,100.0,12,4,35,7,2,20,19,6,55,18.598346433731315,0.2447062699275938
Davidson College,1812,1810,North CaroliNA,Suburb,private,99.99,96.85,100.0,6,2,15,3,1,8,9,3,23,0.3937153005777586,8.821987011159587
Davis & Elkins College,839,785,West Virginia,Town,NA,86.2,45.43,99.73,1,0,4,1,0,2,2,0,6,0.09227147072009333,1.8772147794207488
Defiance College,583,525,Ohio,Town,NA,82.41,49.22,98.63,1,0,3,1,0,2,2,0,5,0.8020665987311378,0.9304964582086638
Delaware State University,4054,3571,Delaware,Small City,NA,99.99,98.74,100.0,6,3,14,3,1,8,9,4,22,0.6774802745416669,9.000526672756695
Delaware Valley University,1991,1756,Pennsylvania,Suburb,private,99.78,93.97,100.0,4,2,9,2,1,5,6,3,14,1.9399571215331364,4.168667281516525
Delta State University,3034,2198,Mississippi,Town,NA,100.0,100.0,100.0,24,10,53,12,5,28,36,15,81,31.816222480439347,4.201672027546963
Denison University,2344,2319,Ohio,Suburb,NA,99.87,92.6,100.0,4,2,11,2,1,6,6,3,17,1.2653963329496107,5.329061430955934
DePaul University,14822,12886,Illinois,Large City,NA,100.0,100.0,100.0,19,8,49,10,4,26,29,12,75,11.838150709900033,17.069328945420967
DePauw University,2156,2140,IndiaNA,Town,NA,99.77,92.97,100.0,4,2,9,2,1,5,6,3,14,2.4532080438752812,3.5942177773487387
DeSales University,2350,1811,Pennsylvania,Suburb,private,99.84,95.3,100.0,4,2,10,2,1,5,6,3,15,2.7264262248573807,3.6949859788515496
Dickinson College,2386,2346,Pennsylvania,Small City,private,99.97,96.92,100.0,5,2,13,3,1,7,8,3,20,0.8931396253843144,7.326201243044691
Dickinson State University,1426,922,North Dakota,Town,public,100.0,95.0,100.0,14,2,80,8,1,41,22,3,121,13.787843750850582,7.96884523875528
DigiPen Institute of Technology,1024,964,Washington,Small City,NA,99.6,91.33,100.0,4,2,8,2,1,5,6,3,13,2.7589648864289824,2.732546629454391
Dillard University,1292,1200,LouisiaNA,Large City,NA,99.99,96.35,100.0,6,2,16,3,1,9,9,3,25,4.885635066099742,4.470813346703669
Doane University,1066,1062,Nebraska,Town,NA,65.94,31.32,94.45,1,0,2,0,0,1,1,0,3,0.11484639920434651,0.9526677482544206
Dominican College of Blauvelt,1420,1271,New York,Suburb,private,99.01,88.76,100.0,3,1,7,2,1,4,5,2,11,2.6739170819106124,1.9267645610028288
Dominican University,2171,2014,Illinois,Suburb,NA,92.98,73.34,99.86,2,1,4,1,0,2,3,1,6,2.2670735432719096,0.38707479694936386
Dominican University of California,1304,1135,California,Small City,private,99.95,96.41,100.0,5,2,13,3,1,7,8,3,20,6.852436993528856,0.7963041118085838
Dordt College,1445,1341,Iowa,Town,NA,99.85,83.3,100.0,4,1,19,2,1,10,6,2,29,1.4924948208943132,4.987330685949147
Drake University,3100,2955,Iowa,Midsize City,NA,99.71,81.99,100.0,4,1,12,2,1,7,6,2,19,2.63562287659801,3.19338037391284
Drew University,1534,1507,New Jersey,Suburb,private,99.95,96.24,100.0,5,2,12,3,1,6,8,3,18,5.331748421193624,2.320502821950349
Drexel University,15528,13572,Pennsylvania,Large City,private,100.0,100.0,100.0,36,16,84,19,8,45,55,24,129,12.433443732323745,42.39565806963813
Drury University,3277,2478,Missouri,Midsize City,NA,99.48,79.48,100.0,3,1,11,2,1,5,5,2,16,3.4105226253054086,1.8269028962010099
Duke University,6699,6669,North CaroliNA,Large City,NA,100.0,100.0,100.0,27,10,65,14,5,35,41,15,100,0.8938132707560732,39.869283769989195
Duquesne University,5941,5826,Pennsylvania,Large City,NA,100.0,99.81,100.0,9,4,19,5,2,10,14,6,29,7.846611283740738,5.36536396476057
D'Youville College,1734,1295,New York,Large City,private,98.58,88.9,99.98,3,1,6,1,1,3,4,2,9,4.072543452245776,0.1752001566179548
Earlham College,1061,1051,IndiaNA,Town,private,97.3,76.74,100.0,2,1,6,1,0,3,3,1,9,0.7016997309855553,2.894839220162378
East CaroliNA University,23267,19999,North CaroliNA,Small City,public,100.0,100.0,100.0,24,9,60,13,4,32,37,13,92,19.980057273764235,16.92749270092624
East Central University,3082,2551,Oklahoma,Town,NA,100.0,98.14,100.0,9,3,26,5,1,14,14,4,40,9.969082311928034,3.6171895342975353
East Stroudsburg University of Pennsylvania,6051,5552,Pennsylvania,Small City,public,100.0,99.96,100.0,11,5,25,6,3,13,17,8,38,7.517559842809675,8.91854040778479
East Tennessee State University,11319,9641,Tennessee,Small City,NA,100.0,99.94,100.0,19,5,57,9,2,29,28,7,86,20.78881499437364,7.306153683227878
East Texas Baptist University,1421,1216,Texas,Town,NA,100.0,100.0,100.0,23,7,60,12,4,32,35,11,92,34.315303774893046,0.5561627620675943
Eastern Connecticut State University,5069,4210,Connecticut,Town,public,94.53,83.45,99.58,2,1,4,1,1,2,3,2,6,1.7221349771619745,1.181537112950578
Eastern Illinois University,5569,4319,Illinois,Town,NA,99.89,96.74,100.0,5,2,11,2,1,6,7,3,17,6.197198526716189,0.6389409974598899
Eastern Kentucky University,14138,10744,Kentucky,Town,NA,100.0,100.0,100.0,23,8,63,12,4,33,35,12,96,29.257274908501095,4.953287866584588
Eastern Mennonite University,1102,942,Virginia,Small City,NA,99.81,86.35,100.0,4,1,9,2,1,5,6,2,14,4.863440995086752,1.3918825652110793
Eastern Michigan University,17218,12410,Michigan,Suburb,NA,100.0,100.0,100.0,37,13,106,20,6,59,57,19,165,50.95292675404623,6.104156467751885
Eastern Nazarene College,694,571,Massachusetts,Suburb,private,91.8,67.4,99.64,2,1,4,1,0,2,3,1,6,1.5157518890857458,0.9770993872918257
Eastern New Mexico University - Main Campus,4600,2590,New Mexico,Town,NA,100.0,99.96,100.0,21,5,69,11,3,38,32,8,107,14.437939996735116,17.791623714247923
Eastern Oregon University,2736,1668,Oregon,Town,public,99.99,97.08,100.0,6,2,24,4,1,12,10,3,36,3.6409405976076106,6.198517365138426
Eastern University,1882,1462,Pennsylvania,Suburb,NA,99.67,91.99,100.0,4,2,9,2,1,5,6,3,14,1.701304428110607,3.9884644038927166
Eastern Washington University,11474,10060,Washington,Town,NA,100.0,100.0,100.0,42,22,92,24,13,54,66,35,146,61.40127870689563,4.863666078220979
Eckerd College,2036,1915,Florida,Large City,private,100.0,98.93,100.0,7,3,18,4,2,10,11,5,28,5.484075781948297,5.840519272218727
Edgewood College,1566,1361,Wisconsin,Large City,NA,54.05,33.61,81.42,1,0,1,0,0,1,1,0,2,0.5760099645917336,0.20117575753621378
Edinboro University of Pennsylvania,4294,3888,Pennsylvania,Town,public,99.98,98.66,100.0,6,3,12,3,1,6,9,4,18,6.675043516030139,1.8823086071372066
Edward Waters College,3443,853,Florida,Large City,private,100.0,100.0,100.0,29,12,69,16,6,38,45,18,107,40.70073539791898,4.1727789966485
Elizabeth City State University,1365,1179,North CaroliNA,Town,NA,86.07,51.15,99.3,1,0,3,1,0,2,2,0,5,1.2169382017857993,0.7508865799265747
Elizabethtown College,1674,1636,Pennsylvania,Suburb,private,98.58,86.92,99.99,3,1,6,1,1,3,4,2,9,1.8441344491740905,2.4012966625745196
Elmhurst College,2874,2732,Illinois,Suburb,private,99.24,89.15,100.0,3,1,8,2,1,4,5,2,12,2.8017070431905235,2.069204163037608
Elmira College,936,833,New York,Small City,NA,90.83,67.49,99.5,2,1,3,1,0,2,3,1,5,1.139621486939763,1.2437042429906848
Elon University,6049,5885,North CaroliNA,Suburb,NA,100.0,99.98,100.0,14,6,34,8,3,19,22,9,53,1.5231612133462782,20.487742905796196
Embry Riddle AeroNAutical University - DaytoNA Beach,5733,5378,Florida,Small City,NA,100.0,100.0,100.0,28,11,69,15,6,38,43,17,107,24.381904490013373,18.95833492819903
Embry Riddle AeroNAutical University - Prescott,2607,2471,ArizoNA,Rural,NA,100.0,99.74,100.0,10,4,29,5,2,15,15,6,44,2.2806419943084206,12.989532312600858
Emerson College,3814,3748,Massachusetts,Large City,NA,100.0,99.92,100.0,11,5,28,6,2,15,17,7,43,2.9310119402210555,14.385869267924683
Emmanuel College Georgia,954,822,Georgia,Town,NA,99.27,79.0,100.0,3,1,10,2,1,5,5,2,15,1.6799562088981208,3.2048803809355673
Emmanuel College Massachusetts,1947,1804,Massachusetts,Large City,NA,99.87,95.18,100.0,4,2,10,2,1,5,6,3,15,5.267447172568697,1.3798474174078437
Emory and Henry College,999,966,Virginia,Rural,NA,99.82,84.91,100.0,4,1,9,2,1,5,6,2,14,4.688257014131655,1.5970109410848696
Emory University,6938,6794,Georgia,Large City,NA,100.0,100.0,100.0,27,10,73,14,5,40,41,15,113,4.502673327337405,36.73693938014776
Emporia State University,3605,3340,Kansas,Town,NA,99.5,82.6,100.0,3,1,8,2,1,4,5,2,12,1.8753387659876366,3.385918938208354
Endicott College,3348,2946,Massachusetts,Suburb,NA,99.99,98.37,100.0,6,3,13,3,1,7,9,4,20,6.594776865497375,2.3160589543607433
Erskine College,573,568,South CaroliNA,Rural,NA,99.99,97.98,100.0,6,3,14,3,1,8,9,4,22,9.001738373737231,0.5978954612559831
Eureka College,615,593,Illinois,Town,private,51.21,30.65,82.63,0,0,1,0,0,1,0,0,2,0.6825108509599327,0.034756862713227046
Evangel University,1632,1461,Missouri,Midsize City,NA,99.9,89.64,100.0,4,1,13,2,1,7,6,2,20,0.6436469100424455,6.165864476774243
Everglades University,2101,2099,Florida,Small City,NA,100.0,100.0,100.0,17,7,39,9,4,22,26,11,61,23.210980201435223,2.8255417023299483
Fairfield University,4118,3879,Connecticut,Suburb,private,100.0,99.58,100.0,8,4,17,4,2,9,12,6,26,0.419907805069707,11.327423651525265
Fairleigh Dickinson University - Florham Campus,2747,2640,New Jersey,Suburb,NA,100.0,99.8,100.0,9,4,23,5,2,12,14,6,35,12.323120704620218,1.7566730845279304
Fairleigh Dickinson University - Metropolitan Campus,5471,2374,New Jersey,Suburb,NA,100.0,100.0,100.0,19,8,46,10,4,24,29,12,70,25.914392533205827,2.797879980081067
Fairmont State University,3661,3108,West Virginia,Town,public,86.12,47.57,99.12,1,0,3,1,0,2,2,0,5,0.5492503889788333,1.417700953900775
Farmingdale State College,9552,7407,New York,Suburb,NA,100.0,100.0,100.0,16,8,32,8,4,17,24,12,49,23.453508869747328,0.10370789100152909
Faulkner University,2673,1744,Alabama,Midsize City,NA,100.0,99.43,100.0,10,3,25,5,2,13,15,5,38,8.892238972569924,5.999509109964318
Fayetteville State University,5394,3905,North CaroliNA,Midsize City,NA,99.91,92.89,100.0,5,2,12,2,1,6,7,3,18,5.064610457432076,1.9479720216651248
Felician University,1626,1430,New Jersey,Suburb,NA,99.98,97.91,100.0,6,3,14,3,1,7,9,4,21,8.408393321944443,0.3693298097260488
Ferris State University,12513,8469,Michigan,Town,public,100.0,100.0,100.0,27,9,77,14,5,43,41,14,120,40.24644003825587,1.5292792360380667
Ferrum College,1137,1118,Virginia,Rural,NA,99.98,91.04,100.0,5,2,11,3,1,7,8,3,18,7.58296374705636,0.6799773967181637
Finlandia University,399,336,Michigan,Town,NA,81.84,43.15,99.53,1,0,3,1,0,2,2,0,5,1.0801897800463223,0.6178496010928974
Fisk University,663,639,Tennessee,Large City,NA,95.15,62.32,99.98,2,1,5,1,0,3,3,1,8,0.5042259321525694,2.5000681483286575
Fitchburg State University,4119,3386,Massachusetts,Suburb,public,100.0,99.95,100.0,10,5,23,6,3,13,16,8,36,15.869336076339714,0.26995397003542243
Five Towns College,626,591,New York,Suburb,NA,80.7,56.59,96.9,1,1,2,1,0,1,2,1,3,1.3566922463568605,0.2861391978965804
Flagler College - St Augustine,2681,2591,Florida,Suburb,NA,100.0,100.0,100.0,18,7,41,10,4,23,28,11,64,22.840434540492772,4.5073015993281995
Florida Agricultural and Mechanical University,8027,6875,Florida,Midsize City,NA,100.0,100.0,100.0,68,28,157,36,15,87,104,43,244,96.31222819216225,7.305754245329586
Florida Atlantic University,25033,16325,Florida,Small City,public,100.0,100.0,100.0,227,97,521,121,50,288,348,147,809,340.50181875323847,7.643106931936928
Florida Gulf Coast University,13857,10973,Florida,Suburb,NA,100.0,100.0,100.0,125,53,288,67,27,160,192,80,448,188.37059219670516,4.063087676394981
Florida Institute of Technology,3634,3269,Florida,Small City,private,100.0,100.0,100.0,22,9,50,12,5,28,34,14,78,24.9599557210836,8.222863602387854
Florida InterNAtioNAl University,47621,26655,Florida,Suburb,public,100.0,100.0,100.0,447,190,1027,239,98,569,686,288,1596,678.2912432683781,7.823084899591881
Florida Memorial University,1173,1129,Florida,Suburb,private,100.0,99.84,100.0,10,4,23,5,2,13,15,6,36,14.673608173321119,0.5555638031173986
Florida Southern College,2615,2356,Florida,Midsize City,NA,100.0,100.0,100.0,17,7,40,9,4,22,26,11,62,23.685278647441564,2.9644369449587273
Florida State University,33009,29286,Florida,Midsize City,NA,100.0,100.0,100.0,301,127,693,161,65,384,462,192,1077,448.89383549212465,12.61143667539946
Fontbonne University,892,765,Missouri,Suburb,NA,77.62,38.11,98.92,1,0,3,0,0,2,1,0,5,0.8601149227221946,0.631339622053108
Fordham University,9595,9132,New York,Large City,NA,100.0,100.0,100.0,24,11,56,12,5,30,36,16,86,10.157924855450094,25.958588369742614
Fort Hays State University,12499,5889,Kansas,Town,NA,100.0,99.74,100.0,10,4,24,5,2,13,15,6,37,5.587196500067275,10.246059366328712
Fort Lewis College,3303,2921,Colorado,Town,public,99.96,91.86,100.0,5,2,16,3,1,8,8,3,24,1.6503392399261603,6.023979932360457
Fort Valley State University,2345,2115,Georgia,Town,NA,99.88,73.83,100.0,4,1,18,2,0,10,6,1,28,5.279164714589734,1.4025988855669669
Framingham State University,4128,3558,Massachusetts,Small City,public,100.0,99.96,100.0,11,5,23,6,3,13,17,8,36,16.606276221309578,0.1690226159676248
Francis Marion University,3462,3006,South CaroliNA,Suburb,public,100.0,100.0,100.0,44,18,101,24,10,55,68,28,156,67.9128872296531,0.6290257457753917
Franciscan University of Steubenville,2201,2011,Ohio,Small City,NA,99.99,97.16,100.0,6,2,15,3,1,8,9,3,23,0.7495039818240002,8.765623488059525
Franklin and Marshall College,2281,2263,Pennsylvania,Small City,NA,99.93,96.24,100.0,5,2,11,2,1,6,7,3,17,1.151680043258721,6.100373878048227
Franklin College,1017,962,IndiaNA,Suburb,private,94.85,76.41,99.86,2,1,4,1,0,2,3,1,6,2.59299978715756,0.3673739568949104
Franklin Pierce University,1712,1563,New Hampshire,Rural,NA,98.7,85.73,99.99,3,1,6,2,1,3,5,2,9,0.1635656654897865,4.1719631768578065
Welch College,344,222,Tennessee,Rural,private,64.7,29.43,94.69,1,0,2,0,0,1,1,0,3,0.31934309036329395,0.7175099204412944
Freed - Hardeman University,1469,1261,Tennessee,Town,NA,99.62,83.96,100.0,4,1,10,2,1,5,6,2,15,1.8404246523568784,3.700851751991251
Fresno Pacific University,2803,2342,California,Large City,private,100.0,99.94,100.0,11,5,27,6,2,14,17,7,41,16.20365058038763,0.42875668916872234
Friends University,1149,906,Kansas,Large City,NA,96.25,65.58,99.98,2,1,5,1,0,3,3,1,8,0.5132205633555206,2.740320917152621
Frostburg State University,4726,3849,Maryland,Suburb,public,100.0,99.48,100.0,8,3,18,4,2,10,12,5,28,11.055049081081119,0.9680787078952783
Full Sail University,16908,16908,Florida,Suburb,NA,100.0,100.0,100.0,88,34,219,47,17,119,135,51,338,62.10345277395504,73.04260567984265
Furman University,2732,2658,South CaroliNA,Suburb,NA,100.0,100.0,100.0,17,7,41,9,3,23,26,10,64,15.686400582936177,10.266416118462951
Gallaudet University,1125,1074,District of Columbia,Large City,NA,99.83,90.53,100.0,4,2,10,2,1,6,6,3,16,0.058588521355640674,6.283684761113851
Gannon University,3074,2530,Pennsylvania,Small City,private,99.8,95.45,100.0,4,2,9,2,1,5,6,3,14,4.051671863332487,2.1452161692598697
Gardner - Webb University,2218,1781,North CaroliNA,Town,NA,99.98,96.68,100.0,6,2,14,3,1,8,9,3,22,1.5022823716489728,7.230772765929972
Geneva College,1412,1247,Pennsylvania,Suburb,NA,96.77,80.26,99.96,2,1,5,1,1,3,3,2,8,1.784471275818458,1.6403024137265856
George Fox University,2700,2494,Oregon,Town,private,99.99,98.82,100.0,6,3,16,3,2,9,9,5,25,2.8903070635884567,6.489573953917702
George Mason University,25006,20221,Virginia,Suburb,NA,100.0,100.0,100.0,118,36,259,68,19,155,186,55,414,164.39765298486216,21.966555672142412
George Washington University,11996,10893,District of Columbia,Large City,NA,100.0,100.0,100.0,35,15,83,19,7,45,54,22,128,0.33444280940511556,53.167524386596135
Georgetown College,1059,976,Kentucky,Town,private,93.46,60.78,99.96,2,1,5,1,0,3,3,1,8,2.158007338314528,0.5636562671555188
Georgetown University,7465,6987,District of Columbia,Large City,private,100.0,100.0,100.0,23,9,56,12,5,30,35,14,86,0.27097191126983816,34.73797434059561
Georgia College & State University,5987,5442,Georgia,Town,NA,100.0,89.26,100.0,10,2,43,5,1,24,15,3,67,14.58241058072613,0.06308391228280041
Georgia Gwinnett College,12290,8289,Georgia,Suburb,public,100.0,99.26,100.0,20,3,89,10,2,50,30,5,139,29.69469107036344,0.9990035385428468
Georgia Institute of Technology - Main Campus,15576,13974,Georgia,Large City,NA,100.0,100.0,100.0,43,13,140,23,6,78,66,19,218,26.32745326212142,39.37533316269626
Georgia Southern University,17763,15755,Georgia,Town,NA,100.0,99.98,100.0,32,6,132,16,3,75,48,9,207,41.71077319825247,6.250478349221739
Georgia Southwestern State University,2604,1779,Georgia,Town,public,99.86,65.64,100.0,4,1,19,2,0,11,6,1,30,6.243674456616998,0.2928305141653952
Georgia State University,25771,19882,Georgia,Large City,NA,100.0,100.0,100.0,44,8,187,23,4,106,67,12,293,60.6713254687378,5.346543876989299
Georgian Court University,1612,1343,New Jersey,Small City,private,99.98,97.48,100.0,6,2,13,3,1,7,9,3,20,7.917673973975226,0.40146637895021686
Gettysburg College,2411,2404,Pennsylvania,Small City,NA,99.91,95.72,100.0,5,2,10,2,1,6,7,3,16,1.2004953669133294,5.769979256425181
Glenville State College,1655,1037,West Virginia,Town,NA,69.08,30.61,93.12,1,0,2,0,0,1,1,0,3,0.2385436439881499,0.9314733481792448
Goddard College,189,173,Vermont,Rural,NA,49.71,23.5,79.65,0,0,1,0,0,1,0,0,2,0.0,0.6854365966600926
Gonzaga University,5194,5106,Washington,Midsize City,private,100.0,100.0,100.0,19,8,70,11,4,36,30,12,106,14.06385212853944,15.815420976687209
Gordon College,1593,1528,Massachusetts,Suburb,NA,99.45,89.39,100.0,3,1,8,2,1,4,5,2,12,2.152200196105175,3.0241496727585417
Goshen College,888,816,IndiaNA,Small City,private,92.72,68.89,99.78,2,1,4,1,0,2,3,1,6,1.4362916368610585,1.1755197143327463
Goucher College,1534,1447,Maryland,Small City,NA,99.74,91.38,100.0,4,2,9,2,1,5,6,3,14,0.7155777851710469,5.198426948441477
Grace Bible College,873,822,Michigan,Small City,NA,96.25,68.26,99.99,2,1,6,1,0,3,3,1,9,2.395499733036481,0.8760227129632913
Grace College and Theological SemiNAry,1761,1439,IndiaNA,Town,private,99.33,89.69,100.0,3,2,7,2,1,4,5,3,11,2.5765536997125857,2.411588735287441
Graceland University - Lamoni,1405,1061,Iowa,Rural,private,100.0,98.73,100.0,8,3,20,4,1,10,12,4,30,1.0061762837489752,10.853230383745647
Grambling State University,4075,3734,LouisiaNA,Town,NA,100.0,100.0,100.0,22,8,59,12,4,31,34,12,90,12.95451207264156,21.21180757931744
Grand Canyon University,49564,15998,ArizoNA,Large City,NA,100.0,100.0,100.0,227,88,587,120,45,312,347,133,899,77.2738144457361,269.69341764622624
Grand Valley State University,21935,19373,Michigan,Suburb,NA,100.0,100.0,100.0,48,17,135,25,8,76,73,25,211,71.35045364160865,2.0389943590354473
Grand View University,1787,1574,Iowa,Midsize City,NA,99.99,89.27,100.0,6,1,19,3,1,10,9,2,29,4.06383421269725,4.944280357733284
Granite State College,1758,807,New Hampshire,Town,NA,56.27,0.0,93.49,1,0,2,0,0,1,1,0,3,0.8269153088650317,6.568952485451121e-05
Grantham University,7817,3296,Kansas,Suburb,NA,100.0,100.0,100.0,39,13,104,21,7,56,60,20,160,0.11874291121017608,59.8568420627032
Greensboro College,944,772,North CaroliNA,Large City,NA,97.86,76.23,99.99,2,1,6,1,0,3,3,1,9,0.5189883507615909,3.3052536875343845
Greenville University,988,887,Illinois,Town,NA,86.66,56.7,99.47,1,1,3,1,0,2,2,1,5,0.7052612126585971,1.300799534938015
Grinnell College,1717,1662,Iowa,Town,private,99.88,91.18,100.0,4,2,12,2,1,7,6,3,19,0.807735961120705,5.8843281352969266
Grove City College,2376,2315,Pennsylvania,Town,NA,99.89,94.05,100.0,4,2,11,2,1,6,6,3,17,1.8477503990744317,4.911391339084393
Guilford College,1669,1429,North CaroliNA,Large City,NA,99.47,85.47,100.0,3,1,8,2,1,4,5,2,12,0.805326751181779,4.404211402977269
Gustavus Adolphus College,2184,2150,Minnesota,Town,private,92.46,55.78,99.99,2,1,6,1,0,3,3,1,9,0.6029498097371908,1.9650553280399297
Gwynedd Mercy University,2081,1934,Pennsylvania,Suburb,private,99.17,90.57,100.0,3,2,7,2,1,4,5,3,11,3.0898291898416868,1.6950980067353931
Hamilton College,1894,1886,New York,Suburb,private,99.92,95.48,100.0,5,2,11,2,1,6,7,3,17,1.4750944787661866,5.568488975577227
Hamline University,2166,2082,Minnesota,Large City,NA,92.0,61.59,99.88,2,1,4,1,0,2,3,1,6,0.5739522235309246,1.9386134703017348
Hampden - Sydney College,1044,1039,Virginia,Rural,NA,99.94,88.97,100.0,5,1,11,3,1,6,8,2,17,5.947913258142118,1.4798054024116367
Hampshire College,1264,1268,Massachusetts,Suburb,private,99.42,87.46,100.0,3,1,9,2,1,5,5,2,14,0.9421109807853392,4.186459633959015
Hampton University,3796,3651,Virginia,Midsize City,NA,100.0,99.93,100.0,13,5,31,7,2,17,20,7,48,7.841568671323409,12.383785013406262
Hannibal - LaGrange University,913,706,Missouri,Town,NA,79.58,43.03,98.97,1,0,3,1,0,2,2,0,5,0.6885525084174998,0.8955974290011204
Hanover College,1096,1081,IndiaNA,Town,NA,96.39,76.83,99.96,2,1,5,1,0,3,3,1,8,1.8227746918179464,1.4890662020039656
Hardin - Simmons University,1741,1585,Texas,Midsize City,NA,100.0,100.0,100.0,28,9,76,15,5,41,43,14,117,43.378735153605255,0.33920510717889574
Harding University,4187,3945,Arkansas,Town,NA,100.0,99.99,100.0,20,6,53,11,3,28,31,9,81,1.2625883153490063,28.817477583571662
Harris - Stowe State University,1441,1163,Missouri,Large City,NA,81.74,42.07,99.52,1,0,4,1,0,2,2,0,6,1.4680676391844685,0.2313117456671243
Harrisburg University of Science and Technology,509,463,Pennsylvania,Small City,NA,62.77,39.51,88.42,1,0,1,0,0,1,1,0,2,0.8099727776764633,0.17718196436119227
Hartwick College,1198,1180,New York,Town,private,95.49,78.66,99.86,2,1,4,1,1,2,3,2,6,2.26444269482836,0.8284143088079707
Harvard University,9964,7147,Massachusetts,Midsize City,NA,100.0,100.0,100.0,34,13,89,18,7,47,52,20,136,6.217932473183239,46.38721307424976
Harvey Mudd College,867,844,California,Suburb,NA,99.04,84.87,100.0,3,1,7,2,1,4,5,2,11,2.1620620169237594,2.4622183227961116
Hastings College,1156,1073,Nebraska,Town,NA,63.16,30.71,93.36,1,0,2,0,0,1,1,0,3,0.10167359395039585,0.8907236838494244
Haverford College,1293,1294,Pennsylvania,Suburb,private,99.03,86.62,100.0,3,1,7,2,1,4,5,2,11,0.31820359123003916,4.299936068242499
Hawaii Pacific University,3565,2411,Hawaii,Large City,NA,99.99,97.21,100.0,6,2,16,3,1,9,9,3,25,0.00016599869146341253,9.281393276801305
Heidelberg University,1049,1031,Ohio,Town,NA,96.81,72.7,99.98,2,1,5,1,0,3,3,1,8,1.598292906694816,1.829895617230147
Henderson State University,2838,2565,Arkansas,Town,public,100.0,95.45,100.0,7,2,19,4,1,10,11,3,29,2.8434275809463876,7.7447994263760584
Hendrix College,1240,1228,Arkansas,Small City,NA,99.98,92.74,100.0,5,2,14,3,1,8,8,3,22,0.6908938810846533,7.687949118894999
Heritage University,812,734,Washington,Rural,private,99.05,92.37,99.99,3,2,6,2,1,4,5,3,10,4.647882754730983,0.0
Herzing University - Atlanta,593,365,Georgia,Large City,NA,76.54,19.69,99.88,1,0,4,0,0,2,1,0,6,1.4479855114485256,0.0
High Point University,4467,4418,North CaroliNA,Midsize City,NA,100.0,99.64,100.0,9,4,21,5,2,12,14,6,33,1.0518959293213854,12.766718336696504
Hilbert College,744,680,New York,Suburb,private,83.99,61.19,97.7,1,1,2,1,0,1,2,1,3,1.77603348613989,0.053504811270847455
Hiram College,1209,853,Ohio,Town,NA,95.66,70.75,99.95,2,1,5,1,0,3,3,1,8,2.007113260416998,1.1217287814193027
Hobart and William Smith Colleges,2239,2220,New York,Town,private,99.84,95.1,100.0,4,2,9,2,1,5,6,3,14,2.3039101056314686,4.094789234317703
Hodges University,1076,573,Florida,Suburb,NA,100.0,99.83,100.0,10,4,23,5,2,13,15,6,36,14.895935569886591,0.32081193581037154
Hofstra University,6863,6494,New York,Suburb,NA,100.0,100.0,100.0,14,7,32,7,3,17,21,10,49,9.139172314094852,12.764956470303417
Hollins University,647,632,Virginia,Suburb,NA,99.35,77.6,100.0,3,1,9,2,1,5,5,2,14,2.661128091651242,2.347387866105051
Holy Cross College,555,526,IndiaNA,Suburb,NA,81.7,53.9,98.1,1,1,3,1,0,1,2,1,4,0.8250453868228599,0.8681187955338916
Holy Family University,2095,1630,Pennsylvania,Large City,private,99.22,90.83,100.0,3,2,7,2,1,4,5,3,11,3.0645175405392973,1.7878030670462148
Holy Names University,591,543,California,Large City,private,96.11,75.8,99.97,2,1,5,1,0,3,3,1,8,3.065874827277135,0.1693983825366452
Hood College,1132,1048,Maryland,Small City,NA,97.2,76.47,99.99,2,1,6,1,0,3,3,1,9,2.051322984157001,1.5146354456554723
Hope College,3150,3019,Michigan,Small City,private,100.0,97.39,100.0,7,2,18,3,1,10,10,3,28,7.261465051352405,2.829520336245689
Hope InterNAtioNAl University,866,579,California,Suburb,NA,99.11,87.4,100.0,3,1,8,2,1,4,5,2,12,4.200071295171566,0.506642072563168
Houghton College,1036,971,New York,Rural,private,95.78,75.78,99.93,2,1,5,1,0,2,3,1,7,1.4997616105181295,1.6533995458380502
Houston Baptist University,2320,2098,Texas,Large City,NA,100.0,100.0,100.0,38,12,103,21,6,55,59,18,158,59.226642622162736,0.3394856980407602
Howard Payne University,980,860,Texas,Town,private,100.0,99.94,100.0,16,5,43,9,3,23,25,8,66,24.649389963491874,0.16950437595460338
Howard University,6354,6090,District of Columbia,Large City,NA,100.0,100.0,100.0,24,9,59,13,5,32,37,14,91,0.16844199889746694,35.94398402051513
Humboldt State University,7860,7270,California,Town,NA,100.0,100.0,100.0,30,13,76,15,7,40,45,20,116,41.32728379890334,3.6064040253343546
Humphreys University - Stockton and Modesto Campuses,324,208,California,Large City,NA,85.33,57.57,99.09,1,1,3,1,0,2,2,1,5,1.9139565395718527,0.0
Huntingdon College,1101,878,Alabama,Midsize City,private,99.85,91.3,100.0,4,2,10,2,1,6,6,3,16,3.5764109989868538,2.8865105730780063
Huntington University,1075,859,IndiaNA,Town,NA,95.44,75.64,99.92,2,1,5,1,0,2,3,1,7,1.9187102019136277,1.1605176648185411
Huston - Tillotson University,1052,1003,Texas,Large City,NA,100.0,99.97,100.0,17,5,47,10,3,25,27,8,72,26.71878614533657,0.14678627690979293
Idaho State University,10565,6279,Idaho,Small City,public,100.0,100.0,100.0,49,7,191,29,4,114,78,11,305,72.3313499720039,5.833171484496123
Illinois College,956,950,Illinois,Town,NA,79.7,49.79,98.52,1,0,3,1,0,1,2,0,4,0.9316273115603081,0.6583924970338583
Illinois Institute of Technology,2895,2631,Illinois,Large City,NA,99.76,92.05,100.0,4,2,10,2,1,5,6,3,15,2.4058507496337627,3.613168261218064
Illinois State University,18336,17165,Illinois,Suburb,NA,100.0,100.0,100.0,14,7,35,7,4,18,21,11,53,20.622065361754366,0.8375823487588908
Illinois Wesleyan University,1650,1646,Illinois,Small City,NA,88.75,63.97,99.62,1,1,4,1,0,2,2,1,6,1.6334759699641055,0.5468553922126137
Immaculata University,1481,885,Pennsylvania,Suburb,NA,97.6,83.42,99.98,2,1,6,1,1,3,3,2,9,1.8115909000710182,1.9104276277427075
IndiaNA State University,11578,9369,IndiaNA,Small City,public,100.0,100.0,100.0,20,10,43,11,5,23,31,15,66,27.835003000618414,2.6875993836377154
IndiaNA University - Bloomington,33427,32212,IndiaNA,Small City,public,100.0,100.0,100.0,62,30,139,33,15,75,95,45,214,63.03785317658516,31.87981707649772
IndiaNA University - East,3292,1887,IndiaNA,Rural,public,99.98,98.57,100.0,6,3,12,3,1,7,9,4,19,7.587128341281316,1.028024652333992
IndiaNA University - Kokomo,2877,2215,IndiaNA,Small City,NA,99.96,98.15,100.0,5,3,11,3,1,6,8,4,17,7.842042696678413,0.011877849503505122
IndiaNA University - Northwest,3700,2608,IndiaNA,Small City,NA,100.0,99.42,100.0,7,3,14,3,2,8,10,5,22,10.097897691214007,0.01820028935893154
IndiaNA University of Pennsylvania - Main Campus,10255,9526,Pennsylvania,Town,NA,100.0,100.0,100.0,14,7,30,7,4,16,21,11,46,16.93349338329856,4.22367447829472
IndiaNA University - Purdue University - Fort Wayne,9952,5913,IndiaNA,Large City,public,100.0,100.0,100.0,18,9,38,9,5,21,27,14,59,26.43982658236979,0.8849099335062907
IndiaNA University - Purdue University - IndiaNApolis,21615,17521,IndiaNA,Large City,NA,100.0,100.0,100.0,39,20,84,21,10,46,60,30,130,57.13096676926535,3.0865562109223297
IndiaNA University - South Bend,4877,3767,IndiaNA,Midsize City,NA,100.0,99.88,100.0,9,4,19,5,2,10,14,6,29,13.09656763534759,0.29918608889294157
IndiaNA University - Southeast,4824,3218,IndiaNA,Suburb,NA,100.0,99.77,100.0,8,4,19,4,2,10,12,6,29,10.221243347051312,2.6337417659107203
IndiaNA Wesleyan University,2803,2634,IndiaNA,Town,private,99.94,96.54,100.0,5,2,11,3,1,6,8,3,17,4.465112741310428,2.9104777328957185
Institute of American Indian and Alaska Native Culture and Arts Development,612,264,New Mexico,Rural,NA,95.2,49.81,100.0,2,0,11,1,0,5,3,0,16,1.027375059291487,1.9905681761675025
IoNA College,3177,2949,New York,Suburb,private,99.98,98.62,100.0,6,3,12,3,1,6,9,4,18,5.880644209663192,2.796618651364454
Iowa State University,30573,28743,Iowa,Small City,public,100.0,100.0,100.0,50,12,183,26,6,101,76,18,284,57.452665802066484,19.185532741747767
Iowa Wesleyan University,625,550,Iowa,Town,private,81.17,39.06,99.54,1,0,3,1,0,2,2,0,5,0.5729614949126108,1.089883650996035
Ithaca College,6062,5936,New York,Suburb,NA,100.0,99.98,100.0,13,6,28,7,3,15,20,9,43,6.267918178168696,12.816087473104957
Jackson State University,6498,5935,Mississippi,Midsize City,NA,100.0,100.0,100.0,46,19,103,24,10,54,70,29,157,57.65928441857399,11.857720122642037
Jacksonville State University,7492,5523,Alabama,Small City,NA,100.0,100.0,100.0,20,7,54,10,3,29,30,10,83,25.005179629927063,5.654123806713936
Jacksonville University,2878,2180,Florida,Large City,NA,100.0,100.0,100.0,21,9,49,11,5,27,32,14,76,28.22075753737718,4.002289925813986
James Madison University,19972,18905,Virginia,Small City,NA,100.0,100.0,100.0,88,27,192,50,15,114,138,42,306,117.13968859864183,20.529944606543378
University of Jamestown,916,871,North Dakota,Town,NA,99.99,80.25,100.0,6,1,28,3,1,15,9,2,43,6.4095713923743345,2.911806456328698
Jarvis Christian College,908,835,Texas,Rural,NA,100.0,99.86,100.0,14,4,38,8,2,20,22,6,58,21.42741869302482,0.33414542067247555
John Brown University,1972,1489,Arkansas,Town,NA,100.0,97.8,100.0,8,3,22,4,1,12,12,4,34,0.7476004140380001,11.59862308935744
John Carroll University,3079,2987,Ohio,Suburb,private,99.89,94.15,100.0,4,2,10,2,1,5,6,3,15,3.988918594175004,2.7801188719202004
Johns Hopkins University,6106,5668,Maryland,Large City,NA,100.0,100.0,100.0,18,7,44,9,4,24,27,11,68,1.8102862565204378,25.342277332250145
Johnson & Wales University - Providence,7717,7267,Rhode Island,Midsize City,private,100.0,100.0,100.0,16,7,36,8,4,19,24,11,55,0.43357253095071024,23.3689901746345
Johnson C Smith University,1395,1329,North CaroliNA,Large City,NA,99.95,94.69,100.0,5,2,12,3,1,6,8,3,18,0.5587575730421726,6.969473145906535
Johnson State College,1377,882,Vermont,Rural,NA,68.05,40.2,92.39,1,0,2,0,0,1,1,0,3,0.0020454358946077112,1.1360091353275892
Judson College,313,230,Alabama,Rural,NA,80.67,44.56,99.3,1,0,3,1,0,2,2,0,5,1.047892665183574,0.5888800903463784
Judson University,1078,761,Illinois,Midsize City,private,79.61,51.4,98.28,1,0,3,1,0,1,2,0,4,0.982815625382303,0.6040363576277011
Juniata College,1487,1400,Pennsylvania,Town,NA,98.15,83.69,99.99,3,1,6,1,1,3,4,2,9,1.6723768289078762,2.3027311588103596
Kalamazoo College,1434,1427,Michigan,Small City,NA,99.18,82.18,100.0,3,1,9,2,1,5,5,2,14,3.380278428409942,1.4068882666459197
Kansas State University,18484,16770,Kansas,Small City,NA,100.0,99.99,100.0,17,6,42,9,3,22,26,9,64,8.782979273887301,17.505386652150314
Kansas Wesleyan University,693,631,Kansas,Town,NA,99.54,80.87,100.0,3,1,9,2,1,5,5,2,14,0.2243555966615346,5.091049902884846
Kaplan University - Davenport Campus,25486,3127,Iowa,Midsize City,NA,100.0,100.0,100.0,109,39,298,58,20,159,167,59,457,2.076636052293024,165.46211294680722
Kean University,11985,9516,New Jersey,Suburb,NA,100.0,100.0,100.0,43,19,105,22,9,55,65,28,160,63.572967214438975,1.2428872490896234
Keene State College,3778,3624,New Hampshire,Town,NA,99.56,88.98,100.0,4,1,8,2,1,4,6,2,12,0.8211761627074953,4.589506633163225
Kent State University at Kent,23179,19108,Ohio,Suburb,public,100.0,100.0,100.0,32,13,75,16,6,40,48,19,115,38.96836676408055,8.886488392161858
Kentucky Christian University,589,439,Kentucky,Town,NA,83.69,49.32,99.13,1,0,3,1,0,2,2,0,5,0.7233544150774953,1.0843440267400581
Kentucky State University,1762,1122,Kentucky,Town,public,98.97,82.63,100.0,3,1,8,2,1,4,5,2,12,1.473231825374499,3.093665307527364
Kentucky Wesleyan College,716,673,Kentucky,Small City,private,87.95,54.24,99.68,1,1,4,1,0,2,2,1,6,1.174245333809134,0.9355336279470872
Kenyon College,1678,1661,Ohio,Town,NA,99.74,90.87,100.0,4,2,9,2,1,5,6,3,14,0.4905844244666183,5.451849308495961
Kettering University,1891,1807,Michigan,Small City,NA,99.9,91.31,100.0,4,2,12,2,1,7,6,3,19,4.324166658923605,2.5434691915789087
Keuka College,1645,1312,New York,Town,private,98.16,87.1,99.97,3,1,5,1,1,3,4,2,8,3.7124033286674094,0.2758639619778454
Keystone College,1454,1065,Pennsylvania,Suburb,private,95.17,78.04,99.86,2,1,4,1,1,2,3,2,6,2.1858417147563483,0.8413730623639338
King University,1798,1608,Tennessee,Small City,NA,99.96,89.82,100.0,5,2,13,3,1,7,8,3,20,2.243805398078934,5.490210285373237
King's College,2198,2025,Pennsylvania,Small City,NA,99.71,93.78,100.0,4,2,9,2,1,5,6,3,14,2.578172278943385,3.23425323515125
Knox College,1354,1334,Illinois,Town,private,94.5,68.29,99.96,2,1,5,1,0,3,3,1,8,0.8542760817848492,2.0359853656669022
Kutztown University of Pennsylvania,7489,7053,Pennsylvania,Town,NA,100.0,99.98,100.0,11,6,24,6,3,13,17,9,37,11.706637802355132,5.018774723830465
Kuyper College,182,146,Michigan,Suburb,NA,44.56,18.08,81.88,0,0,1,0,0,1,0,0,2,0.5452061981306358,0.04364197360793133
La Roche College,1379,1163,Pennsylvania,Suburb,NA,92.38,73.16,99.62,2,1,4,1,0,2,3,1,6,2.1966895644573725,0.37512152731949533
La Salle University,3822,3322,Pennsylvania,Large City,NA,100.0,99.39,100.0,7,3,16,4,2,9,11,5,25,4.185462009645117,6.608655333202157
La Sierra University,2027,1830,California,Large City,private,100.0,99.47,100.0,8,3,20,4,2,10,12,5,30,11.194282847187225,0.654190609044412
Lafayette College,2590,2551,Pennsylvania,Suburb,NA,99.99,98.45,100.0,6,3,15,3,1,8,9,4,23,0.9726905231918241,8.522331178454808
LaGrange College,940,888,Georgia,Town,NA,96.72,58.77,100.0,2,1,8,1,0,4,3,1,12,1.9632046394681526,1.4422853363382868
Lake Erie College,959,724,Ohio,Suburb,private,93.58,65.31,99.89,2,1,4,1,0,2,3,1,6,1.2945977867869094,1.440346972146094
Lake Forest College,1505,1487,Illinois,Suburb,NA,97.28,78.63,99.99,2,1,6,1,1,3,3,2,9,0.9430024924096404,2.6487230325761435
Lake Superior State University,1962,1706,Michigan,Town,public,99.89,90.23,100.0,4,2,12,2,1,7,6,3,19,6.181275271306084,0.6533457758139221
Lakeland University,1997,779,Wisconsin,Rural,private,86.04,54.88,99.4,1,1,3,1,0,2,2,1,5,0.6593798278879055,1.3016979643753617
Lamar University,9270,5967,Texas,Midsize City,NA,100.0,100.0,100.0,154,46,413,85,25,222,239,71,635,237.71861202836214,0.8489971105726916
Lander University,2785,2600,South CaroliNA,Town,NA,100.0,100.0,100.0,36,15,81,19,8,44,55,23,125,54.01043024242338,0.9828490102930263
Lane College,1416,1370,Tennessee,Small City,NA,97.64,66.71,100.0,2,1,7,1,0,4,3,1,11,1.9664811353950207,1.7691548701876165
Langston University,2028,1822,Oklahoma,Rural,NA,100.0,97.34,100.0,7,2,21,4,1,12,11,3,33,3.9279419295105296,7.448201031382396
Lasell College,1733,1669,Massachusetts,Small City,NA,99.5,91.26,100.0,3,2,7,2,1,4,5,3,11,4.325336191783357,0.9526408811014682
Lawrence Technological University,2191,1672,Michigan,Small City,NA,99.95,92.44,100.0,5,2,14,3,1,8,8,3,22,6.873005635184327,0.6518228749235424
Lawrence University,1471,1434,Wisconsin,Small City,private,93.52,68.91,99.87,2,1,4,1,0,2,3,1,6,0.18828026543441706,2.5363015520798964
Le Moyne College,2793,2410,New York,Suburb,NA,99.94,97.58,100.0,5,2,10,2,1,5,7,3,15,6.225984054190393,1.108779876803635
Le Moyne - Owen College,867,770,Tennessee,Large City,private,87.86,42.63,99.88,1,0,4,1,0,2,2,0,6,1.657642751951572,0.4456050911742307
Lebanon Valley College,1756,1624,Pennsylvania,Suburb,private,98.38,86.57,99.99,3,1,6,1,1,3,4,2,9,2.3304797107700024,1.7878459955025008
Lee University,4856,3854,Tennessee,Small City,NA,100.0,99.68,100.0,12,4,35,6,2,18,18,6,53,4.781742589913533,13.205821064543436
Lees - McRae College,920,891,North CaroliNA,Rural,NA,98.46,79.77,100.0,3,1,7,1,1,4,4,2,11,0.4931383562792128,3.651758301783235
Lehigh University,5065,5013,Pennsylvania,Small City,NA,100.0,99.97,100.0,12,5,30,6,3,16,18,8,46,2.142450315952252,16.382230706829116
Lenoir - Rhyne University,1698,1441,North CaroliNA,Small City,private,98.78,81.56,100.0,3,1,7,2,1,4,5,2,11,1.2775862657636865,3.1077725929362225
Lesley University,2097,1645,Massachusetts,Midsize City,private,99.89,94.88,100.0,4,2,10,2,1,6,6,3,16,3.814502682201973,2.981088240276748
LeTourneau University,2606,1301,Texas,Small City,NA,100.0,100.0,100.0,34,10,92,18,5,49,52,15,141,48.69629749429479,3.2326279001261216
Lewis & Clark College,2113,2067,Oregon,Large City,NA,99.99,98.08,100.0,6,3,17,3,1,9,9,4,26,0.5740138789558233,9.142385940541395
Lewis - Clark State College,3746,2215,Idaho,Small City,NA,100.0,99.18,100.0,17,3,65,10,2,38,27,5,103,22.600344906763944,4.246551738250794
Lewis University,4502,3687,Illinois,Suburb,private,99.71,94.33,100.0,4,2,9,2,1,5,6,3,14,4.791226173738727,1.030421748057167
Liberty University,45756,26892,Virginia,Small City,NA,100.0,100.0,100.0,187,65,453,102,34,253,289,99,706,103.57544321611856,185.43511901737264
Life University,760,624,Georgia,Small City,NA,93.41,52.94,100.0,2,1,7,1,0,4,3,1,11,1.1256683318343512,1.5823341198971672
Limestone College,2599,1943,South CaroliNA,Town,private,100.0,100.0,100.0,26,11,59,14,6,32,40,17,91,36.04796369255137,3.4338048883729755
Lincoln Memorial University,1923,1355,Tennessee,Town,NA,99.71,80.28,100.0,4,1,12,2,1,6,6,2,18,2.949721703092531,2.8567878303990937
Lincoln University California,107,72,California,Large City,private,46.95,24.66,78.84,0,0,1,0,0,1,0,0,2,0.6320782399203341,0.0
Lincoln University Missouri,2513,1804,Missouri,Small City,NA,99.32,81.12,100.0,3,1,10,2,1,5,5,2,15,2.0599003972556975,2.914690039345227
Lincoln University of Pennsylvania,2002,1826,Pennsylvania,Suburb,NA,99.69,93.09,100.0,4,2,9,2,1,5,6,3,14,1.3686370372792025,4.391846510965239
Lindenwood University,6931,6215,Missouri,Small City,private,100.0,99.43,100.0,11,3,34,5,2,17,16,5,51,5.633925457670278,10.296827074103078
Lindsey Wilson College,2071,1919,Kentucky,Town,NA,99.48,83.58,100.0,3,1,10,2,1,5,5,2,15,4.4100507505891295,0.8439911661335645
Linfield College - McMinnville Campus,1536,1505,Oregon,Town,NA,99.69,92.24,100.0,4,2,12,2,1,6,6,3,18,1.5730188029077852,4.1807793999964025
Lipscomb University,2994,2723,Tennessee,Large City,NA,100.0,95.16,100.0,7,2,19,3,1,10,10,3,29,4.138854526419007,5.758640351549091
Livingstone College,1153,1140,North CaroliNA,Suburb,private,98.34,80.55,99.99,3,1,6,1,1,3,4,2,9,0.6959613899101793,3.3793049985969543
Lock Haven University,3471,3176,Pennsylvania,Town,public,99.91,97.19,100.0,5,2,10,2,1,5,7,3,15,5.734896541941387,1.308082208994409
LIU Brooklyn,3947,3396,New York,Large City,NA,100.0,99.64,100.0,8,4,18,4,2,9,12,6,27,7.812080625840323,3.9674614171618634
LIU Post,6317,2845,New York,Suburb,private,100.0,99.98,100.0,12,6,24,6,3,13,18,9,37,13.93692943984775,3.4966755929965383
Longwood University,4469,3959,Virginia,Town,NA,100.0,100.0,100.0,23,7,50,13,4,30,36,11,80,36.079557982418876,0.5489656512666561
Loras College,1395,1335,Iowa,Small City,NA,91.04,53.85,99.97,2,1,5,1,0,3,3,1,8,1.3136190371167176,1.0947762583873524
LouisiaNA College,985,866,LouisiaNA,Suburb,NA,99.89,90.86,100.0,4,2,12,2,1,6,6,3,18,5.3520441416223905,1.3908756373273892
LouisiaNA State University - Alexandria,3372,1844,LouisiaNA,Rural,public,100.0,99.94,100.0,13,5,35,7,2,19,20,7,54,18.95952891999566,1.3649302007387816
LouisiaNA State University and Agricultural & Mechanical College,25448,22060,LouisiaNA,Midsize City,NA,100.0,100.0,100.0,144,50,380,77,25,203,221,75,583,108.69663505055321,112.22224447534144
LouisiaNA State University - Shreveport,2641,1641,LouisiaNA,Midsize City,public,100.0,99.83,100.0,12,4,31,6,2,16,18,6,47,13.916480790907022,3.9305560781406217
LouisiaNA Tech University,11323,8090,LouisiaNA,Town,NA,100.0,100.0,100.0,51,18,136,27,9,73,78,27,209,58.98908782672696,19.526283630601903
Lourdes University,1046,827,Ohio,Suburb,NA,90.47,59.07,99.69,2,1,4,1,0,2,3,1,6,1.7676613389511484,0.578319140986893
Loyola Marymount University,6395,6164,California,Large City,NA,100.0,100.0,100.0,26,11,68,13,5,35,39,16,103,26.789484280735657,12.223223334416126
Loyola University Maryland,3927,3886,Maryland,Large City,private,100.0,99.78,100.0,9,4,22,5,2,11,14,6,33,1.6646599002400142,12.064208396932106
Loyola University Chicago,11426,10681,Illinois,Large City,private,100.0,99.99,100.0,15,7,40,8,3,21,23,10,61,7.664596856280045,15.599411365703798
Loyola University New Orleans,2607,2446,LouisiaNA,Large City,private,100.0,99.84,100.0,12,4,29,6,2,16,18,6,45,6.529727057317078,11.109303979319272
Lubbock Christian University,1482,1276,Texas,Large City,NA,100.0,100.0,100.0,23,7,62,13,4,33,36,11,95,35.101150426226475,0.4909725989801828
Luther College,2046,2014,Iowa,Town,NA,96.0,58.82,100.0,2,1,7,1,0,4,3,1,11,1.707704748251733,1.5025024663562319
Lycoming College,1222,1199,Pennsylvania,Small City,private,96.12,78.34,99.94,2,1,5,1,1,3,3,2,8,1.3270536134252768,1.9141073987396056
University of Lynchburg,2051,1928,Virginia,Small City,private,100.0,98.31,100.0,8,3,19,5,1,11,13,4,30,11.028248705839943,2.2376298497704474
Lyndon State College,1069,871,Vermont,Town,NA,55.17,28.57,84.25,1,0,1,0,0,1,1,0,2,0.001528980319889485,0.797853107400282
Lynn University,2205,1826,Florida,Small City,NA,100.0,99.89,100.0,11,5,27,6,2,15,17,7,42,10.227060242011689,6.534560478642758
Lyon College,670,652,Arkansas,Town,NA,91.33,50.61,99.88,2,0,4,1,0,2,3,0,6,0.6307155195831425,1.7922421359807679
Macalester College,2138,2093,Minnesota,Large City,NA,99.87,92.67,100.0,4,2,12,2,1,6,6,3,18,0.11165737217355384,6.534003255698455
MadonNA University,2455,1358,Michigan,Small City,NA,99.98,94.29,100.0,6,2,16,3,1,9,9,3,25,8.24283620798755,0.2063147887167542
Maharishi University of MaNAgement,325,261,Iowa,Town,NA,73.39,36.77,97.79,1,0,2,0,0,1,1,0,3,0.30185288512469255,1.0157552478173595
Maine Maritime Academy,1021,989,Maine,Rural,NA,75.15,34.22,97.12,1,0,2,0,0,1,1,0,3,0.6216446675485998,0.7661614635433704
Malone University,1334,1099,Ohio,Small City,NA,96.06,71.42,99.96,2,1,5,1,0,3,3,1,8,2.2017896193323225,1.0234184221519804
Manchester University,1264,1244,IndiaNA,Town,NA,97.44,82.77,99.99,2,1,6,1,1,3,3,2,9,3.124756614545051,0.5315253098219909
Manhattan College,3666,3479,New York,Large City,NA,100.0,99.56,100.0,8,4,17,4,2,9,12,6,26,6.272851604519085,5.073357426242443
Manhattanville College,1731,1633,New York,Suburb,NA,99.68,92.43,100.0,4,2,9,2,1,5,6,3,14,2.400111919464046,3.33311981183566
Mansfield University of Pennsylvania,1827,1655,Pennsylvania,Town,NA,97.04,84.06,99.94,2,1,5,1,1,3,3,2,8,2.7607777489106238,0.7558897636198977
MaraNAtha Baptist University,933,591,Wisconsin,Town,NA,94.46,62.18,99.99,2,1,6,1,0,3,3,1,9,0.09892691912655811,2.775807939109858
Marian University IndiaNA,2301,1961,IndiaNA,Large City,NA,99.85,95.86,100.0,4,2,9,2,1,5,6,3,14,5.588928716716981,0.8764366537727126
Marian University Wisconsin,1508,1254,Wisconsin,Small City,NA,52.82,32.94,80.34,0,0,1,0,0,1,0,0,2,0.5265465050284545,0.22436240866419785
Marietta College,1063,960,Ohio,Town,NA,93.68,66.52,99.87,2,1,4,1,0,2,3,1,6,1.347160403694047,1.4039808764352968
Marist College,5697,5085,New York,Suburb,private,100.0,99.98,100.0,12,6,27,6,3,14,18,9,41,7.340938409378213,10.51502123286516
Marquette University,8334,8026,Wisconsin,Large City,NA,100.0,99.36,100.0,7,3,18,4,2,9,11,5,27,1.1248948061971529,9.982311372160472
Mars Hill University,1265,1199,North CaroliNA,Suburb,private,99.2,83.74,100.0,3,1,8,2,1,4,5,2,12,0.8202402095369971,3.975655204076179
Marshall University,9492,7846,West Virginia,Small City,NA,100.0,97.07,100.0,7,2,15,3,1,8,10,3,23,1.1442311026379237,8.824474427577526
Martin Luther College,896,743,Minnesota,Town,private,85.28,53.7,99.12,1,1,3,1,0,2,2,1,5,0.036330309154977224,1.8672030514833258
Martin Methodist College,979,810,Tennessee,Town,NA,91.53,48.24,99.96,2,0,5,1,0,3,3,0,8,1.8614340661965687,0.6008236018671376
Martin University,263,159,IndiaNA,Large City,NA,51.42,30.69,78.57,0,0,1,0,0,1,0,0,2,0.7208868330046916,0.0
Mary Baldwin University,1133,720,Virginia,Small City,private,99.95,90.37,100.0,5,2,11,3,1,6,8,3,17,5.981281635466898,1.6386104901550027
Marymount Manhattan College,2149,1915,New York,Large City,private,99.99,98.09,100.0,6,3,14,3,1,8,9,4,22,1.850034881395719,7.465461572910762
Marymount University,2306,2069,Virginia,Midsize City,NA,100.0,98.86,100.0,9,3,20,5,2,12,14,5,32,10.352539065013138,3.68194870308653
Maryville College,1184,1158,Tennessee,Suburb,NA,98.85,75.26,100.0,3,1,9,1,0,5,4,1,14,1.7942039419095595,2.654604029012712
Maryville University of Saint Louis,3184,2375,Missouri,Suburb,private,99.61,84.43,100.0,4,1,11,2,1,5,6,2,16,2.761118587266161,2.7693779602250177
Marywood University,1957,1756,Pennsylvania,Small City,NA,99.37,91.46,100.0,3,2,7,2,1,4,5,3,11,2.3485594602717095,2.701351046557912
Massachusetts College of Liberal Arts,1407,1201,Massachusetts,Town,public,99.49,91.88,100.0,3,2,7,2,1,4,5,3,11,4.622624545720065,0.6520884437918586
Massachusetts Institute of Technology,4551,4510,Massachusetts,Midsize City,private,100.0,100.0,100.0,18,7,44,10,4,24,28,11,68,2.043334038325536,25.526751344966318
Massachusetts Maritime Academy,1687,1607,Massachusetts,Suburb,NA,99.9,95.61,100.0,4,2,10,2,1,5,6,3,15,5.280008652312501,1.6134510309400647
Mayville State University,1097,600,North Dakota,Rural,NA,100.0,90.28,100.0,9,2,32,5,1,19,14,3,51,11.802006770341658,1.5933053549099203
McDaniel College,1588,1543,Maryland,Suburb,private,98.42,83.64,100.0,3,1,6,1,1,3,4,2,9,3.7963284602758693,0.3471263518110026
McKendree University,2103,1692,Illinois,Suburb,NA,94.41,74.87,99.92,2,1,5,1,0,2,3,1,7,2.0998583847867263,0.7802413445981177
McMurry University,1106,956,Texas,Midsize City,private,100.0,99.98,100.0,18,5,49,10,3,26,28,8,75,27.81897145720337,0.2778468808677377
McNeese State University,6924,5567,LouisiaNA,Small City,NA,100.0,100.0,100.0,31,11,82,17,6,44,48,17,126,37.70334364256209,10.225485130328089
McPherson College,723,673,Kansas,Town,private,98.56,72.63,100.0,3,1,7,1,0,4,4,1,11,0.20094954204799026,3.9962043363458126
Medaille College,1526,1426,New York,Large City,NA,97.91,86.29,99.97,3,1,5,1,1,3,4,2,8,3.672935917864301,0.19015552380115874
Menlo College,746,728,California,Suburb,private,99.06,85.27,100.0,3,1,9,2,1,4,5,2,13,3.449847589845562,1.1933844522527033
Mercer University,4746,4135,Georgia,Midsize City,NA,100.0,97.61,100.0,10,2,39,5,1,22,15,3,61,9.6475392170879,5.894527409505816
Mercy College,6862,5055,New York,Suburb,private,100.0,99.99,100.0,12,6,24,6,3,13,18,9,37,15.486025313869765,2.184004269224884
Mercyhurst University,2452,2373,Pennsylvania,Small City,NA,99.59,92.8,100.0,4,2,8,2,1,4,6,3,12,2.5456287298403133,2.947002716364641
Meredith College,1682,1600,North CaroliNA,Large City,NA,93.52,63.47,99.9,2,1,4,1,0,2,3,1,6,1.4833919910656965,1.2453259992359222
Merrimack College,3535,3323,Massachusetts,Suburb,NA,100.0,99.69,100.0,8,4,18,4,2,10,12,6,28,10.430215347272355,2.165211133584436
Colorado Mesa University,9461,7145,Colorado,Small City,public,100.0,97.91,100.0,9,3,28,4,1,15,13,4,43,6.29447889026638,6.672567295409002
Messiah College,2760,2637,Pennsylvania,Suburb,private,99.92,96.32,100.0,5,2,10,2,1,6,7,3,16,2.818632947316085,4.279371369839937
Methodist University,1938,1755,North CaroliNA,Midsize City,NA,99.95,94.43,100.0,5,2,12,3,1,6,8,3,18,1.1513189850228396,6.3809509720144195
Metropolitan College of New York,777,681,New York,Large City,NA,85.85,63.63,98.21,1,1,3,1,0,1,2,1,4,1.8870355790236333,0.06616440646775956
Metropolitan State University of Denver,19668,12759,Colorado,Large City,public,100.0,99.03,100.0,11,3,37,6,2,20,17,5,57,14.968229059452069,1.6121927770649194
Metropolitan State University,7317,2878,Minnesota,Large City,NA,91.28,66.9,99.68,2,1,4,1,0,2,3,1,6,2.438796991623563,0.0
Miami University - Oxford,17153,16619,Ohio,Town,NA,100.0,100.0,100.0,25,10,61,13,5,33,38,15,94,22.831643373589284,15.653538039649698
Michigan State University,38997,35404,Michigan,Small City,NA,100.0,100.0,100.0,90,31,250,48,16,140,138,47,390,118.35404299794608,19.066995760305087
Michigan Technological University,5886,5492,Michigan,Town,NA,100.0,99.69,100.0,11,4,31,6,2,17,17,6,48,15.592897266536184,1.2227847907017177
Mid - America Christian University,1622,1170,Oklahoma,Large City,private,100.0,96.03,100.0,7,2,21,4,1,11,11,3,32,3.2281164678335443,7.472223752964722
Mid - Atlantic Christian University,192,166,North CaroliNA,Town,private,38.9,14.69,68.37,0,0,1,0,0,0,0,0,1,0.11433651405667232,0.3768145082344825
MidAmerica Nazarene University,1311,998,Kansas,Suburb,NA,96.07,62.4,100.0,2,1,7,1,0,4,3,1,11,0.34195674911007434,2.8732689156708244
Middle Tennessee State University,19520,15812,Tennessee,Midsize City,public,100.0,100.0,100.0,30,8,95,14,3,48,44,11,143,38.98927020369743,5.3511273841912335
Middlebury College,2547,2528,Vermont,Town,NA,100.0,97.93,100.0,7,3,22,4,1,11,11,4,33,0.0002808793476537721,10.170384197777015
Midland University,1660,1187,Nebraska,Town,NA,96.73,71.04,99.99,2,1,6,1,0,3,3,1,9,0.13863418344934478,3.2580103203693564
Midway University,1003,760,Kentucky,Rural,private,92.9,59.91,99.95,2,1,5,1,0,3,3,1,8,2.1869415149176277,0.4536433988189863
Midwestern State University,5328,4199,Texas,Midsize City,public,100.0,100.0,100.0,87,26,235,48,14,126,135,40,361,134.03924382910512,0.89096473764653
Miles College,1654,1555,Alabama,Suburb,private,99.91,91.8,100.0,5,2,12,2,1,6,7,3,18,3.7842925398532308,3.1686214041429843
Millersville University of Pennsylvania,6756,5671,Pennsylvania,Suburb,NA,100.0,99.88,100.0,9,4,19,4,2,10,13,6,29,11.464369159032263,1.6748022331783878
Millikin University,1951,1840,Illinois,Small City,private,94.33,72.83,99.94,2,1,5,1,0,3,3,1,8,1.9280931539618098,0.9346494127287266
Mills College,764,739,California,Large City,private,98.8,85.27,100.0,3,1,7,1,1,4,4,2,11,3.585714875062082,0.8181443879230115
Millsaps College,808,797,Mississippi,Midsize City,NA,99.98,96.08,100.0,6,2,13,3,1,7,9,3,20,4.0904636820317934,4.379845122268346
Milwaukee School of Engineering,2607,2508,Wisconsin,Large City,private,92.47,66.05,99.97,2,1,5,1,0,3,3,1,8,0.7156245681977631,1.8590735075008422
Minnesota State University - Mankato,12781,10832,Minnesota,Small City,NA,99.93,94.82,100.0,5,2,12,2,1,6,7,3,18,3.6516960284580775,3.5778378640147688
Minnesota State University - Moorhead,5126,4157,Minnesota,Suburb,NA,100.0,98.22,100.0,14,3,50,8,1,29,22,4,79,1.174568894148071,19.948194481608894
Minot State University,2959,1952,North Dakota,Town,public,100.0,99.93,100.0,30,5,136,17,2,74,47,7,210,39.684449577975094,7.020871638753207
Misericordia University,2148,1660,Pennsylvania,Suburb,private,99.36,91.74,100.0,3,2,7,2,1,4,5,3,11,2.818632947316085,2.2230475045999745
Mississippi College,3246,2793,Mississippi,Suburb,private,100.0,100.0,100.0,25,10,57,13,5,30,38,15,87,28.050828759893523,10.019524682713817
Mississippi State University,18312,16803,Mississippi,Town,public,100.0,100.0,100.0,127,53,285,65,27,149,192,80,434,163.0361302669427,28.68891269469901
Mississippi University for Women,2577,2113,Mississippi,Town,NA,100.0,100.0,100.0,20,9,44,10,4,23,30,13,67,27.495500909021658,2.866968555788194
Mississippi Valley State University,1974,1667,Mississippi,Town,public,100.0,99.99,100.0,15,7,33,8,3,18,23,10,51,20.750299208187773,2.2226986302784537
Missouri Baptist University,4507,1519,Missouri,Suburb,NA,99.99,94.86,100.0,6,2,17,3,1,9,9,3,26,4.26142614323272,4.74392828458032
Missouri Southern State University,6025,4358,Missouri,Small City,NA,99.99,94.0,100.0,6,2,18,3,1,9,9,3,27,5.902207622321244,3.0146715801397184
Missouri State University - Springfield,20365,15363,Missouri,Midsize City,NA,100.0,99.98,100.0,19,6,58,9,3,29,28,9,87,21.342824909743772,6.8315615998390555
Missouri Valley College,1793,1296,Missouri,Town,NA,99.35,81.43,100.0,3,1,9,2,1,5,5,2,14,1.5555759847358566,3.453658463014581
Missouri Western State University,5290,3498,Missouri,Small City,NA,99.83,85.06,100.0,4,1,14,2,1,7,6,2,21,5.697253865635099,0.6499676384016307
Mitchell College,706,575,Connecticut,Small City,NA,74.41,48.7,94.91,1,0,2,0,0,1,1,0,3,0.1256792121630973,1.2343575043405852
Molloy College,3534,2800,New York,Suburb,private,99.98,98.94,100.0,6,3,12,3,2,6,9,5,18,8.69516394255988,0.049623304850819665
Monmouth College,1035,1016,Illinois,Town,NA,73.37,46.75,96.58,1,0,2,0,0,1,1,0,3,1.105667578555091,0.21559276984119946
Monmouth University,4708,4502,New Jersey,Suburb,NA,100.0,100.0,100.0,16,7,38,8,3,20,24,10,58,21.420726593937157,2.006966117728227
MontaNA State University,14652,12403,MontaNA,Town,NA,100.0,99.98,100.0,191,6,2090,97,3,934,288,9,3024,265.9001865634684,22.351461222457832
MontaNA State University - Billings,4022,2400,MontaNA,Midsize City,public,100.0,38.97,100.0,73,0,846,37,0,376,110,0,1222,109.32020341346806,1.3147967040882567
MontaNA State University - Northern,1164,855,MontaNA,Town,NA,100.0,24.79,100.0,21,0,237,11,0,106,32,0,343,30.65417921803081,0.5858358483838452
MontaNA Tech of the University of MontaNA,1657,1529,MontaNA,Town,NA,100.0,51.7,100.0,29,0,321,15,0,143,44,0,464,40.9725143228243,2.4068611594922347
Montclair State University,16852,14944,New Jersey,Suburb,NA,100.0,100.0,100.0,61,27,149,31,13,77,92,40,226,90.44674364142732,1.3160776609856168
Montreat College,757,543,North CaroliNA,Suburb,NA,90.31,55.62,99.79,2,1,4,1,0,2,3,1,6,0.5398671924588963,1.779484362719833
Moravian College,2083,1886,Pennsylvania,Small City,private,99.86,95.3,100.0,4,2,10,2,1,5,6,3,15,2.165953990304471,4.416636372971631
Morehead State University,9660,5835,Kentucky,Town,NA,100.0,99.98,100.0,16,6,45,8,3,24,24,9,69,18.77828061541178,5.778748035863695
Morehouse College,2202,2090,Georgia,Large City,private,100.0,97.54,100.0,7,2,20,4,1,11,11,3,31,1.6140276948861305,9.574534511367375
Morgan State University,6436,5825,Maryland,Large City,public,100.0,99.98,100.0,13,6,29,7,3,16,20,9,45,11.263445418516898,8.163995888742784
Morningside College,1322,1252,Iowa,Small City,NA,93.43,47.72,100.0,2,0,6,1,0,4,3,0,10,2.157689141817247,0.5603506023845646
Morris College,745,731,South CaroliNA,Small City,private,100.0,99.49,100.0,8,3,19,5,2,10,13,5,29,12.405584774740374,0.4855858664509509
Mount Aloysius College,1689,999,Pennsylvania,Town,NA,96.28,81.23,99.92,2,1,5,1,1,2,3,2,7,2.8584083962198403,0.4290449078551893
Mount Holyoke College,2213,2161,Massachusetts,Suburb,NA,99.99,98.02,100.0,6,3,15,3,1,8,9,4,23,1.9512165202043026,7.256179143382444
Mount Marty College,875,457,South Dakota,Town,private,88.26,61.26,99.05,1,1,3,1,0,2,2,1,5,1.59237688476378,0.544685829716913
Mount Mary University,700,624,Wisconsin,Large City,private,25.31,14.99,44.4,0,0,0,0,0,0,0,0,0,0.2724479264654806,0.01933780744386476
Mount Mercy University,1517,1083,Iowa,Midsize City,NA,98.86,58.11,100.0,3,1,11,2,0,6,5,1,17,3.9855760572945513,0.4816647271181607
University of Mount Olive,3206,1472,North CaroliNA,Town,private,99.73,87.96,100.0,4,1,10,2,1,5,6,2,15,2.8285859347063718,3.0462149471869138
Mount Saint Mary College,2036,1737,New York,Suburb,private,99.4,92.52,100.0,3,2,7,2,1,4,5,3,11,3.9862084911139757,1.12784805549948
Mount Saint Mary's University,2603,2056,California,Large City,NA,100.0,99.89,100.0,10,5,25,5,2,13,15,7,38,14.93358682727668,0.4659713614359806
Mount St Mary's University,1815,1696,Maryland,Town,private,99.72,91.34,100.0,4,2,10,2,1,5,6,3,15,2.1843953442063535,3.6904860214376978
Mount Vernon Nazarene University,1829,1440,Ohio,Town,NA,97.46,76.2,99.99,2,1,6,1,0,3,3,1,9,3.1303958513584216,0.5388595821382695
Muhlenberg College,2369,2279,Pennsylvania,Midsize City,NA,99.97,97.74,100.0,5,3,13,3,1,7,8,4,20,0.8352844269788527,7.419542660305902
Murray State University,8559,6584,Kentucky,Town,NA,100.0,99.91,100.0,13,5,38,7,2,20,20,7,58,13.859470592884811,6.242094272501333
Muskingum University,1559,1363,Ohio,Town,NA,96.67,73.34,99.97,2,1,5,1,0,3,3,1,8,2.723522261225393,0.6720884931401946
Naropa University,391,368,Colorado,Midsize City,NA,77.75,38.31,99.88,1,0,4,1,0,2,2,0,6,0.04406057923924643,1.4501517747254153
NatioNAl Louis University,1883,1250,Illinois,Large City,NA,88.27,66.59,99.47,1,1,3,1,0,2,2,1,5,2.1419465539292553,0.0
NatioNAl University,7881,2899,California,Large City,private,100.0,100.0,100.0,36,15,91,18,7,48,54,22,139,42.12476569039161,11.605545851260443
Nazareth College,2195,2099,New York,Suburb,NA,99.71,94.54,100.0,4,2,8,2,1,4,6,3,12,5.091295993601019,0.7314548416622738
Nebraska Wesleyan University,1776,1566,Nebraska,Large City,NA,77.09,39.95,98.11,1,0,3,1,0,1,2,0,4,0.19465057860692137,1.2672599134902518
Neumann University,2085,1462,Pennsylvania,Suburb,private,99.38,91.49,100.0,3,2,8,2,1,4,5,3,12,2.4986213811358753,2.581506588899495
Nevada State College,4217,1708,Nevada,Rural,public,100.0,100.0,100.0,68,16,216,36,8,109,104,24,325,103.63843078017719,0.11531129003412036
New College of Florida,836,835,Florida,Small City,NA,100.0,98.78,100.0,7,3,17,4,1,9,11,4,26,9.82687092819384,0.8678079031231579
New England College,1841,1811,New Hampshire,Rural,NA,98.0,80.49,99.99,3,1,6,1,1,3,4,2,9,0.3041747463494275,3.595975637185802
New Jersey City University,6508,5210,New Jersey,Large City,NA,100.0,100.0,100.0,24,11,58,12,5,30,36,16,88,35.657101385583424,0.08433282835955967
New Jersey Institute of Technology,8479,6380,New Jersey,Large City,public,100.0,100.0,100.0,31,14,75,15,7,39,46,21,114,44.5507003549581,1.5540246645852955
New Mexico Highlands University,1933,1315,New Mexico,Town,public,100.0,96.61,100.0,8,2,28,4,1,15,12,3,43,4.703268332269772,8.140017155765998
New Mexico Institute of Mining and Technology,1471,1294,New Mexico,Town,NA,99.9,77.65,100.0,5,1,17,2,0,9,7,1,26,4.60560910610138,2.276340675007504
New Mexico State University - Main Campus,11711,9703,New Mexico,Suburb,public,100.0,100.0,100.0,53,13,174,28,7,94,81,20,268,35.8331232657065,44.58521319769413
New York Institute of Technology,3663,3234,New York,Suburb,NA,100.0,99.33,100.0,7,3,14,3,2,7,10,5,21,8.006950966680671,1.93510954864865
New York University,26418,25347,New York,Large City,NA,100.0,100.0,100.0,85,35,203,45,18,109,130,53,312,19.26009647191703,109.97989199573843
Newberry College,1177,1158,South CaroliNA,Town,private,100.0,99.98,100.0,14,6,31,7,3,17,21,9,48,19.74641014557848,1.2165897450253185
Newman University,2811,1013,Kansas,Large City,private,99.59,82.69,100.0,4,1,9,2,1,5,6,2,14,1.285049486221665,4.17738165640818
Niagara University,2998,2827,New York,Suburb,private,99.97,98.21,100.0,5,3,11,3,1,6,8,4,17,6.6206581622214795,1.495894779008112
Nicholls State University,5684,4662,LouisiaNA,Small City,public,100.0,100.0,100.0,23,8,59,12,4,31,35,12,90,31.984002353965614,2.405272288838978
Nichols College,1339,1232,Massachusetts,Suburb,private,99.21,89.25,100.0,3,1,7,2,1,4,5,2,11,3.4795298890338526,1.3446145162858931
Norfolk State University,4684,4011,Virginia,Midsize City,NA,100.0,100.0,100.0,21,7,47,12,4,28,33,11,75,30.14832891293915,3.6252576239010867
North CaroliNA A & T State University,10339,9347,North CaroliNA,Large City,NA,100.0,99.87,100.0,12,4,30,6,2,16,18,6,46,8.875496182468815,9.159386303414765
North CaroliNA Central University,6355,5363,North CaroliNA,Large City,NA,100.0,98.15,100.0,7,3,17,4,1,9,11,4,26,5.264450799392,5.375517158131259
North CaroliNA State University,24149,21384,North CaroliNA,Large City,NA,100.0,100.0,100.0,24,9,61,13,4,33,37,13,94,21.694110754057306,14.871322558740353
North CaroliNA Wesleyan College,2090,1754,North CaroliNA,Small City,NA,99.96,93.27,100.0,5,2,12,3,1,7,8,3,19,1.2278747379129593,6.6849966783286625
North Central College,2772,2634,Illinois,Midsize City,NA,96.73,81.43,99.98,2,1,6,1,1,3,3,2,9,2.8927084899851816,0.5262386281408391
North Central University,1081,912,Minnesota,Large City,NA,82.6,41.63,99.52,1,0,3,1,0,2,2,0,5,0.19798351961519697,1.5430725216063579
North Dakota State University - Main Campus,11981,10782,North Dakota,Midsize City,NA,100.0,100.0,100.0,48,9,182,27,4,105,75,13,287,68.98765380255801,6.209110860191801
North Greenville University,2359,2080,South CaroliNA,Rural,NA,100.0,100.0,100.0,26,11,59,14,6,32,40,17,91,37.9754429798664,1.7693505679826511
North Park University,2033,1812,Illinois,Large City,NA,98.44,82.76,100.0,3,1,7,1,1,4,4,2,11,1.440097895525458,2.7042266030159836
Northcentral University,90,14,California,Large City,NA,39.81,15.0,77.33,0,0,1,0,0,1,0,0,2,0.0,0.5041207179892052
Northeastern Illinois University,7113,4164,Illinois,Large City,NA,99.97,98.42,100.0,5,3,13,3,1,7,8,4,20,8.08320351153547,0.019187102019136277
Northeastern State University,6830,4753,Oklahoma,Town,NA,100.0,99.95,100.0,17,5,50,9,3,28,26,8,78,22.301790815500397,3.6073063173496402
Northeastern University,13824,13786,Massachusetts,Large City,private,100.0,100.0,100.0,36,16,82,19,8,44,55,24,126,18.27695302723558,36.121411813936774
Northern ArizoNA University,27092,21990,ArizoNA,Small City,NA,100.0,100.0,100.0,99,48,221,50,24,114,149,72,335,93.31921809970642,55.67435003567364
Northern Illinois University,13456,11788,Illinois,Suburb,public,100.0,99.97,100.0,11,5,27,6,3,14,17,8,41,14.851436116888136,1.5485198333110182
Northern Kentucky University,12326,8962,Kentucky,Suburb,public,100.0,100.0,100.0,19,7,51,10,3,27,29,10,78,19.966993037522464,8.558314410309784
Northern Michigan University,7018,6207,Michigan,Town,NA,100.0,99.94,100.0,14,5,39,7,2,22,21,7,61,18.700572595880807,2.773675571499045
Northern State University,3164,1346,South Dakota,Town,NA,100.0,98.4,100.0,7,3,21,4,1,11,11,4,32,5.953735954578609,5.239082567457281
Northland College,631,594,Wisconsin,Town,private,61.43,32.23,90.98,1,0,2,0,0,1,1,0,3,0.11328727835460688,0.8346938323034316
Northwest Christian University,604,444,Oregon,Midsize City,NA,90.04,61.64,99.69,1,1,4,1,0,2,2,1,6,0.8021476000792916,1.4909377057087125
Northwest Missouri State University,5478,4806,Missouri,Town,NA,99.93,86.35,100.0,5,1,16,2,1,8,7,2,24,4.660970826210768,2.6516412174724144
Northwest Nazarene University,1482,1125,Idaho,Suburb,NA,99.99,89.97,100.0,6,1,26,3,1,14,9,2,40,5.02799124059159,4.529928914610537
Northwest University,946,929,Washington,Suburb,NA,99.8,90.92,100.0,4,2,18,2,1,9,6,3,27,3.8236276849264734,2.357636683476723
Northwestern College - 2,1039,997,Iowa,Town,private,95.65,59.85,100.0,2,1,6,1,0,4,3,1,10,1.4002619948839905,1.7234295675076763
University of Northwestern - St Paul,3325,2033,Minnesota,Suburb,NA,97.71,70.14,100.0,2,1,9,1,0,5,3,1,14,0.7586035196030106,2.999239283080014
Northwestern Oklahoma State University,1881,1329,Oklahoma,Town,NA,99.99,94.04,100.0,6,2,17,3,1,10,9,3,27,5.039429427468094,4.399214352442418
Northwestern State University of LouisiaNA,9440,5471,LouisiaNA,Town,public,100.0,100.0,100.0,47,16,122,25,8,65,72,24,187,49.3460801902962,21.838370983805714
Northwestern University,8699,8205,Illinois,Small City,NA,100.0,100.0,100.0,25,10,62,13,5,34,38,15,96,2.7994320070206573,35.07769210037593
Norwich University,3229,2542,Vermont,Town,private,100.0,99.33,100.0,8,3,20,4,2,11,12,5,31,0.0007542969578121459,12.616549164752497
Notre Dame College,1736,1216,Ohio,Suburb,NA,96.99,74.13,99.98,2,1,5,1,0,3,3,1,8,3.3017110472039075,0.19756931705735403
Notre Dame de Namur University,922,718,California,Suburb,private,99.46,90.06,100.0,3,2,8,2,1,4,5,3,12,4.7789840756593485,0.4337558278293123
Nova Southeastern University,4501,3154,Florida,Suburb,NA,100.0,100.0,100.0,38,16,88,20,8,49,58,24,137,50.40903171461124,8.393977334333012
Nyack College,1397,1131,New York,Suburb,NA,98.78,87.02,100.0,3,1,6,1,1,3,4,2,9,2.232375423550834,2.1615362752682126
Oakland City University,1112,572,IndiaNA,Town,NA,94.91,77.45,99.85,2,1,4,1,1,2,3,2,6,2.8013168947938962,0.173395672845461
Oakland University,15902,12549,Michigan,Suburb,NA,100.0,100.0,100.0,36,12,100,19,6,57,55,18,157,53.59036173750319,0.8384524258493892
Oakwood University,1648,1521,Alabama,Midsize City,private,99.99,96.94,100.0,6,2,15,3,1,8,9,3,23,1.1030449107195515,7.84995826601533
Oberlin College,2828,2790,Ohio,Town,NA,100.0,99.03,100.0,8,3,20,4,2,10,12,5,30,0.39713977218726243,11.145921329917359
Occidental College,1976,1952,California,Large City,private,100.0,98.63,100.0,7,3,16,3,1,9,10,4,25,5.635538699850455,4.360035538980592
Oglethorpe University,1253,1166,Georgia,Suburb,NA,99.31,74.36,100.0,3,1,11,2,0,6,5,1,17,2.1976171337330066,2.7531535402279212
Ohio Christian University,3988,2429,Ohio,Town,NA,100.0,98.74,100.0,7,3,18,4,1,10,11,4,28,6.009659199716074,5.375520751513562
Ohio Dominican University,1176,957,Ohio,Large City,NA,93.54,65.79,99.86,2,1,4,1,0,2,3,1,6,2.0733032224482084,0.660411511890726
Ohio Northern University,2315,2092,Ohio,Town,private,99.72,89.7,100.0,4,2,9,2,1,5,6,3,14,3.582045004041975,2.2694086107812073
Ohio State University - Lima Campus,1007,844,Ohio,Rural,public,85.99,53.61,99.04,1,1,3,1,0,2,2,1,5,1.952603879920707,0.0107599970215553
Ohio State University - Main Campus,45943,42003,Ohio,Large City,NA,100.0,100.0,100.0,73,29,173,38,14,93,111,43,266,75.42930202533172,34.91136749889078
Ohio State University - Newark Campus,2605,2218,Ohio,Suburb,NA,99.4,86.42,100.0,3,1,8,2,1,4,5,2,12,5.034330641550297,0.08237703532826665
Ohio University - Main Campus,23167,17695,Ohio,Town,public,100.0,100.0,100.0,31,13,73,16,6,39,47,19,112,40.858674209148354,6.533842104257868
Ohio Valley University,528,435,West Virginia,Small City,NA,77.08,41.97,97.53,1,0,2,1,0,1,2,0,3,0.03616263263722463,1.426860620822408
Ohio Wesleyan University,1557,1545,Ohio,Suburb,private,99.22,84.17,100.0,3,1,8,2,1,4,5,2,12,1.489274145702234,3.3422017504021704
Oklahoma Baptist University,1962,1835,Oklahoma,Town,NA,100.0,99.09,100.0,10,3,28,6,2,16,16,5,44,4.243549490658974,11.547400578818262
Oklahoma Christian University,1976,1846,Oklahoma,Large City,NA,100.0,99.46,100.0,11,3,32,6,2,17,17,5,49,2.710108405513815,14.503745123314788
Oklahoma City University,1715,1579,Oklahoma,Large City,NA,100.0,98.12,100.0,8,3,23,5,1,13,13,4,36,2.909078389716095,10.023476615145412
Oklahoma Panhandle State University,1136,852,Oklahoma,Rural,public,99.99,94.67,100.0,6,2,17,3,1,9,9,3,26,1.787299340851516,7.641382824612654
Oklahoma State University - Main Campus,20992,18221,Oklahoma,Town,NA,100.0,100.0,100.0,108,33,301,59,17,165,167,50,466,50.43889099527801,116.97162577402483
Oklahoma Wesleyan University,1005,609,Oklahoma,Town,NA,99.92,89.3,100.0,5,1,13,3,1,7,8,2,20,1.8113129596345499,5.318217467087031
Old Dominion University,19543,15036,Virginia,Midsize City,public,100.0,100.0,100.0,99,29,214,57,16,130,156,45,344,151.10869671526834,4.879772966796415
Olivet College,1178,1032,Michigan,Rural,private,98.26,74.55,100.0,3,1,7,1,0,4,4,1,11,3.9459298589704765,0.09926435850468907
Olivet Nazarene University,3377,3113,Illinois,Suburb,NA,99.9,94.82,100.0,5,2,11,2,1,6,7,3,17,2.305749158159639,4.610395713781368
Oral Roberts University,3384,2866,Oklahoma,Large City,private,100.0,99.97,100.0,17,5,50,9,3,27,26,8,77,3.639778504114124,22.25254898983179
Oregon Institute of Technology,5380,2284,Oregon,Town,NA,100.0,99.71,100.0,8,4,25,5,2,13,13,6,38,8.838341905460819,4.0807934722539585
Oregon State University,25835,18829,Oregon,Small City,NA,100.0,100.0,100.0,47,22,118,26,12,64,73,34,182,36.126078612745346,36.63197680476695
Ottawa University - Online,156,85,Kansas,Town,NA,76.05,35.15,97.86,1,0,2,0,0,1,1,0,3,0.02968572780254402,1.381187603902572
Ottawa University - Ottawa,669,646,Kansas,Town,NA,82.12,42.37,98.92,1,0,3,1,0,2,2,0,5,0.2603209976530783,1.4450998043822822
Otterbein University,2483,2294,Ohio,Suburb,private,99.66,88.98,100.0,4,1,9,2,1,5,6,2,14,4.366590730470733,1.3144892355495417
Ouachita Baptist University,1542,1500,Arkansas,Town,private,100.0,99.05,100.0,10,3,27,6,2,15,16,5,42,0.9651683363896162,14.655788368844664
University of Holy Cross,912,457,LouisiaNA,Large City,private,99.5,85.53,100.0,3,1,9,2,1,5,5,2,14,5.212121418965596,0.061335697289696525
Our Lady of the Lake University,1344,1221,Texas,Large City,NA,100.0,100.0,100.0,22,7,60,12,4,32,34,11,92,34.210524221381924,0.20507221810457296
Pace University - New York,8670,7878,New York,Large City,NA,100.0,100.0,100.0,18,9,41,9,4,22,27,13,63,13.194448774114267,14.625147721124021
Pacific Lutheran University,2764,2655,Washington,Suburb,NA,100.0,99.93,100.0,11,5,40,6,3,20,17,8,60,11.390747145215093,5.277207294305819
Pacific Union College,1227,1077,California,Rural,NA,99.94,95.71,100.0,5,2,12,2,1,6,7,3,18,6.179007840716537,1.1386485255982624
Pacific University,1876,1818,Oregon,Suburb,NA,99.8,91.72,100.0,4,2,15,2,1,7,6,3,22,1.4184766047273711,4.766838986211998
Paine College,425,328,Georgia,Midsize City,NA,82.28,40.6,99.7,1,0,4,1,0,2,2,0,6,0.7642824031760346,0.9577725962905022
Palm Beach Atlantic University,3005,2350,Florida,Midsize City,NA,100.0,100.0,100.0,20,8,47,11,4,26,31,12,73,26.27909827403873,4.7777534850983
Park University,9864,4134,Missouri,Suburb,NA,100.0,98.74,100.0,9,3,27,4,1,14,13,4,41,9.36454439959787,4.017498459396712
Paul Quinn College,518,492,Texas,Large City,private,100.0,96.47,100.0,7,2,19,4,1,10,11,3,29,10.373175797601258,0.613622312681526
Paul Smiths College of Arts and Science,768,760,New York,Rural,private,83.06,57.95,97.84,1,1,2,1,0,1,2,1,3,1.1815556109180658,0.5907046859950248
William Peace University,932,814,North CaroliNA,Large City,NA,72.96,38.56,96.42,1,0,2,0,0,1,1,0,3,0.8570267401465351,0.44815167692077695
Peirce College,1388,307,Pennsylvania,Large City,NA,94.31,75.61,99.83,2,1,4,1,0,2,3,1,6,2.3142079362184664,0.5452860188522315
Pennsylvania State University - Brandywine,1439,1245,Pennsylvania,Suburb,NA,94.14,76.58,99.79,2,1,4,1,0,2,3,1,6,2.4299183330293896,0.40367664099395756
Pennsylvania State University - University Park,40833,39785,Pennsylvania,Small City,NA,100.0,100.0,100.0,75,35,171,39,18,91,114,53,262,47.515389665435556,66.68066742569584
Pennsylvania State University - Abington,3891,3312,Pennsylvania,Suburb,NA,99.97,98.25,100.0,5,3,11,3,1,6,8,4,17,6.468934371710682,1.5317063012251873
Pennsylvania State University - AltooNA,3478,3374,Pennsylvania,Small City,NA,99.97,98.1,100.0,5,3,12,3,1,6,8,4,18,5.114761134032845,2.9387852175866356
Pennsylvania State University - Beaver,652,563,Pennsylvania,Suburb,NA,76.27,50.39,95.95,1,0,2,0,0,1,1,0,3,1.0341616714976272,0.4008042145096683
Pennsylvania State University - Berks,2718,2411,Pennsylvania,Suburb,public,99.63,94.14,100.0,4,2,8,2,1,4,6,3,12,4.429538627918158,1.1722115080039328
Pennsylvania State University - Erie - Behrend College,4341,4138,Pennsylvania,Suburb,NA,99.99,98.93,100.0,6,3,13,3,2,7,9,5,20,6.939007858755058,2.1885654983155374
Pennsylvania State University - Greater Allegheny,497,453,Pennsylvania,Suburb,public,66.34,40.99,91.08,1,0,2,0,0,1,1,0,3,0.8045488528259512,0.2816128786037234
Pennsylvania State University - Harrisburg,4288,3960,Pennsylvania,Suburb,public,100.0,99.4,100.0,7,3,16,4,2,9,11,5,25,5.548675122073807,5.463576633615778
Pennsylvania State University - Lehigh Valley,899,739,Pennsylvania,Suburb,public,84.07,60.8,98.13,1,1,3,1,0,1,2,1,4,1.562090356947465,0.2716020650882328
Pennsylvania State University - New Kensington,597,484,Pennsylvania,Rural,NA,69.48,44.48,92.71,1,0,2,0,0,1,1,0,3,1.052241420999334,0.132506767613231
Pennsylvania State University - Schuylkill,733,595,Pennsylvania,Town,NA,81.97,56.81,97.68,1,1,2,1,0,1,2,1,3,0.9980021724942136,0.7115650886893871
Pennsylvania State University - SheNAngo,490,241,Pennsylvania,Suburb,NA,59.14,36.45,85.58,1,0,1,0,0,1,1,0,2,0.777429228573391,0.11680581534919483
Pennsylvania State University - Wilkes - Barre,456,387,Pennsylvania,Rural,NA,60.15,37.19,86.59,1,0,1,0,0,1,1,0,2,0.7810451784737324,0.13752124636272178
Pennsylvania State University - Worthington Scranton,1030,904,Pennsylvania,Suburb,public,84.95,62.63,98.25,1,1,3,1,0,1,2,1,4,1.835094574423237,0.05685415647743841
Pennsylvania State University - York,966,793,Pennsylvania,Suburb,NA,86.38,62.72,98.76,1,1,3,1,0,2,2,1,5,1.5458185823959287,0.44400906071062207
Pepperdine University,3603,3300,California,Suburb,NA,100.0,99.99,100.0,16,6,41,8,3,22,24,9,63,11.720030168242456,12.639150997319199
Peru State College,2046,1105,Nebraska,Rural,public,76.04,43.66,97.88,1,0,2,0,0,1,1,0,3,0.19388323072805047,1.231346951880665
Pfeiffer University,812,733,North CaroliNA,Rural,NA,94.23,65.41,99.92,2,1,5,1,0,2,3,1,7,0.5895787203096233,2.2432879589987023
Cairn University,770,727,Pennsylvania,Suburb,private,87.16,61.49,99.07,1,1,3,1,0,2,2,1,5,0.7955089780750978,1.2527777098019075
Thomas Jefferson University,2690,2279,Pennsylvania,Large City,private,99.98,97.87,100.0,6,3,13,3,1,7,9,4,20,2.2292331135604444,6.201451182070977
Philander Smith College,893,845,Arkansas,Midsize City,private,94.81,61.4,99.97,2,1,5,1,0,3,3,1,8,0.386530245028935,2.5476375377624234
Piedmont College,1281,1160,Georgia,Town,NA,96.81,46.45,100.0,2,0,10,1,0,5,3,0,15,2.991201098692148,0.4456956890650329
University of Pikeville,1562,1049,Kentucky,Town,NA,99.26,81.5,100.0,3,1,9,2,1,5,5,2,14,2.869305846474065,2.014488026411698
Pine Manor College,419,417,Massachusetts,Suburb,NA,78.86,51.78,96.69,1,0,2,1,0,1,2,0,3,1.3650141321600915,0.18564694576536012
Pittsburg State University,5709,5109,Kansas,Town,NA,99.57,84.16,100.0,4,1,9,2,1,5,6,2,14,2.387417570581521,3.0510749363705774
Pitzer College,1070,1046,California,Suburb,NA,99.03,87.13,100.0,3,1,7,2,1,4,5,2,11,2.522405686411053,2.1016503182750674
Platt College - Aurora,236,236,Colorado,Large City,private,16.68,4.84,47.25,0,0,0,0,0,0,0,0,0,0.1824262579028449,0.0
Plymouth State University,4148,3971,New Hampshire,Town,NA,99.89,93.13,100.0,4,2,10,2,1,6,6,3,16,1.0282636865585992,5.8046604699111795
Point Loma Nazarene University,3097,2571,California,Large City,private,100.0,99.96,100.0,12,5,28,6,3,15,18,8,43,14.856792274762993,2.637419241341867
Point Park University,3282,2758,Pennsylvania,Large City,private,99.99,98.57,100.0,6,3,15,3,1,8,9,4,23,3.8582185436642247,5.848538516431659
PomoNA College,1600,1578,California,Suburb,private,99.98,96.61,100.0,5,2,14,3,1,7,8,3,21,3.065874827277135,5.317303191259027
Portland State University,21163,13990,Oregon,Large City,NA,100.0,100.0,100.0,37,17,107,20,9,57,57,26,164,30.753897437902385,26.13859921318268
Post University,7845,2617,Connecticut,Suburb,private,100.0,100.0,100.0,21,8,56,11,4,30,32,12,86,1.1857082523608828,30.433140704361765
University of the Potomac - VA Campus,37,37,Virginia,Suburb,NA,26.65,8.35,49.55,0,0,0,0,0,0,0,0,0,0.3086574902542193,0.0
Prairie View A & M University,7977,7341,Texas,Town,NA,100.0,100.0,100.0,126,38,337,69,20,181,195,58,518,191.32746471131207,3.2967874551890954
Pratt Institute - Main,3642,3537,New York,Large City,NA,100.0,99.89,100.0,11,4,27,6,2,15,17,6,42,2.4223123380407947,14.201035754037138
Presbyterian College,1014,975,South CaroliNA,Town,NA,100.0,99.79,100.0,10,4,23,5,2,13,15,6,36,13.881951888428485,1.4734307476610469
Prescott College,386,291,ArizoNA,Small City,NA,81.49,47.27,99.71,1,0,4,1,0,2,2,0,6,0.2123879462548862,1.464864642230424
Presentation College,762,475,South Dakota,Town,private,86.3,51.57,99.45,1,0,3,1,0,2,2,0,5,1.139836384653292,0.8403742654201061
Princeton University,5397,5260,New Jersey,Suburb,private,100.0,100.0,100.0,19,7,49,10,4,26,29,11,75,4.653563254899089,23.705691940996676
Principia College,456,441,Illinois,Rural,private,89.93,59.26,99.69,1,1,4,1,0,2,2,1,6,0.04095065105759596,2.239427421814713
Providence Christian College,165,161,California,Midsize City,private,55.02,28.98,86.78,1,0,1,0,0,1,1,0,2,0.6143564201094837,0.1822535211612601
Providence College,4076,3826,Rhode Island,Midsize City,private,100.0,99.58,100.0,8,4,17,4,2,9,12,6,26,0.20233384777699812,11.679311611764234
Purdue University - Main Campus,32130,30277,IndiaNA,Small City,NA,100.0,100.0,100.0,66,30,150,35,16,81,101,46,231,60.9683871730926,39.39229361355935
Queens University of Charlotte,1717,1449,North CaroliNA,Large City,private,99.62,87.78,100.0,4,1,9,2,1,5,6,2,14,1.04195362375124,4.484810176589668
Quincy University,992,874,Illinois,Town,NA,96.3,75.13,99.97,2,1,5,1,0,3,3,1,8,0.7143613573380629,2.562955449502184
Quinnipiac University,7311,6959,Connecticut,Suburb,private,100.0,99.99,100.0,14,7,31,7,3,16,21,10,47,0.6034800654012281,20.414603578155692
Radford University,8419,8049,Virginia,Small City,NA,100.0,100.0,100.0,43,12,92,25,7,56,68,19,148,65.56886144319361,1.7051917345470682
Ramapo College of New Jersey,5616,4910,New Jersey,Suburb,NA,100.0,100.0,100.0,20,9,49,10,4,26,30,13,75,30.20956525307122,0.2849605819174603
Randolph College,666,645,Virginia,Small City,NA,98.74,74.26,100.0,3,1,6,2,0,4,5,1,10,3.370206109802827,0.9871154327733745
Randolph - Macon College,1452,1428,Virginia,Suburb,private,100.0,94.83,100.0,6,2,14,4,1,8,10,3,22,8.750856953423677,1.147986583096142
Reed College,1446,1408,Oregon,Large City,NA,99.97,95.66,100.0,5,2,14,3,1,8,8,3,22,0.1839788073576357,7.78656027007624
Regent University,4280,2263,Virginia,Large City,NA,100.0,99.99,100.0,18,6,43,10,3,25,28,9,68,15.866663417933111,12.460170289668067
Regis University,4084,2378,Colorado,Large City,NA,99.98,94.73,100.0,6,2,18,3,1,9,9,3,27,2.0066888369312936,6.753668635044803
Reinhardt University,1408,1260,Georgia,Rural,NA,97.59,48.8,100.0,2,0,10,1,0,6,3,0,16,3.325727262382617,0.39174585593769534
Rensselaer Polytechnic Institute,6366,6340,New York,Small City,NA,100.0,99.99,100.0,14,6,33,7,3,18,21,9,51,5.214631652360733,16.39851329064878
Rhode Island College,7079,5461,Rhode Island,Suburb,public,99.88,97.37,100.0,4,2,9,2,1,5,6,3,14,2.7469228572010556,3.995642385450119
Rhodes College,1984,1979,Tennessee,Large City,NA,100.0,98.91,100.0,9,3,24,5,2,13,14,5,37,1.1134989335035907,12.543311496947815
Rice University,4004,3916,Texas,Large City,NA,100.0,100.0,100.0,42,13,110,23,7,59,65,20,169,55.32360425387337,8.967879548640662
Rider University,4092,3711,New Jersey,Suburb,private,100.0,99.98,100.0,13,6,31,7,3,16,20,9,47,16.53558791640091,2.8491963634509823
Ripon College,759,739,Wisconsin,Town,NA,60.81,31.65,90.56,1,0,2,0,0,1,1,0,3,0.22019217483008097,0.7114311963503488
Rivier University,1427,908,New Hampshire,Small City,private,94.54,70.03,99.88,2,1,4,1,0,2,3,1,6,0.34243572073300327,2.559249098515989
Roanoke College,2036,1973,Virginia,Suburb,NA,100.0,97.63,100.0,7,2,16,4,1,10,11,3,26,8.550646689474993,3.054513482430159
Robert Morris University,4245,3840,Pennsylvania,Suburb,NA,99.98,98.52,100.0,6,3,12,3,1,6,9,4,18,6.553909194368703,1.8568954180411008
Roberts Wesleyan College,1322,1248,New York,Suburb,NA,96.22,81.03,99.9,2,1,4,1,1,2,3,2,6,2.720784632239304,0.5496399358374345
Rochester College,1152,762,Michigan,Suburb,NA,97.94,73.33,100.0,3,1,7,1,0,4,4,1,11,3.7005870698116907,0.17463458531415108
Rochester Institute of Technology,13510,12447,New York,Suburb,private,100.0,100.0,100.0,28,13,63,15,6,34,43,19,97,17.284259218586403,25.289433944482397
Rockford University,1059,918,Illinois,Midsize City,NA,88.06,56.56,99.68,1,1,4,1,0,2,2,1,6,0.9293522753904417,1.184153351639705
Rockhurst University,2208,1445,Missouri,Large City,NA,95.49,62.25,99.99,2,1,6,1,0,3,3,1,9,1.7248355478418305,1.361232962946172
Rocky Mountain College,898,868,MontaNA,Midsize City,private,100.0,49.95,100.0,11,0,119,6,0,53,17,0,172,14.920974378943358,2.0020974550867074
Roger Williams University,4704,4042,Rhode Island,Suburb,private,100.0,99.66,100.0,8,4,17,4,2,9,12,6,26,0.18980841910508872,11.953415280570894
Rollins College,2614,2453,Florida,Suburb,private,100.0,100.0,100.0,16,7,38,9,3,21,25,10,59,19.96500021157934,4.550062485210649
Roosevelt University,2576,2117,Illinois,Large City,NA,99.65,90.44,100.0,4,2,9,2,1,5,6,3,14,1.9986192752276697,3.6421594544272238
Rosemont College,634,520,Pennsylvania,Suburb,NA,79.56,53.88,97.23,1,1,2,1,0,1,2,1,3,0.8859077255836317,0.698838933017757
Rowan University,15399,13634,New Jersey,Suburb,NA,100.0,100.0,100.0,55,25,135,28,12,70,83,37,205,82.26441204158105,1.1618926007239796
Rust College,862,792,Mississippi,Town,NA,99.67,89.94,100.0,4,2,9,2,1,5,6,3,14,4.036285355117465,1.653135473804398
Rutgers University - Camden,5489,4493,New Jersey,Small City,NA,100.0,100.0,100.0,20,9,49,10,4,25,30,13,74,28.831140118326225,1.2215238510443154
Rutgers University - New Brunswick,35638,33677,New Jersey,Small City,NA,100.0,100.0,100.0,129,57,314,65,28,163,194,85,477,181.83081637448123,12.139705196052114
Rutgers University - Newark,8549,7162,New Jersey,Large City,NA,100.0,100.0,100.0,31,14,76,16,7,40,47,21,116,45.09104300777814,1.7795709911648154
Sacred Heart University,5605,4982,Connecticut,Suburb,NA,100.0,99.91,100.0,10,5,21,5,2,11,15,7,32,0.5712358360415997,14.083971311398596
SagiNAw Valley State University,7850,6559,Michigan,Suburb,public,100.0,99.99,100.0,17,6,49,9,3,28,26,9,77,26.428870454382572,0.18320128921985895
Saint Ambrose University,2369,2215,Iowa,Midsize City,private,98.49,74.98,100.0,3,1,9,1,0,5,4,1,14,2.057071513442349,2.1291160404516534
Saint Anselm College,1965,1926,New Hampshire,Suburb,NA,99.49,90.43,100.0,3,2,8,2,1,4,5,3,12,0.21234840782884562,5.0557475288450755
Saint Augustine's University,972,961,North CaroliNA,Large City,private,95.88,69.59,99.95,2,1,5,1,0,3,3,1,8,0.5010922007353291,2.6755777280821382
St. BoNAventure University,1621,1586,New York,Town,NA,98.78,88.57,99.99,3,1,6,1,1,3,4,2,9,3.1327257324967506,1.2632336871131573
Saint Cloud State University,13133,8373,Minnesota,Small City,NA,99.98,95.22,100.0,6,2,16,3,1,9,9,3,25,3.8436800474788746,4.758719021434287
Saint Edward's University,3941,3528,Texas,Large City,NA,100.0,100.0,100.0,62,19,166,34,10,89,96,29,255,94.93027548107817,1.142114538145495
Saint Francis University,2119,1526,Pennsylvania,Town,private,98.9,89.09,100.0,3,1,6,2,1,3,5,2,9,3.3375217580150696,1.1627049222114971
St. John Fisher College,2746,2624,New York,Suburb,NA,99.9,97.14,100.0,5,2,9,2,1,5,7,3,14,6.618191449046285,0.2699435848907855
Saint Johns University,1724,1703,Minnesota,Rural,NA,83.81,46.07,99.79,1,0,4,1,0,2,2,0,6,0.4906258263864814,1.3181374139652926
University of Saint Joseph,808,654,Connecticut,Small City,NA,47.9,31.01,72.5,0,0,1,0,0,0,0,0,1,0.25575536469341664,0.3954837529865607
St. Joseph's College - New York,928,798,New York,Large City,NA,91.21,71.16,99.35,2,1,3,1,0,2,3,1,5,2.2422422762516114,0.18569085659989312
Saint Joseph's College of Maine,1537,960,Maine,Rural,private,91.92,61.04,99.74,2,1,4,1,0,2,3,1,6,0.6611894937285362,1.8499830975061975
Saint Joseph's University,5143,4481,Pennsylvania,Large City,NA,100.0,99.95,100.0,11,5,26,6,3,14,17,8,40,3.4622720295768463,13.201775967509274
Saint Leo University,9672,6732,Florida,Suburb,private,100.0,100.0,100.0,72,31,165,38,16,91,110,47,256,102.01863137067602,8.520929443036495
Saint Louis University,9900,6625,Missouri,Large City,NA,100.0,99.96,100.0,14,5,37,7,3,20,21,8,57,3.928664145017574,17.41776109057623
Saint Martin's University,1318,1121,Washington,Suburb,NA,99.91,97.52,100.0,4,2,10,3,1,6,7,3,16,6.330736855581856,0.6319458401561258
Saint Mary - of - the - Woods College,662,491,IndiaNA,Rural,private,86.83,60.22,99.12,1,1,3,1,0,2,2,1,5,1.3458381559137018,0.6751149499838003
Saint Mary's College,1533,1486,IndiaNA,Suburb,NA,99.52,88.57,100.0,3,1,9,2,1,5,5,2,14,1.1923413397606115,4.116568954116488
Saint Mary's College of California,2776,2614,California,Suburb,NA,100.0,99.92,100.0,11,5,26,6,2,14,17,7,40,14.51417042508655,1.7459452751807034
Saint Mary's University of Minnesota,1501,1129,Minnesota,Town,NA,70.16,39.82,95.43,1,0,2,0,0,1,1,0,3,0.3316390606348838,0.8736654052015198
Saint Michael's College,1790,1766,Vermont,Suburb,private,97.67,81.82,99.98,2,1,5,1,1,3,3,2,8,0.0008131910145782594,3.752350707549236
Saint Norbert College,2068,2021,Wisconsin,Suburb,private,89.47,62.86,99.6,1,1,4,1,0,2,2,1,6,0.5596551110264558,1.682281738857558
Saint Peter's University,2633,2387,New Jersey,Large City,NA,100.0,99.63,100.0,8,4,20,4,2,10,12,6,30,10.773770853166848,1.7926266129008253
St. Thomas AquiNAs College,1777,1091,New York,Suburb,NA,99.65,93.6,100.0,4,2,8,2,1,4,6,3,12,3.2511279649060767,2.398549052028609
St. Thomas University,2907,935,Florida,Suburb,NA,100.0,100.0,100.0,26,11,61,14,6,34,40,17,95,39.21855275414917,1.2984726811841423
Saint Vincent College,1667,1617,Pennsylvania,Suburb,NA,98.59,86.24,99.99,3,1,6,1,1,3,4,2,9,2.4299183330293896,1.8166685313728073
Saint Xavier University,2942,2638,Illinois,Large City,NA,97.37,83.39,99.99,2,1,6,1,1,3,3,2,9,3.1213496250567587,0.5110783508188361
Salem College,817,673,North CaroliNA,Midsize City,private,95.49,64.17,99.97,2,1,5,1,0,3,3,1,8,0.5348960396738236,2.5408634841283884
Salem InterNAtioNAl University,892,892,West Virginia,Rural,private,98.97,81.53,100.0,3,1,7,2,1,4,5,2,11,0.024324640787370826,4.522294356756209
Salem State University,7110,5792,Massachusetts,Suburb,NA,100.0,100.0,100.0,19,9,41,10,5,23,29,14,64,28.388944220998223,0.7905686095278984
Salisbury University,7783,7191,Maryland,Suburb,public,100.0,99.99,100.0,14,6,32,7,3,18,21,9,50,16.134395956172444,4.773339024375518
Salve RegiNA University,2180,2087,Rhode Island,Suburb,NA,99.37,90.74,100.0,3,2,7,2,1,4,5,3,11,0.1483781550364653,4.909028509185924
Sam Houston State University,18416,14808,Texas,Town,public,100.0,100.0,100.0,308,93,827,169,50,444,477,143,1271,476.7731633639911,0.9817524058986737
Samford University,3375,3266,Alabama,Suburb,private,100.0,99.75,100.0,12,4,31,6,2,17,18,6,48,4.810972802907583,12.849678828683176
San Diego Christian College,656,504,California,Suburb,private,97.6,80.74,99.99,2,1,6,1,1,3,3,2,9,3.130854833250253,0.5854996046559122
San Diego State University,30267,27060,California,Large City,NA,100.0,100.0,100.0,120,53,294,61,26,155,181,79,449,163.30066228371697,18.35627444519027
San Francisco State University,26676,22263,California,Large City,public,100.0,100.0,100.0,104,47,250,53,23,132,157,70,382,156.20011981283622,0.4818084156473973
San Jose State University,27777,23097,California,Large City,NA,100.0,100.0,100.0,109,49,262,55,24,138,164,73,400,163.67282049974483,0.20833596875497334
Santa Clara University,5498,5411,California,Midsize City,private,100.0,100.0,100.0,20,9,52,11,4,27,31,13,79,19.907510920855383,10.871364167590533
Sarah Lawrence College,1401,1384,New York,Suburb,NA,99.78,91.96,100.0,4,2,10,2,1,6,6,3,16,0.6808128363536246,5.419336038497993
SavanNAh State University,4237,3687,Georgia,Midsize City,NA,100.0,93.67,100.0,8,2,33,4,1,19,12,3,52,9.542541954031767,3.27913646818622
Schreiner University,1249,1137,Texas,Town,NA,100.0,99.99,100.0,21,6,55,11,3,30,32,9,85,31.800594490626075,0.11430513730967269
Scripps College,1064,1060,California,Suburb,NA,99.61,90.34,100.0,4,2,9,2,1,5,6,3,14,2.5519420527624703,2.961214561045449
Seattle Pacific University,2898,2783,Washington,Large City,private,100.0,99.91,100.0,10,5,29,5,3,15,15,8,44,9.639205121880511,5.481144825793927
Seattle University,4563,4325,Washington,Large City,private,100.0,100.0,100.0,16,7,46,9,4,25,25,11,71,11.144615422981802,13.306232130294491
Seton Hall University,5972,5554,New Jersey,Suburb,NA,100.0,100.0,100.0,19,8,46,10,4,24,29,12,70,22.556548904967027,6.2417774868026825
Seton Hill University,2091,1551,Pennsylvania,Suburb,NA,99.26,90.15,100.0,3,2,7,2,1,4,5,3,11,2.8999918200737658,1.9988610501021027
Sewanee - The University of the South,1700,1687,Tennessee,Rural,NA,100.0,97.55,100.0,7,2,18,4,1,10,11,3,28,0.8634869088112751,10.082610442569402
Shaw University,1545,1466,North CaroliNA,Large City,private,98.54,79.83,100.0,3,1,7,1,1,4,4,2,11,0.9852824820014111,3.2249305377181403
Shawnee State University,3408,2832,Ohio,Town,public,99.89,92.95,100.0,5,2,11,2,1,6,7,3,17,6.017446254072687,0.8327650740887693
SheNAndoah University,2060,1991,Virginia,Small City,NA,100.0,98.39,100.0,8,3,18,5,1,11,13,4,29,10.561091423293018,2.596298553004346
Shepherd University,3419,2614,West Virginia,Town,NA,99.81,88.07,100.0,4,1,9,2,1,5,6,2,14,0.3332475787869803,5.887402057308094
Shippensburg University of Pennsylvania,5573,5160,Pennsylvania,Town,NA,100.0,99.6,100.0,7,4,15,4,2,8,11,6,23,9.339998592581717,1.5461029130960546
Shorter University,1402,1140,Georgia,Small City,NA,98.88,64.7,100.0,3,1,11,2,0,6,5,1,17,2.952132349648006,1.52707136844249
Shorter University - College of Adult & ProfessioNAl Programs,113,56,Georgia,Small City,NA,24.14,4.09,72.16,0,0,1,0,0,0,0,0,1,0.2759230401242553,0.0
SieNA College,3161,3039,New York,Suburb,NA,99.97,98.4,100.0,5,3,11,3,1,6,8,4,17,6.216117201489616,2.0588804262107576
SieNA Heights University,2301,1290,Michigan,Town,NA,99.96,92.85,100.0,5,2,14,3,1,8,8,3,22,7.206944431539342,0.5139168892207308
Sierra Nevada College,452,410,Nevada,Town,private,97.07,67.94,100.0,2,1,7,1,0,4,3,1,11,1.3175430154352101,2.1845184369110267
Silver Lake College of the Holy Family,393,267,Wisconsin,Town,NA,36.01,16.3,66.5,0,0,1,0,0,0,0,0,1,0.14121019907581278,0.3016414768932475
Simmons College,1743,1553,Massachusetts,Large City,NA,99.74,92.97,100.0,4,2,9,2,1,5,6,3,14,4.430015189648395,1.4947441281807936
Simpson College,1433,1280,Iowa,Town,NA,98.18,55.28,100.0,3,1,10,1,0,6,4,1,16,3.5076423225137883,0.49184397199307095
Simpson University,779,619,California,Small City,NA,98.99,86.51,100.0,3,1,7,2,1,4,5,2,11,3.5739003285215154,0.9983980390445779
Skidmore College,2682,2636,New York,Suburb,private,99.97,97.81,100.0,5,3,12,3,1,7,8,4,19,2.113973191141508,6.109767004197559
Slippery Rock University of Pennsylvania,7613,7125,Pennsylvania,Town,NA,100.0,99.95,100.0,10,5,21,5,3,11,15,8,32,11.769916925611106,3.3266656763552724
Smith College,2526,2505,Massachusetts,Suburb,private,100.0,98.89,100.0,7,3,18,4,2,10,11,5,28,2.286189313372423,8.68562194793511
Soka University of America,409,412,California,Suburb,NA,90.78,63.05,99.74,2,1,4,1,0,2,3,1,6,1.654036515679379,0.7181231237019305
Sonoma State University,8670,7887,California,Suburb,NA,100.0,100.0,100.0,34,15,82,17,8,43,51,23,125,50.93841740965459,0.27890998780572296
South CaroliNA State University,2523,2281,South CaroliNA,Town,NA,100.0,100.0,100.0,26,11,60,14,6,33,40,17,93,37.2782696206248,3.1131629505385408
South College,1410,1410,Tennessee,Midsize City,NA,94.85,51.14,99.99,2,1,7,1,0,3,3,1,10,2.962327351396345,0.0
South Dakota State University,10886,8425,South Dakota,Town,NA,100.0,100.0,100.0,17,8,39,9,4,21,26,12,60,19.51863744539049,6.806482223301569
South University - Columbia,806,556,South CaroliNA,Suburb,NA,100.0,99.89,100.0,11,4,24,6,2,13,17,6,37,16.527109633786353,0.0
South University - SavanNAh,499,396,Georgia,Midsize City,NA,97.36,71.65,100.0,2,1,6,1,0,3,3,1,9,0.17092577706812276,3.4323444876422013
South University - Tampa,543,424,Florida,Large City,private,99.97,96.63,100.0,5,2,12,3,1,7,8,3,19,8.048251755670067,0.0
South University - West Palm Beach,699,535,Florida,Suburb,NA,100.0,98.66,100.0,7,3,15,4,1,8,11,4,23,10.227060242011689,0.018908472455721352
Southeast Missouri State University,10462,7779,Missouri,Small City,NA,100.0,98.37,100.0,8,3,26,4,1,13,12,4,39,10.126788146374432,2.455426716448432
Southeastern LouisiaNA University,13317,8998,LouisiaNA,Small City,NA,100.0,100.0,100.0,52,19,137,27,10,73,79,29,210,75.84977590687069,3.76687516930106
Southeastern Oklahoma State University,3122,2374,Oklahoma,Town,NA,100.0,99.96,100.0,17,5,48,9,3,26,26,8,74,7.999965571719262,18.46388715569307
Southeastern University,6241,4288,Florida,Midsize City,private,100.0,100.0,100.0,46,19,115,25,10,62,71,29,177,60.8435975267507,10.378873042732518
Southern Adventist University,2596,2173,Tennessee,Suburb,NA,100.0,99.42,100.0,9,3,25,5,2,14,14,5,39,1.3004827166768351,13.162116573466784
Southern Arkansas University Main Campus,3478,2924,Arkansas,Town,public,100.0,99.69,100.0,13,4,34,7,2,18,20,6,52,3.0737255413079385,16.225310401140568
Southern Connecticut State University,7944,6814,Connecticut,Midsize City,NA,99.42,95.34,100.0,3,2,7,2,1,3,5,3,10,2.692759563226245,2.4456363258872447
Southern Illinois University Carbondale,10990,9455,Illinois,Small City,NA,100.0,99.94,100.0,10,5,26,5,2,13,15,7,39,11.326267571680082,4.319553009573107
Southern Illinois University Edwardsville,11408,9550,Illinois,Suburb,NA,100.0,99.87,100.0,9,4,23,5,2,12,14,6,35,11.956452590733088,1.7564023062095278
Southern Methodist University,6454,6240,Texas,Suburb,NA,100.0,100.0,100.0,65,21,171,35,11,92,100,32,263,83.16877059945452,16.560257968100338
Southern Nazarene University,1517,1483,Oklahoma,Suburb,NA,100.0,98.35,100.0,9,3,24,5,1,13,14,4,37,3.234977501771554,10.479329761053009
Southern New Hampshire University,70662,19935,New Hampshire,Suburb,NA,100.0,100.0,100.0,109,48,244,58,25,133,167,73,377,11.152595770632548,155.40779066435957
Southern Oregon University,5522,3640,Oregon,Suburb,public,100.0,99.96,100.0,12,5,36,6,3,19,18,8,55,6.558844482299713,11.829130823663132
Southern University and A & M College,5152,4530,LouisiaNA,Midsize City,NA,100.0,100.0,100.0,24,9,64,13,4,34,37,13,98,24.439835557386775,12.65987946488403
Southern University at New Orleans,2108,1520,LouisiaNA,Large City,NA,100.0,99.03,100.0,8,3,22,4,2,12,12,5,34,11.905091652715601,0.8380442250087027
Southern Utah University,8549,6279,Utah,Town,public,100.0,100.0,100.0,49,11,169,26,5,95,75,16,264,48.476552418668525,26.51031440530345
Southern Virginia University,908,853,Virginia,Town,NA,99.83,83.95,100.0,4,1,13,2,1,7,6,2,20,1.2012615836920968,5.1283906125144
Southern Wesleyan University,1360,820,South CaroliNA,Suburb,NA,100.0,99.98,100.0,14,6,32,8,3,17,22,9,49,18.844185798324634,2.4810843572424477
Southwest Baptist University,2827,1835,Missouri,Town,private,99.96,91.1,100.0,5,2,15,3,1,8,8,3,23,2.2844283891309694,5.511620290769228
Southwest Minnesota State University,6711,1932,Minnesota,Town,public,99.78,90.24,100.0,4,2,10,2,1,5,6,3,15,1.8395135433607273,4.26722691413145
Southwestern Adventist University,802,652,Texas,Town,private,100.0,98.87,100.0,9,3,25,5,2,14,14,5,39,13.647536844823875,1.0223821815294087
Southwestern Assemblies of God University,1788,1492,Texas,Suburb,private,100.0,99.99,100.0,20,6,53,11,3,28,31,9,81,28.10711522935896,2.3535590919707663
Southwestern Christian University,620,539,Oklahoma,Suburb,NA,95.58,61.3,99.99,2,1,6,1,0,3,3,1,9,1.8833538159836514,1.2180157157880709
Southwestern College - Winfield,1148,577,Kansas,Town,NA,99.54,80.46,100.0,3,1,9,2,1,5,5,2,14,0.3528034573456193,4.983688950410123
Southwestern Oklahoma State University,4626,3713,Oklahoma,Town,public,100.0,99.84,100.0,14,4,41,8,2,23,22,6,64,14.46992057526237,7.450600626554586
Southwestern University,1398,1367,Texas,Suburb,NA,100.0,100.0,100.0,22,7,58,12,3,31,34,10,89,33.005559356004,0.4437280497220734
Spalding University,1250,916,Kentucky,Large City,NA,95.16,66.45,99.98,2,1,6,1,0,3,3,1,9,2.618542982580533,0.40649210325617835
Spelman College,2139,2086,Georgia,Large City,NA,100.0,98.2,100.0,8,3,20,4,1,11,12,4,31,1.3063612961635096,10.313301106594672
Spring Arbor University,1958,1380,Michigan,Suburb,NA,99.86,89.42,100.0,4,1,12,2,1,7,6,2,19,5.7791857001847395,0.763987680577035
Spring Hill College,1376,1363,Alabama,Midsize City,NA,99.98,95.71,100.0,5,2,13,3,1,7,8,3,20,2.541245775080813,5.7756872174965785
Springfield College,2230,2188,Massachusetts,Midsize City,private,99.71,93.7,100.0,4,2,8,2,1,5,6,3,13,3.4292839700586346,2.406185856232571
St. Andrews University,641,567,North CaroliNA,Town,NA,96.68,70.35,100.0,2,1,7,1,0,3,3,1,10,0.24557494758259185,3.1369813059260636
St Catherine University,3157,2124,Minnesota,Large City,private,91.16,60.23,99.97,2,1,5,1,0,3,3,1,8,0.9285893697776747,1.4866717240592633
St. Francis College,2286,2097,New York,Large City,NA,99.72,95.05,100.0,4,2,8,2,1,4,6,3,12,5.308366753018117,0.5714173857507817
St John's College MD,466,458,Maryland,Suburb,NA,91.5,59.25,99.79,2,1,4,1,0,2,3,1,6,0.22597193215927794,2.222037784298965
St. John's College,319,309,New Mexico,Rural,NA,80.0,43.84,98.77,1,0,3,1,0,2,2,0,5,0.12500380949554213,1.475046803410478
St John's University - New York,16760,11526,New York,Large City,NA,100.0,100.0,100.0,39,18,88,20,9,47,59,27,135,28.739675204188696,29.951406958491894
St Lawrence University,2411,2372,New York,Town,private,99.7,93.51,100.0,4,2,8,2,1,4,6,3,12,2.5801819812532294,3.2038735769666857
St Mary's College of Maryland,1574,1516,Maryland,Suburb,NA,98.69,84.49,100.0,3,1,7,1,1,4,4,2,11,3.3946005808815976,0.9346266050986398
St. Mary's University,2323,2228,Texas,Large City,NA,100.0,100.0,100.0,37,11,99,20,6,53,57,17,152,56.580958896006855,0.669141629158825
St Olaf College,3039,3003,Minnesota,Town,NA,99.68,86.95,100.0,4,1,11,2,1,6,6,2,17,0.5216232461242142,5.189830576241871
Stanford University,7064,7064,California,Suburb,NA,100.0,100.0,100.0,28,11,77,15,6,40,43,17,117,17.515065246390567,25.372191364683516
SUNY New Paltz,6733,6235,New York,Suburb,NA,100.0,99.98,100.0,11,6,23,6,3,12,17,9,35,15.727763205038805,1.3304847941730544
Stephen F Austin State University,10988,9567,Texas,Town,NA,100.0,100.0,100.0,183,55,491,101,29,263,284,84,754,282.64284559625645,0.9393332492907023
Stephens College,654,542,Missouri,Midsize City,NA,79.48,38.82,99.69,1,0,4,1,0,2,2,0,6,0.5135358173147239,1.060433190679371
Sterling College Kansas,698,599,Kansas,Rural,private,96.99,67.99,99.99,2,1,6,1,0,3,3,1,9,0.20722921523698998,3.262220394546703
Sterling College Vermont,155,120,Vermont,Rural,private,36.65,17.58,68.28,0,0,1,0,0,0,0,0,1,2.2651560294659038e-05,0.4554821744517465
Stetson University,3068,3028,Florida,Suburb,private,100.0,100.0,100.0,27,11,61,14,6,34,41,17,95,38.744254308142835,2.1051008391754036
Stevens Institute of Technology,3125,3113,New Jersey,Suburb,NA,100.0,99.87,100.0,10,4,24,5,2,13,15,6,37,11.435414917844444,3.7938852533344827
Stevenson University,3401,2926,Maryland,Rural,NA,99.99,98.05,100.0,6,3,14,3,1,7,9,4,21,7.321490601960606,1.6195459370104786
Stillman College,675,552,Alabama,Midsize City,NA,95.15,63.46,99.97,2,1,5,1,0,3,3,1,8,1.8157816222614156,1.1977226400144618
Stonehill College,2494,2482,Massachusetts,Suburb,private,99.96,97.2,100.0,5,2,11,3,1,6,8,3,17,5.52705108727399,2.1878353393878407
Stony Brook University,17369,16212,New York,Suburb,NA,100.0,100.0,100.0,31,15,65,16,8,34,47,23,99,38.12305212262778,8.105286061576368
Stratford University,1979,471,Virginia,Suburb,NA,100.0,98.31,100.0,9,3,19,5,1,11,14,4,30,11.695616252335553,1.851665737365605
Strayer University - District of Columbia,691,107,District of Columbia,Large City,NA,82.92,53.99,97.74,1,1,2,1,0,1,2,1,3,0.8739454435549734,0.8910211977974146
Suffolk University,5028,4762,Massachusetts,Large City,private,100.0,99.97,100.0,12,5,29,6,3,16,18,8,45,13.403098886639425,5.004505900240797
Sul Ross State University,2292,1378,Texas,Town,NA,100.0,100.0,100.0,38,11,102,21,6,54,59,17,156,58.38840619407374,0.23834426034715567
Sullivan University,2596,1321,Kentucky,Large City,NA,99.72,87.8,100.0,4,1,11,2,1,6,6,2,17,4.397994843671172,1.4873809264703681
Summit Christian College,32,17,Nebraska,Town,NA,0.98,0.35,2.93,0,0,0,0,0,0,0,0,0,0.0010231305051612162,0.00885153939779384
University at Albany,13510,12740,New York,Small City,public,100.0,100.0,100.0,23,12,47,12,6,25,35,18,72,31.6331297586916,2.879543311285498
Binghamton University,13739,13345,New York,Suburb,public,100.0,100.0,100.0,25,13,53,13,6,28,38,19,81,28.978946382182542,9.03837473815569
SUNY Fredonia,4393,4281,New York,Town,NA,100.0,99.65,100.0,7,4,15,4,2,8,11,6,23,10.673467909065701,0.1896496798929714
SUNY Geneseo,5558,5452,New York,Town,NA,100.0,99.92,100.0,9,5,19,5,2,10,14,7,29,13.418919673056948,0.40551934337249024
Purchase College,4062,3712,New York,Suburb,public,100.0,99.63,100.0,8,4,16,4,2,9,12,6,25,7.9206160055488715,3.6459649777561705
The College at Brockport,7182,6419,New York,Town,NA,100.0,99.99,100.0,12,6,24,6,3,13,18,9,37,17.370594179718204,0.6688356896232022
Buffalo State,8527,7665,New York,Large City,NA,100.0,100.0,100.0,14,7,29,7,4,15,21,11,44,20.545254036193256,0.9266821224155573
SUNY Cortland,6345,6196,New York,Town,public,100.0,99.97,100.0,11,5,23,5,3,12,16,8,35,14.970482260254158,1.138063041494771
SUNY Old Westbury,4634,4056,New York,Suburb,public,100.0,99.72,100.0,7,4,15,4,2,8,11,6,23,11.255612218411555,0.05746051778626558
SUNY Oneonta,5940,5828,New York,Town,NA,100.0,99.95,100.0,10,5,20,5,3,10,15,8,30,14.467272772514523,0.2202498364929495
SUNY Oswego,7123,6836,New York,Town,NA,100.0,99.99,100.0,12,6,24,6,3,13,18,9,37,17.296592784462376,0.44857786657439863
SUNY Plattsburgh,5353,4894,New York,Town,public,100.0,99.88,100.0,9,4,18,4,2,9,13,6,27,12.565436914439724,0.46674268322111945
SUNY Potsdam,3323,3196,New York,Town,public,99.98,98.61,100.0,5,3,11,3,1,6,8,4,17,7.915682579198483,0.37423768260477003
SUNY College of Environmental Science and Forestry,1791,1737,New York,Midsize City,NA,99.45,91.86,100.0,3,2,7,2,1,4,5,3,11,3.7272036077185753,1.4635573316122286
SUNY Empire State College,9810,3772,New York,Suburb,NA,100.0,100.0,100.0,17,9,35,9,4,19,26,13,54,22.713494917189042,2.842516821564835
SUNY Polytechnic Institute,2179,1859,New York,Suburb,NA,99.54,93.91,100.0,4,2,7,2,1,4,6,3,11,5.374968008748362,0.0
SUNY Maritime College,1640,1581,New York,Large City,public,99.58,92.24,100.0,4,2,8,2,1,4,6,3,12,2.974856089284316,2.4802985756167057
SusquehanNA University,2354,2283,Pennsylvania,Town,NA,99.93,96.35,100.0,5,2,11,2,1,6,7,3,17,2.0285478940914996,5.252221232650813
Swarthmore College,1581,1573,Pennsylvania,Suburb,NA,99.91,93.43,100.0,5,2,12,2,1,6,7,3,18,0.37967473953584213,6.612512173047819
Sweet Briar College,320,314,Virginia,Suburb,NA,87.88,47.56,99.8,1,0,4,1,0,2,2,0,6,1.3263929986600234,0.7732909458468152
Syracuse University,15248,14675,New York,Midsize City,NA,100.0,100.0,100.0,36,16,84,19,8,45,55,24,129,15.683362367885309,39.24464227449651
Tabor College,712,554,Kansas,Town,private,97.87,72.81,100.0,2,1,6,1,0,3,3,1,9,0.17982700495771856,3.6348445785621815
Talladega College,782,762,Alabama,Town,NA,97.64,74.33,99.99,2,1,6,1,0,3,3,1,9,1.8921462699266154,1.8369338100579273
Tarleton State University,11290,8429,Texas,Town,NA,100.0,100.0,100.0,189,57,506,104,30,272,293,87,778,291.6538871982131,0.7170947856208126
Taylor University,2111,1840,IndiaNA,Town,NA,99.74,92.21,100.0,4,2,9,2,1,5,6,3,14,2.080430061789205,3.86193118454588
Temple University,29583,26643,Pennsylvania,Large City,NA,100.0,100.0,100.0,46,22,102,24,11,54,70,33,156,40.63785295498631,29.352848885258013
Tennessee State University,6504,5431,Tennessee,Large City,NA,100.0,99.28,100.0,11,3,35,6,2,18,17,5,53,9.899635801262113,7.214127139176264
Tennessee Technological University,9365,8259,Tennessee,Town,NA,100.0,99.38,100.0,14,4,44,7,2,22,21,6,66,19.202604249477016,1.1919427110090641
Tennessee Wesleyan University,931,863,Tennessee,Town,NA,92.18,51.53,99.96,2,0,5,1,0,3,3,0,8,1.766891703917962,0.7736474399732477
Texas A&M InterNAtioNAl University,6800,5191,Texas,Large City,public,100.0,100.0,100.0,114,34,307,63,18,164,177,52,471,176.86788632677698,0.1345925211755522
Texas A&M University - College Station,53069,46724,Texas,Midsize City,public,100.0,100.0,100.0,872,263,2339,479,140,1254,1351,403,3593,1342.3308600310072,7.979527232693428
Texas A&M University - Commerce,8490,6068,Texas,Town,NA,100.0,100.0,100.0,141,42,380,77,23,203,218,65,583,216.81509110289295,1.2341104650055652
Texas A&M University - Corpus Christi,10174,8355,Texas,Large City,NA,100.0,100.0,100.0,170,51,455,93,27,244,263,78,699,262.2632224383429,0.4771994760712914
Texas A&M University - Kingsville,6782,5020,Texas,Town,NA,100.0,100.0,100.0,114,34,305,63,18,164,177,52,469,175.89867545679908,0.38343525814103874
Texas A&M University - TexarkaNA,1611,1166,Texas,Rural,NA,100.0,100.0,100.0,22,7,59,12,4,32,34,11,91,33.81760089571521,0.404426990265088
Texas Christian University,9009,8738,Texas,Large City,NA,100.0,100.0,100.0,108,33,288,59,18,155,167,51,443,153.63302033568527,13.055044541673977
Texas College,993,940,Texas,Midsize City,NA,100.0,99.82,100.0,13,4,35,7,2,19,20,6,54,18.93890429713563,1.5447841780240767
Texas Lutheran University,1359,1305,Texas,Town,private,100.0,100.0,100.0,23,7,61,12,4,33,35,11,94,34.97017598433757,0.2124308008414527
Texas Southern University,7971,6695,Texas,Large City,NA,100.0,100.0,100.0,114,35,306,63,19,164,177,54,470,169.1141993669538,7.755422558676567
Texas State University,34177,28019,Texas,Suburb,NA,100.0,100.0,100.0,572,172,1534,314,92,823,886,264,2357,884.6275754060405,1.4348798730347567
Texas Tech University,30737,27318,Texas,Large City,public,100.0,100.0,100.0,497,150,1335,273,80,716,770,230,2051,763.1356831098925,6.616483796201319
Texas Wesleyan University,1675,1497,Texas,Large City,NA,100.0,100.0,100.0,28,8,74,15,4,40,43,12,114,42.40952428362736,0.38785514986864356
Texas Woman's University,10311,6968,Texas,Midsize City,NA,100.0,100.0,100.0,172,52,462,95,28,248,267,80,710,266.1400659182545,0.45608272914313946
The College of Idaho,938,896,Idaho,Suburb,NA,99.9,68.23,100.0,4,1,16,3,0,10,7,1,26,5.76718645936852,1.0777321262160364
The College of New Jersey,6956,6728,New Jersey,Suburb,NA,100.0,100.0,100.0,25,11,60,13,5,31,38,16,91,36.1864166373255,1.0347721734421549
The College of Saint Rose,2504,2426,New York,Small City,NA,99.8,95.89,100.0,4,2,8,2,1,4,6,3,12,5.666040163421289,0.5235700710176577
The College of Saint Scholastica,2678,2179,Minnesota,Small City,NA,83.61,47.76,99.83,1,0,4,1,0,2,2,0,6,0.7406050178198109,1.0604892788222728
The College of Wooster,1979,1962,Ohio,Town,NA,99.82,91.41,100.0,4,2,10,2,1,6,6,3,16,1.4075100749577978,4.8840288718309885
The Evergreen State College,3615,3330,Washington,Suburb,NA,100.0,99.99,100.0,12,6,28,7,3,16,19,9,44,11.905906563842912,6.774621078882905
The King's College,555,542,New York,Large City,NA,98.43,76.96,100.0,3,1,7,1,0,4,4,1,11,0.1554029300372404,3.9601800000626
The Master's College and SemiNAry,1353,975,California,Suburb,NA,99.96,95.99,100.0,5,2,13,3,1,7,8,3,20,5.346082309606564,2.3563615906661424
The New School,7124,6224,New York,Large City,private,100.0,100.0,100.0,24,10,57,12,5,31,36,15,88,4.153944987027188,31.79402829842325
Stockton University,8276,7809,New Jersey,Suburb,NA,100.0,100.0,100.0,30,13,73,15,6,38,45,19,111,44.61686476142586,0.5082801807699796
The University of Alabama,33303,29923,Alabama,Midsize City,NA,100.0,100.0,100.0,123,43,315,65,22,169,188,65,484,80.8404645144656,107.1823161893435
The University of Findlay,3563,2499,Ohio,Town,private,99.96,95.57,100.0,5,2,12,3,1,7,8,3,19,5.476245976288085,2.3704157397587293
The University of MontaNA,9322,7444,MontaNA,Small City,NA,100.0,99.45,100.0,140,3,1550,71,2,692,211,5,2242,198.0639018366191,12.96039707605856
The University of MontaNA - Western,1540,1230,MontaNA,Town,public,100.0,56.23,100.0,23,1,258,12,0,115,35,1,373,32.69979667320853,2.7404109955390754
The University of Tampa,7970,7728,Florida,Large City,NA,100.0,100.0,100.0,36,16,84,19,8,46,55,24,130,38.195846729948,17.58653235963822
The University of Tennessee - Knoxville,22315,20965,Tennessee,Midsize City,NA,100.0,100.0,100.0,37,10,114,18,5,57,55,15,171,42.006222031076966,12.259722171815152
The University of Tennessee - Chattanooga,10172,8962,Tennessee,Midsize City,NA,100.0,99.58,100.0,15,4,49,7,2,24,22,6,73,20.652253804415654,1.5083775040961718
The University of Tennessee - Martin,6327,4950,Tennessee,Town,NA,100.0,96.95,100.0,9,2,30,4,1,15,13,3,45,12.872467859578302,1.0075572476128833
The University of Texas at Arlington,33305,17819,Texas,Large City,public,100.0,100.0,100.0,555,167,1489,305,89,799,860,256,2288,856.2847061812815,3.4898870045243204
The University of Texas at Austin,40489,37740,Texas,Large City,NA,100.0,100.0,100.0,639,194,1714,351,103,919,990,297,2633,975.6024227420738,14.064512612937401
The University of Texas at Dallas,18474,15294,Texas,Midsize City,NA,100.0,100.0,100.0,303,91,814,166,49,437,469,140,1251,465.064048259123,3.8021738972544896
The University of Texas at El Paso,21335,14025,Texas,Large City,NA,100.0,100.0,100.0,355,107,953,195,57,511,550,164,1464,548.5995472958665,1.8433895650089953
The University of Texas at San Antonio,26437,21510,Texas,Large City,NA,100.0,100.0,100.0,441,133,1184,242,71,635,683,204,1819,681.879139362016,1.73715392621442
The University of Texas at Tyler,7440,4842,Texas,Midsize City,NA,100.0,100.0,100.0,123,37,331,68,20,177,191,57,508,190.4630333948453,0.5387381272426013
The University of Texas of the Permian Basin,6066,2192,Texas,Midsize City,public,100.0,100.0,100.0,100,30,269,55,16,144,155,46,413,155.12612897321878,0.4686009967634724
The University of Texas Rio Grande Valley,24216,18647,Texas,Small City,public,100.0,100.0,100.0,407,123,1092,224,65,586,631,188,1678,629.8037012669874,1.1539771255565647
The University of Virginia's College at Wise,2093,1210,Virginia,Town,NA,100.0,99.25,100.0,11,3,24,6,2,14,17,5,38,16.867714737676526,0.35807890199281583
The University of West Florida,10000,6906,Florida,Small City,public,100.0,100.0,100.0,92,39,210,49,20,117,141,59,327,136.82027984639114,3.618909398904096
Thiel College,764,751,Pennsylvania,Town,NA,82.46,55.1,98.07,1,1,3,1,0,1,2,1,4,0.82805252717817,0.9086288773572838
Thomas AquiNAs College,364,369,California,Rural,private,88.61,49.84,100.0,1,0,6,1,0,3,2,0,9,0.9333491767047924,1.2253652451447696
Thomas College,1660,774,Maine,Rural,NA,92.06,58.3,99.78,2,1,4,1,0,2,3,1,6,0.9364214839408934,1.5907662541219034
Thomas More College,1878,1356,Kentucky,Suburb,NA,98.73,79.59,100.0,3,1,8,1,1,4,4,2,12,2.428059653276793,1.9317935814001543
Thomas More College of Liberal Arts,90,90,New Hampshire,Suburb,private,26.11,8.19,60.04,0,0,1,0,0,0,0,0,1,0.0,0.3013964908600214
Thomas University,1118,438,Georgia,Town,NA,99.91,91.34,100.0,5,2,13,2,1,7,7,3,20,1.885067141379868,5.128351947443543
Tiffin University,2243,1772,Ohio,Town,private,100.0,98.18,100.0,7,3,19,4,1,10,11,4,29,1.668376395904333,9.480327574227728
Toccoa Falls College,1420,872,Georgia,Town,NA,99.71,84.23,100.0,4,1,12,2,1,7,6,2,19,2.073085496154803,3.7424857993904928
Tougaloo College,794,766,Mississippi,Midsize City,private,99.99,98.09,100.0,6,3,13,3,1,7,9,4,20,8.533086489006722,0.6423467257283585
Touro College,6428,4232,New York,Large City,NA,100.0,99.99,100.0,13,6,31,7,3,16,20,9,47,14.292136137075728,5.6163907913157844
Towson University,19592,17106,Maryland,Small City,NA,100.0,100.0,100.0,37,17,86,19,8,47,56,25,133,35.241578219862504,21.215614158754263
Transylvania University,962,963,Kentucky,Large City,private,91.47,57.38,99.9,2,1,5,1,0,2,3,1,7,1.8541984839819798,0.6021559430634844
Trevecca Nazarene University,2216,1317,Tennessee,Large City,NA,99.98,94.85,100.0,6,2,15,3,1,8,9,3,23,2.8299680442062956,5.7444384934146635
Trident University InterNAtioNAl,4368,1862,California,Suburb,private,100.0,99.94,100.0,15,5,41,8,2,22,23,7,63,0.8742764440019575,22.09992427253012
Trine University,4099,1938,IndiaNA,Town,NA,100.0,99.54,100.0,8,4,19,4,2,10,12,6,29,6.548283817673795,5.720112780761788
Trine University - RegioNAl/Non - TraditioNAl Campuses,368,210,IndiaNA,Large City,NA,51.18,24.44,81.66,0,0,1,0,0,1,0,0,2,0.0,0.716409000808395
Trinity Christian College,1109,907,Illinois,Suburb,private,86.76,57.39,99.55,1,1,4,1,0,2,2,1,6,0.8053628041327205,1.2121219850813787
Trinity College,2218,2117,Connecticut,Midsize City,NA,99.94,96.17,100.0,5,2,12,3,1,6,8,3,18,0.1315417993193934,7.267163745526585
Trinity InterNAtioNAl University - Florida,156,64,Florida,Suburb,NA,90.27,62.26,99.58,2,1,3,1,0,2,3,1,5,2.3122049242809037,0.0
Trinity InterNAtioNAl University - Illinois,936,592,Illinois,Suburb,NA,90.84,63.17,99.77,2,1,4,1,0,2,3,1,6,0.5084705839651499,1.870502286088739
Trinity University,2389,2353,Texas,Large City,NA,100.0,100.0,100.0,30,9,80,16,5,43,46,14,123,43.43112493036082,2.783840430139798
Trinity Washington University,1530,1075,District of Columbia,Large City,NA,98.02,82.33,99.98,3,1,5,1,1,3,4,2,8,2.0969808268539727,1.8189901404654287
Troy University,14006,9491,Alabama,Town,public,100.0,100.0,100.0,45,16,118,23,8,63,68,24,181,41.24963718048539,26.624211021259434
Truett McConnell University,2574,780,Georgia,Town,NA,99.82,63.92,100.0,4,1,18,2,0,10,6,1,28,6.038563524135251,0.24999745597522954
Truman State University,5895,5134,Missouri,Town,NA,99.96,91.32,100.0,5,2,16,3,1,8,8,3,24,5.538357132923368,2.2687146993398097
Tufts University,5543,5483,Massachusetts,Suburb,NA,100.0,99.99,100.0,15,6,37,8,3,20,23,9,57,4.986907458290395,18.14999846035516
Tulane University of LouisiaNA,7872,6716,LouisiaNA,Large City,private,100.0,100.0,100.0,31,12,81,16,6,43,47,18,124,6.185750364119125,40.86172326794163
Tusculum College,1485,1376,Tennessee,Town,NA,99.81,86.85,100.0,4,1,11,2,1,6,6,2,17,2.044215966601875,4.190939139006897
Tuskegee University,2830,2722,Alabama,Town,NA,100.0,99.16,100.0,9,3,23,5,2,13,14,5,36,3.2794373691777436,10.09500526947342
Union College Kentucky,1096,918,Kentucky,Town,private,94.67,63.18,99.98,2,1,6,1,0,3,3,1,9,2.039859450518537,0.8863865725878728
Union College Nebraska,779,707,Nebraska,Large City,private,96.71,65.24,99.99,2,1,6,1,0,3,3,1,9,0.009080283233305793,3.3791775367408756
Union College New York,2265,2176,New York,Small City,NA,99.88,95.73,100.0,4,2,10,2,1,5,6,3,15,2.2767762607043314,4.428311783624608
Union Institute & University,814,434,Ohio,Large City,NA,99.92,94.81,100.0,5,2,11,2,1,6,7,3,17,0.5003182424123845,6.588574077670906
Union University,2179,1599,Tennessee,Small City,NA,99.84,85.98,100.0,4,1,12,2,1,6,6,2,18,3.1367054862657753,3.298342417065542
United States Air Force Academy,4279,4276,Colorado,Town,NA,100.0,100.0,100.0,20,7,55,11,4,29,31,11,84,0.26049851234431665,30.215837836932234
United States Coast Guard Academy,1047,1044,Connecticut,Small City,NA,99.89,91.46,100.0,4,2,11,2,1,6,6,3,17,0.013190821101666188,6.7722152561965965
United States Merchant Marine Academy,952,954,New York,Suburb,public,99.85,88.48,100.0,4,1,13,2,1,7,6,2,20,0.37247368945433806,6.068340817935026
United States Military Academy,4487,4491,New York,Town,public,100.0,100.0,100.0,19,7,51,10,4,27,29,11,78,0.777014650186202,28.846495396142977
United States Naval Academy,4495,4495,Maryland,Suburb,NA,100.0,100.0,100.0,18,7,49,10,3,26,28,10,75,1.0043196984856797,27.125655938672832
Unity College,706,694,Maine,Rural,private,85.34,52.82,99.11,1,0,3,1,0,2,2,0,5,0.1898151656636946,1.72258172962229
Polytechnic University of Puerto Rico - Orlando,124,53,Florida,Suburb,NA,84.3,53.91,98.7,1,1,3,1,0,2,2,1,5,1.8379064782745644,0.0
University at Buffalo,21016,19401,New York,Suburb,NA,100.0,100.0,100.0,37,19,76,19,9,40,56,28,116,48.68305122563454,6.791447136078622
University of Advancing Technology,775,508,ArizoNA,Midsize City,NA,99.26,82.15,100.0,3,1,8,2,1,4,5,2,12,0.5157992980475807,4.352488254346486
University of Akron Main Campus,16874,13563,Ohio,Midsize City,public,100.0,100.0,100.0,22,9,51,11,4,27,33,13,78,31.794542938050835,1.5117399608369189
University of Alabama at Birmingham,13130,9677,Alabama,Midsize City,NA,100.0,100.0,100.0,38,14,95,19,7,50,57,21,145,50.38369753732844,7.328762137229713
University of Alabama in Huntsville,7089,5903,Alabama,Midsize City,NA,100.0,100.0,100.0,20,7,53,10,3,27,30,10,80,24.966997306094466,4.819174812164744
University of Alaska Anchorage,14954,6974,Alaska,Large City,NA,98.22,73.05,100.0,3,1,10,1,0,5,4,1,15,0.008456648016117169,3.988346481847173
University of Alaska Fairbanks,6633,3022,Alaska,Suburb,public,94.83,66.64,99.96,2,1,5,1,0,3,3,1,8,0.003603678518678022,2.9385160295918107
University of Alaska Southeast,2060,629,Alaska,Town,NA,68.74,38.02,94.57,1,0,2,0,0,1,1,0,3,0.0010974140716931923,1.1557501585157801
University of ArizoNA,34099,29325,ArizoNA,Large City,NA,100.0,100.0,100.0,120,59,266,62,30,138,182,89,404,112.89430714619843,68.66293811707335
University of Arkansas,23037,20464,Arkansas,Small City,NA,100.0,100.0,100.0,94,28,255,51,15,136,145,43,391,16.391659852065377,128.66988304798522
University of Arkansas at Little Rock,8794,4603,Arkansas,Midsize City,NA,100.0,96.76,100.0,8,2,23,4,1,12,12,3,35,9.899340466998535,2.7054468551575397
University of Arkansas at Pine Bluff,2517,2341,Arkansas,Small City,public,99.97,92.57,100.0,5,2,14,3,1,8,8,3,22,1.6109284463481364,6.612806102659731
University of Baltimore,2950,1716,Maryland,Large City,NA,99.93,96.05,100.0,5,2,11,3,1,6,8,3,17,6.980021904475474,0.3385871498064159
University of Bridgeport,3124,2300,Connecticut,Midsize City,private,99.91,96.79,100.0,5,2,10,2,1,5,7,3,15,0.38143457685651394,6.661292563063472
University of California - Berkeley,30577,29351,California,Midsize City,public,100.0,100.0,100.0,124,54,306,64,27,162,188,81,468,151.59244666201508,36.01835021062214
University of California - Davis,30067,29284,California,Suburb,NA,100.0,100.0,100.0,118,53,284,60,26,150,178,79,434,174.94980517271603,2.69816413747654
University of California - Irvine,29310,28855,California,Large City,public,100.0,100.0,100.0,115,52,277,58,26,146,173,78,423,171.22231573916713,2.0587035982647133
University of California - Los Angeles,31001,30458,California,Large City,NA,100.0,100.0,100.0,123,54,297,63,27,157,186,81,454,170.10584109108356,15.121681986517036
University of California - Riverside,20077,19719,California,Large City,public,100.0,100.0,100.0,79,35,189,40,18,100,119,53,289,118.25770359780532,0.3894047625702509
University of California - San Diego,28582,27880,California,Large City,NA,100.0,100.0,100.0,113,50,273,57,25,144,170,75,417,163.34792046987923,6.734247991456031
University of California - Santa Barbara,22182,21777,California,Suburb,NA,100.0,100.0,100.0,87,39,210,44,19,111,131,58,321,126.28568797212058,4.626292701290843
University of California - Santa Cruz,17573,17082,California,Small City,NA,100.0,100.0,100.0,69,31,166,35,15,88,104,46,254,102.66250216425688,1.3402443975679283
University of Central Arkansas,9549,8070,Arkansas,Small City,NA,100.0,99.86,100.0,15,4,41,8,2,21,23,6,62,10.16667126520717,12.796140205493469
University of Central Florida,56854,39962,Florida,Suburb,NA,100.0,100.0,100.0,528,224,1213,282,115,672,810,339,1885,793.6050529536693,15.868595664718963
University of Central Missouri,9800,7701,Missouri,Town,NA,100.0,97.06,100.0,8,2,25,4,1,12,12,3,37,10.480275805378065,1.1942810748836938
University of Central Oklahoma,14340,10448,Oklahoma,Suburb,public,100.0,100.0,100.0,34,10,102,19,5,58,53,15,160,47.704768970981156,5.317242055102803
University of Charleston,1833,1220,West Virginia,Small City,NA,98.57,79.21,100.0,3,1,6,1,1,4,4,2,10,0.16005613638090002,4.069199383458847
University of Chicago,6305,6288,Illinois,Large City,private,100.0,100.0,100.0,19,7,49,10,4,26,29,11,75,1.399147244467862,27.50486845844055
University of CincinNAti - Main Campus,26558,22622,Ohio,Large City,NA,100.0,100.0,100.0,39,15,93,20,8,49,59,23,142,46.007863902458695,13.076672641789074
University of Colorado at Colorado Springs,10804,8171,Colorado,Large City,public,100.0,98.66,100.0,10,3,32,5,1,17,15,4,49,7.502666352563612,6.993724590092926
University of Colorado Boulder,29057,26977,Colorado,Midsize City,NA,100.0,100.0,100.0,56,20,155,29,10,83,85,30,238,13.228995668429183,72.17862584314636
University of Colorado Denver/Anschutz Medical Campus,15589,8671,Colorado,Large City,NA,100.0,99.7,100.0,13,4,41,7,2,22,20,6,63,11.176700267022179,8.662049421711727
University of Connecticut,19243,18555,Connecticut,Suburb,NA,100.0,100.0,100.0,18,9,38,9,4,20,27,13,58,4.736970422287236,22.14218778101336
University of Dallas,1456,1421,Texas,Midsize City,private,100.0,99.8,100.0,14,4,44,8,2,23,22,6,67,16.817118338535373,4.47784893025343
University of Dayton,8498,8079,Ohio,Midsize City,NA,100.0,99.95,100.0,13,5,31,7,3,16,20,8,47,9.025195999314453,10.119344989489742
University of Delaware,19752,18195,Delaware,Suburb,NA,100.0,100.0,100.0,28,13,64,14,7,34,42,20,98,4.147454082707325,38.39895591596697
University of Denver,5768,5494,Colorado,Large City,NA,100.0,99.84,100.0,13,4,44,7,2,23,20,6,67,2.068528246389885,17.88180321290675
University of Detroit Mercy,2839,2338,Michigan,Large City,private,99.99,96.27,100.0,6,2,18,3,1,10,9,3,28,9.094720892566668,0.5413705248952858
University of Dubuque,1953,1709,Iowa,Small City,NA,99.42,81.33,100.0,3,1,10,2,1,6,5,2,16,1.7999375742620556,3.337699430845476
University of Evansville,2346,2024,IndiaNA,Midsize City,NA,99.98,96.9,100.0,6,2,14,3,1,7,9,3,21,3.530426771521075,5.051180745594219
University of Florida,35251,31384,Florida,Midsize City,NA,100.0,100.0,100.0,331,141,760,177,72,421,508,213,1181,500.20699861943547,7.45497257088971
University of Georgia,28844,27142,Georgia,Midsize City,NA,100.0,100.0,100.0,60,13,230,31,7,130,91,20,360,62.2633769922866,29.328633475992678
University of Providence,930,469,MontaNA,Small City,private,100.0,50.79,100.0,13,0,138,7,0,62,20,0,200,17.44791358828054,1.9050605028656455
University of Hartford,5073,4460,Connecticut,Midsize City,NA,100.0,99.66,100.0,8,4,17,4,2,9,12,6,26,0.6467166456789117,11.247604957683523
University of Hawaii at Hilo,2972,2340,Hawaii,Town,public,97.4,69.54,100.0,2,1,10,1,0,5,3,1,15,0.00021037193265975148,3.62458526766392
University of Hawaii at Manoa,12877,10702,Hawaii,Large City,NA,100.0,99.97,100.0,14,5,39,7,3,21,21,8,60,0.0008187664926770251,20.74112148393405
University of Hawaii - West Oahu,3083,1611,Hawaii,Suburb,NA,17.77,9.77,34.03,0,0,0,0,0,0,0,0,0,0.00026953625425487005,0.19482849882238537
University of Houston,37217,27159,Texas,Large City,public,100.0,100.0,100.0,616,186,1653,338,99,887,954,285,2540,950.9792276669597,3.535787099415491
University of Houston - Downtown,12402,6320,Texas,Large City,public,100.0,100.0,100.0,208,63,557,114,33,299,322,96,856,320.80879796268334,0.8420679851789351
University of Houston - Victoria,3273,1722,Texas,Small City,public,100.0,100.0,100.0,55,17,148,30,9,80,85,26,228,85.73586966047705,0.0
University of Idaho,9889,7166,Idaho,Town,NA,100.0,100.0,100.0,43,10,160,25,5,93,68,15,253,47.16211871087657,20.841015282845706
University of Illinois at Chicago,19446,17961,Illinois,Large City,public,100.0,100.0,100.0,15,8,37,8,4,19,23,12,56,21.75048330200812,1.4815453988663954
University of Illinois at Springfield,2932,1903,Illinois,Midsize City,public,97.35,83.37,99.99,2,1,6,1,1,3,3,2,9,3.266951939928211,0.3581666072044565
University of Illinois at UrbaNA - Champaign,33955,32613,Illinois,Small City,NA,100.0,100.0,100.0,32,15,79,16,8,41,48,23,120,35.472363960557566,13.362257425977091
University of IndiaNApolis,4486,3828,IndiaNA,Large City,NA,100.0,99.77,100.0,8,4,17,4,2,9,12,6,26,11.142224243969853,1.0470551631147382
University of Iowa,24506,21222,Iowa,Small City,public,100.0,100.0,100.0,35,10,120,18,5,66,53,15,186,34.45594785015935,19.125102150870635
University of Kansas,19344,17151,Kansas,Small City,public,100.0,100.0,100.0,24,8,59,13,4,31,37,12,90,8.015146506686884,28.110971834577835
University of Kentucky,22420,20657,Kentucky,Large City,NA,100.0,100.0,100.0,39,14,108,20,7,57,59,21,165,41.40962908180302,17.966523644131183
University of La Verne,5169,3759,California,Suburb,NA,100.0,100.0,100.0,20,9,49,10,4,26,30,13,75,28.998804483821683,1.265281142291983
University of LouisiaNA at Lafayette,15665,12767,LouisiaNA,Midsize City,NA,100.0,100.0,100.0,63,23,166,33,12,88,96,35,254,88.36119935776574,8.33920367954868
University of LouisiaNA at Monroe,7946,5212,LouisiaNA,Small City,NA,100.0,100.0,100.0,34,12,88,18,6,47,52,18,135,43.29442243538984,7.788824953827482
University of Louisville,15543,12025,Kentucky,Large City,NA,100.0,100.0,100.0,27,10,73,14,5,39,41,15,112,31.38152570744534,8.936782293512778
University of Maine,9277,8204,Maine,Suburb,NA,100.0,96.02,100.0,7,2,17,4,1,10,11,3,27,5.9760141323119855,4.839394847275099
University of Maine at Augusta,4013,1317,Maine,Town,public,95.89,46.27,99.98,2,0,5,1,0,3,3,0,8,3.1572589222061205,0.03406775808944788
University of Maine at Farmington,1810,1673,Maine,Town,public,86.01,41.56,99.34,1,0,3,1,0,2,2,0,5,1.2045354054408621,0.7590469675914748
University of Maine at Fort Kent,1762,582,Maine,Rural,NA,79.84,31.68,98.37,1,0,3,1,0,1,2,0,4,1.31763360831548,0.28285917999569865
University of Maine at Machias,698,367,Maine,Rural,public,65.03,29.61,92.1,1,0,2,0,0,1,1,0,3,0.42312964012531923,0.6245799255443456
University of Maine at Presque Isle,1413,716,Maine,Rural,NA,71.19,24.38,96.09,1,0,2,0,0,1,1,0,3,1.0558468590043013,0.18783846811421673
University of Mary,2234,1794,North Dakota,Rural,NA,100.0,99.2,100.0,21,3,103,11,2,54,32,5,157,23.943058878818988,8.0484206028774
University of Mary Hardin - Baylor,3329,3045,Texas,Suburb,NA,100.0,100.0,100.0,55,17,149,30,9,80,85,26,229,85.44772588832147,0.38201940480320107
University of Mary Washington,4399,3905,Virginia,Suburb,NA,100.0,99.99,100.0,21,6,45,12,3,27,33,9,72,30.131644724276757,2.6469709822863834
University of Maryland - Baltimore County,11238,9543,Maryland,Suburb,public,100.0,100.0,100.0,19,9,45,10,4,25,29,13,70,26.026944986256392,3.582371917788962
University of Maryland - College Park,29870,27708,Maryland,Suburb,public,100.0,100.0,100.0,60,26,141,31,13,77,91,39,218,50.4118272654887,40.42387122580928
University of Maryland Eastern Shore,2860,2573,Maryland,Town,public,99.96,96.66,100.0,5,2,12,3,1,7,8,3,19,5.463499159762097,2.461798912656845
University of Maryland - University College,45609,9714,Maryland,Suburb,NA,100.0,100.0,100.0,108,43,274,58,22,149,166,65,423,77.01123447988192,89.4622212623214
University of Massachusetts Amherst,23386,21577,Massachusetts,Suburb,NA,100.0,100.0,100.0,59,28,129,31,14,70,90,42,199,72.35831048422865,17.814122910701894
University of Massachusetts - Boston,12658,9574,Massachusetts,Large City,NA,100.0,100.0,100.0,34,16,74,18,8,41,52,24,115,49.45873291127301,3.181855653538723
University of Massachusetts - Dartmouth,6764,5790,Massachusetts,Suburb,NA,100.0,100.0,100.0,18,8,39,10,4,21,28,12,60,27.13279624661777,0.4135510959738471
University of Massachusetts - Lowell,14015,10495,Massachusetts,Suburb,NA,100.0,100.0,100.0,36,17,78,19,9,43,55,26,121,52.57816704765113,2.579675842145022
University of Memphis,17392,12400,Tennessee,Large City,NA,100.0,100.0,100.0,31,9,92,15,4,46,46,13,138,33.31042564282912,11.950923514885398
University of Miami,10834,10216,Florida,Suburb,NA,100.0,100.0,100.0,60,25,139,32,13,77,92,38,216,66.07570225925812,25.220685658994398
University of Michigan - Ann Arbor,29819,28702,Michigan,Midsize City,NA,100.0,100.0,100.0,73,27,195,38,14,108,111,41,303,64.94768835231199,46.02252061241116
University of Michigan - Dearborn,7132,5137,Michigan,Small City,NA,100.0,99.97,100.0,16,5,45,8,3,25,24,8,70,24.220785351953495,0.05928962441988178
University of Michigan - Flint,6432,3809,Michigan,Small City,public,100.0,99.94,100.0,14,5,40,8,2,23,22,7,63,21.641278527047927,0.3209777882617675
University of Minnesota - Crookston,2832,1195,Minnesota,Town,public,99.8,81.46,100.0,4,1,12,2,1,7,6,2,19,0.6982752080704338,5.473876494556692
University of Minnesota - Duluth,10124,8906,Minnesota,Small City,NA,99.0,85.08,100.0,3,1,8,2,1,4,5,2,12,3.0184154101603093,1.5821901503546645
University of Minnesota - Morris,1627,1526,Minnesota,Town,NA,72.4,38.14,96.53,1,0,2,0,0,1,1,0,3,0.4802933531405704,0.800887984984612
University of Minnesota - Twin Cities,35429,29991,Minnesota,Large City,NA,100.0,100.0,100.0,20,7,55,10,4,29,30,11,84,8.080993995068098,21.74835399121413
University of Mississippi,18734,17511,Mississippi,Town,NA,100.0,100.0,100.0,131,53,307,68,27,162,199,80,469,130.93547157020313,68.66791500676652
University of Missouri - Columbia,23800,22197,Missouri,Midsize City,NA,100.0,100.0,100.0,32,11,92,17,5,48,49,16,140,19.67556064186996,29.067386928663893
University of Missouri - Kansas City,11369,6760,Missouri,Large City,public,100.0,99.48,100.0,11,4,33,6,2,17,17,6,50,10.444581611797894,6.4042252657859935
University of Missouri - St Louis,13791,5492,Missouri,Suburb,public,100.0,99.69,100.0,12,4,38,6,2,20,18,6,58,14.718673436623577,3.8961639372273087
University of Mobile,1442,1152,Alabama,Rural,NA,99.98,96.04,100.0,6,2,14,3,1,7,9,3,21,4.437634525433273,4.256993471787124
University of Montevallo,2352,2101,Alabama,Suburb,NA,100.0,98.05,100.0,7,3,18,4,1,9,11,4,27,9.274062210895922,1.651212640656268
University of Mount Union,2093,2046,Ohio,Town,NA,99.24,86.18,100.0,3,1,7,2,1,4,5,2,11,3.4087830446073357,1.4564929007403897
University of Nebraska at Kearney,4846,4063,Nebraska,Town,NA,89.99,58.25,99.94,1,1,5,1,0,2,2,1,7,0.5600360602626206,1.7261835731873465
University of Nebraska at Omaha,12620,9820,Nebraska,Large City,NA,98.05,78.77,100.0,3,1,7,1,1,4,4,2,11,1.4995256466269073,2.4323766943020777
University of Nebraska - Lincoln,20955,19534,Nebraska,Large City,public,100.0,99.91,100.0,13,5,38,7,2,20,20,7,58,2.1978122163994374,17.99460289930071
University of Nevada - Las Vegas,25281,18958,Nevada,Midsize City,NA,100.0,100.0,100.0,372,90,1182,198,45,599,570,135,1781,555.8042780962345,14.352560890943431
University of Nevada - Reno,18354,15572,Nevada,Midsize City,NA,100.0,100.0,100.0,250,62,787,132,31,399,382,93,1186,361.9762990141905,20.12070067955951
University of New England,4427,2361,Maine,Suburb,NA,99.98,96.35,100.0,5,2,13,3,1,7,8,3,20,1.3113064361266902,6.998135639195751
University of New Hampshire at Manchester,737,575,New Hampshire,Midsize City,NA,30.68,0.89,69.54,0,0,1,0,0,0,0,0,1,0.34913139125012904,0.017266992226360044
University of New Hampshire - Main Campus,13010,12677,New Hampshire,Suburb,NA,100.0,99.98,100.0,14,6,34,7,3,18,21,9,52,3.4353572374653107,18.23772065617744
University of New Haven,5214,4831,Connecticut,Suburb,NA,100.0,99.81,100.0,9,4,21,5,2,11,14,6,32,0.70351045875553,12.94332741427305
University of New Mexico - Main Campus,20359,15093,New Mexico,Large City,public,100.0,100.0,100.0,63,13,235,32,6,127,95,19,362,70.572463198327,24.15454709227348
University of New Orleans,6468,4737,LouisiaNA,Large City,NA,100.0,100.0,100.0,25,9,65,13,5,35,38,14,100,36.024270970680554,2.0868687455220267
University of North Alabama,6061,5141,Alabama,Small City,public,100.0,99.99,100.0,18,6,43,9,3,23,27,9,66,22.879696936579005,3.8848052931800083
University of North CaroliNA at Asheville,3820,3285,North CaroliNA,Small City,NA,99.82,90.54,100.0,4,2,11,2,1,6,6,3,17,3.2044050852578687,3.0846602809781176
University of North CaroliNA at Chapel Hill,18863,18303,North CaroliNA,Small City,public,100.0,100.0,100.0,25,9,63,13,5,34,38,14,97,15.510990919983868,22.102473400624802
University of North CaroliNA at Charlotte,23915,20597,North CaroliNA,Large City,public,100.0,100.0,100.0,22,8,56,11,4,30,33,12,86,21.542987709391095,11.410504269062658
University of North CaroliNA at Greensboro,16441,14136,North CaroliNA,Large City,NA,100.0,99.98,100.0,15,6,39,8,3,21,23,9,60,15.083471780467615,7.827499606060807
University of North CaroliNA at Pembroke,5478,4483,North CaroliNA,Town,NA,99.89,92.14,100.0,4,2,12,2,1,6,6,3,18,5.214739271541273,1.5808171135966833
University of North CaroliNA at Wilmington,14499,12346,North CaroliNA,Midsize City,NA,100.0,99.99,100.0,16,6,39,8,3,21,24,9,60,11.911876303591226,11.949976137037245
University of North Dakota,10999,8525,North Dakota,Small City,public,100.0,100.0,100.0,49,9,186,27,5,107,76,14,293,65.5810554050996,10.273689382673613
University of North Florida,14251,10223,Florida,Large City,NA,100.0,100.0,100.0,135,58,311,72,30,172,207,88,483,206.17160574838056,1.5305851366583587
University of North Texas,31444,25592,Texas,Midsize City,NA,100.0,100.0,100.0,517,156,1387,284,83,744,801,239,2131,796.9794788939855,3.961743294188561
University of Northern Colorado,10103,8328,Colorado,Midsize City,NA,100.0,97.19,100.0,8,2,29,4,1,15,12,3,44,7.086796323954585,5.0532018307127196
University of Northern Iowa,9959,9100,Iowa,Small City,NA,100.0,99.28,100.0,18,3,69,9,2,39,27,5,108,26.263995939969778,0.7279434029274532
University of Notre Dame,8577,8557,IndiaNA,Suburb,private,100.0,100.0,100.0,26,10,67,14,5,36,40,15,103,1.5459322198275514,38.601934222090236
University of Oklahoma Norman Campus,22028,19065,Oklahoma,Suburb,NA,100.0,100.0,100.0,132,40,367,72,21,200,204,61,567,48.428608051441174,156.26828358465977
University of Oregon,19336,17801,Oregon,Midsize City,NA,100.0,100.0,100.0,49,22,128,26,11,68,75,33,196,18.905662244070644,55.394671585352874
University of Pennsylvania,11719,10496,Pennsylvania,Large City,NA,100.0,100.0,100.0,37,15,91,19,8,49,56,23,140,3.838330819212347,52.206045587789205
University of Phoenix - New Mexico,216,217,New Mexico,Large City,private,99.05,74.1,100.0,3,1,8,2,0,4,5,1,12,0.1835993451965775,4.409083341798395
University of Phoenix - Hawaii,661,661,Hawaii,Large City,NA,6.8,3.05,15.45,0,0,0,0,0,0,0,0,0,5.6402131882093475e-05,0.07030237889399758
University of Phoenix - New Jersey,111,111,New Jersey,Large City,NA,41.03,21.1,72.12,0,0,1,0,0,0,0,0,1,0.4576371447353369,0.06906796890544017
University of Phoenix - Kentucky,18,18,Kentucky,Suburb,NA,4.35,1.64,11.55,0,0,0,0,0,0,0,0,0,0.03616772075387477,0.008223043722486976
University of Phoenix - Utah,122,122,Utah,Suburb,NA,58.14,15.07,96.27,1,0,2,0,0,1,1,0,3,0.8676847704045716,0.0
University of Pittsburgh - Bradford,1337,1229,Pennsylvania,Town,NA,94.89,76.74,99.85,2,1,4,1,0,2,3,1,6,1.8839098980778453,1.0834426649627396
University of Pittsburgh - Greensburg,1524,1436,Pennsylvania,Suburb,NA,94.02,76.62,99.76,2,1,4,1,0,2,3,1,6,2.6848428010034553,0.12901891905586
University of Pittsburgh - Johnstown,2785,2713,Pennsylvania,Suburb,NA,99.46,93.27,100.0,3,2,7,2,1,4,5,3,11,4.937579588916119,0.26974852957787443
University of Pittsburgh - Pittsburgh Campus,19329,18390,Pennsylvania,Large City,public,100.0,100.0,100.0,32,15,74,17,8,40,49,23,114,24.105730010625635,25.247840442173942
University of Portland,3888,3792,Oregon,Large City,private,100.0,99.94,100.0,11,5,33,6,3,18,17,8,51,2.180148867187983,14.970995496762487
University of Puget Sound,2415,2390,Washington,Midsize City,NA,100.0,98.97,100.0,7,3,23,4,2,12,11,5,35,2.541453131897237,8.77129049797272
University of Redlands,3133,2518,California,Small City,private,100.0,99.95,100.0,12,5,29,6,3,15,18,8,44,12.818782996515187,4.956810751626549
University of Rhode Island,15100,12629,Rhode Island,Suburb,NA,100.0,100.0,100.0,17,8,36,9,4,19,26,12,55,4.137245439782999,21.081042541330863
University of Richmond,3265,3035,Virginia,Midsize City,NA,100.0,99.67,100.0,10,4,23,5,2,13,15,6,36,5.313914088971289,10.114735436117288
University of Rio Grande,1755,1269,Ohio,Rural,NA,96.7,73.63,99.97,2,1,5,1,0,3,3,1,8,3.282243411312375,0.12574569867921753
University of Rochester,6542,6250,New York,Midsize City,private,100.0,99.99,100.0,15,6,36,8,3,19,23,9,55,7.274337153647967,15.406106389578389
University of Saint Francis - Fort Wayne,1906,1523,IndiaNA,Large City,NA,99.36,91.72,100.0,3,2,7,2,1,4,5,3,11,4.481558828755402,0.5624015716845954
University of Saint Mary,750,641,Kansas,Town,NA,97.83,68.49,100.0,2,1,8,1,0,4,3,1,12,0.20380393895208104,3.584498758568698
University of San Diego,5776,5605,California,Large City,NA,100.0,100.0,100.0,23,9,60,12,5,32,35,14,92,19.966583653558217,15.550334564835305
University of San Francisco,6847,6586,California,Large City,NA,100.0,100.0,100.0,26,11,64,13,6,34,39,17,98,30.079835492283564,9.030267335972708
University of Science and Arts of Oklahoma,881,727,Oklahoma,Town,public,96.49,62.48,100.0,2,1,6,1,0,4,3,1,10,2.909078389716095,0.4320484002490856
University of Scranton,3809,3630,Pennsylvania,Small City,private,100.0,99.69,100.0,8,4,19,4,2,10,12,6,29,2.657723176750895,9.592767255163812
University of Sioux Falls,1214,1036,South Dakota,Midsize City,private,98.15,74.05,100.0,3,1,8,1,0,4,4,1,12,1.6659147160317345,2.304540809903993
University of South Alabama,10986,9090,Alabama,Midsize City,public,100.0,100.0,100.0,41,16,97,21,8,51,62,24,148,37.5841340925558,24.557301136356706
University of South CaroliNA - Aiken,3352,2716,South CaroliNA,Suburb,public,100.0,100.0,100.0,41,17,94,22,9,52,63,26,146,62.048428972503096,1.4423427444300563
University of South CaroliNA - Beaufort,2078,1797,South CaroliNA,Town,NA,100.0,100.0,100.0,25,10,57,13,5,31,38,15,88,37.09372373141378,0.9365389364006262
University of South CaroliNA - Columbia,26363,25243,South CaroliNA,Midsize City,NA,100.0,100.0,100.0,229,93,524,124,49,288,353,142,812,312.026088458222,40.91894599274854
University of South CaroliNA - Upstate,5776,4583,South CaroliNA,Suburb,public,100.0,100.0,100.0,73,30,166,40,16,91,113,46,257,110.74803862540954,2.1410536194726535
University of South Dakota,7652,4908,South Dakota,Town,public,100.0,99.98,100.0,13,6,30,7,3,16,20,9,46,14.897067588012131,5.338088266702799
University of South Florida - Main Campus,31773,24672,Florida,Large City,NA,100.0,100.0,100.0,295,125,677,157,64,375,452,189,1052,443.60244345386644,8.347524232050647
University of South Florida - St. Petersburg,4251,2845,Florida,Large City,NA,100.0,100.0,100.0,40,17,91,21,9,50,61,26,141,60.19143716349198,0.5497114530377621
University of Southern California,19174,18631,California,Large City,private,100.0,100.0,100.0,77,31,195,40,16,104,117,47,299,67.89819896863851,49.43210861982632
University of Southern IndiaNA,9689,6588,IndiaNA,Suburb,NA,100.0,100.0,100.0,17,9,37,9,4,20,26,13,57,24.67461319660925,1.6588157026662431
University of Southern Maine,6110,3901,Maine,Small City,NA,99.78,81.01,100.0,4,1,10,2,1,5,6,2,15,4.073117096533447,2.031519538031169
University of Southern Mississippi,11809,10384,Mississippi,Small City,NA,100.0,100.0,100.0,94,41,207,48,20,108,142,61,315,126.26259087384231,16.034271978447823
University of St Francis,1600,1291,Illinois,Suburb,NA,94.33,72.22,99.93,2,1,5,1,0,2,3,1,7,1.615275680605174,1.2440964437475486
University of St Thomas Minnesota,6197,5945,Minnesota,Large City,NA,99.18,82.06,100.0,3,1,9,2,1,5,5,2,14,1.6048664090019753,3.175006981984092
University of St. Thomas - Houston,1815,1434,Texas,Large City,NA,100.0,100.0,100.0,29,9,78,16,5,42,45,14,120,44.92423356789433,0.3948592976982688
University of the Cumberlands,3317,1828,Kentucky,Town,NA,99.99,94.9,100.0,6,2,17,3,1,9,9,3,26,4.810306860265344,4.196833212712551
University of the District of Columbia,3858,1830,District of Columbia,Large City,public,100.0,99.44,100.0,8,3,18,4,2,10,12,5,28,6.4520609142899294,5.864129815822913
University of the IncarNAte Word,5996,4461,Texas,Large City,NA,100.0,100.0,100.0,98,30,264,54,16,141,152,46,405,151.22309060492944,0.9539995198084287
University of the Ozarks,756,747,Arkansas,Town,NA,99.36,77.27,100.0,3,1,9,2,1,5,5,2,14,0.5797953675434026,4.420124495560824
University of the Pacific,3552,3452,California,Large City,private,100.0,99.99,100.0,14,6,34,7,3,18,21,9,52,18.99188356396144,1.971694108484396
University of the Southwest,509,417,New Mexico,Rural,NA,97.82,67.3,100.0,2,1,7,1,0,4,3,1,11,1.1289406545066147,2.6671404920412813
University of the West,185,148,California,Suburb,NA,66.58,38.71,93.18,1,0,2,0,0,1,1,0,3,1.0928455550024467,0.0
University of Toledo,16191,13056,Ohio,Large City,public,100.0,100.0,100.0,23,9,54,12,4,29,35,13,83,28.084011537124745,6.308217924143966
University of Tulsa,3347,3203,Oklahoma,Large City,private,100.0,99.88,100.0,14,4,40,8,2,22,22,6,62,5.993113144851437,16.117495426207444
University of Utah,24637,18066,Utah,Midsize City,NA,100.0,100.0,100.0,114,25,409,62,12,233,176,37,642,139.29896650117985,36.09792206897375
University of Vermont,11341,10395,Vermont,Small City,NA,100.0,100.0,100.0,17,7,40,9,4,21,26,11,61,0.006356027818681326,25.309697425500758
University of Virginia - Main Campus,16658,15766,Virginia,Suburb,public,100.0,100.0,100.0,80,25,177,46,13,105,126,38,282,100.74747323784342,24.47221447949205
University of Washington - Bothell Campus,5365,4641,Washington,Suburb,NA,100.0,100.0,100.0,20,11,40,11,6,24,31,17,64,30.222685892832004,0.8059057172879344
University of Washington - Seattle Campus,31328,28759,Washington,Large City,public,100.0,100.0,100.0,114,60,251,65,33,146,179,93,397,148.86962399635885,30.50075339470948
University of Washington - Tacoma Campus,4436,3945,Washington,Midsize City,NA,100.0,100.0,100.0,16,9,32,9,5,19,25,14,51,25.048195732392585,0.24594852560167008
University of West Alabama,2111,1843,Alabama,Rural,NA,100.0,97.96,100.0,7,3,16,4,1,9,11,4,25,8.251624428267414,2.1628434523258053
University of West Georgia,11230,8938,Georgia,Town,public,100.0,99.03,100.0,19,3,81,10,1,46,29,4,127,26.835346999695272,1.4309559958599771
University of Wisconsin - Eau Claire,10184,9476,Wisconsin,Small City,public,98.18,88.05,99.98,3,1,6,1,1,3,4,2,9,2.9809712364224548,1.0229216698268113
University of Wisconsin - Green Bay,6812,4095,Wisconsin,Midsize City,public,96.32,82.11,99.91,2,1,5,1,1,2,3,2,7,2.5617285267369203,0.739064609029939
University of Wisconsin - La Crosse,9701,9094,Wisconsin,Small City,NA,98.96,89.89,100.0,3,2,7,2,1,4,5,3,11,3.222703950094609,1.3425584695814572
University of Wisconsin - Madison,31358,28977,Wisconsin,Large City,NA,100.0,100.0,100.0,21,10,49,11,5,26,32,15,75,7.780921308397753,24.523344486208707
University of Wisconsin - Milwaukee,20356,17076,Wisconsin,Large City,NA,99.99,99.19,100.0,6,3,12,3,2,6,9,5,18,7.675612007392061,1.1686951008136832
University of Wisconsin - Oshkosh,12410,7994,Wisconsin,Small City,NA,99.5,94.48,100.0,4,2,7,2,1,4,6,3,11,4.824681801756937,0.46272325378752144
University of Wisconsin - Parkside,4135,3275,Wisconsin,Suburb,NA,87.79,67.4,98.83,1,1,3,1,0,2,2,1,5,1.489089472175167,0.6120647426389189
University of Wisconsin - Platteville,7614,6723,Wisconsin,Town,NA,99.62,90.93,100.0,4,2,10,2,1,5,6,3,15,2.35190772246043,3.2038335254231587
University of Wisconsin - River Falls,5680,5014,Wisconsin,Town,NA,89.5,67.58,99.3,2,1,3,1,0,2,3,1,5,1.068650065887295,1.1840779494349836
University of Wisconsin - Stevens Point,7896,7224,Wisconsin,Town,NA,98.29,86.56,99.99,3,1,6,1,1,3,4,2,9,2.8940112833192706,1.1662176641852529
University of Wisconsin - Stout,8129,6605,Wisconsin,Town,public,96.98,83.02,99.95,2,1,5,1,1,3,3,2,8,2.0718807175134795,1.4262194557127283
University of Wisconsin - Superior,2373,1829,Wisconsin,Suburb,NA,75.35,44.93,96.87,1,0,2,0,0,1,1,0,3,0.5301365948354667,0.8665187918884598
University of Wisconsin - Whitewater,11128,9830,Wisconsin,Town,NA,99.74,95.6,100.0,4,2,8,2,1,4,6,3,12,3.870515710826586,2.0941596948690044
University of Wyoming,9796,8281,Wyoming,Town,NA,100.0,95.96,100.0,8,2,40,4,1,20,12,3,60,0.0008330026716322777,12.80572318828997
Upper Iowa University,4275,2107,Iowa,Rural,private,100.0,97.47,100.0,8,2,26,4,1,14,12,3,40,5.969979283577253,6.468325184422738
Ursinus College,1507,1489,Pennsylvania,Suburb,private,99.23,88.76,100.0,3,1,7,2,1,4,5,2,11,1.460843759737907,3.393622283001843
Ursuline College,620,455,Ohio,Suburb,private,71.88,38.82,95.06,1,0,2,0,0,1,1,0,3,1.1077084822281977,0.15943063353722423
Utah State University,24621,17188,Utah,Small City,public,100.0,100.0,100.0,113,23,414,62,11,239,175,34,653,135.0814495433937,39.84654574846068
Utah Valley University,36870,18404,Utah,Small City,NA,100.0,100.0,100.0,169,36,603,92,17,350,261,53,953,234.1397567744992,27.049129320581336
Utica College,3686,2901,New York,Small City,NA,99.99,99.13,100.0,6,3,13,3,2,7,9,5,20,7.417406517809236,2.081949224632277
Valdosta State University,8774,7166,Georgia,Small City,NA,100.0,98.26,100.0,15,3,65,8,1,37,23,4,102,20.95305847173659,2.2464380217504574
Valley City State University,1373,834,North Dakota,Town,NA,100.0,95.02,100.0,11,2,38,6,1,22,17,3,60,15.28933024830855,1.26208083080532
University of Valley Forge,700,589,Pennsylvania,Suburb,NA,92.15,63.42,99.73,2,1,4,1,0,2,3,1,6,0.5188888106989843,2.016340889513017
Valparaiso University,3228,3153,IndiaNA,Suburb,NA,99.97,97.16,100.0,5,2,13,3,1,7,8,3,20,3.3659658970713355,4.851474444576002
Vanderbilt University,6888,6805,Tennessee,Large City,NA,100.0,100.0,100.0,24,9,62,13,4,33,37,13,95,1.991692432002649,34.68919262755458
Vanguard University of Southern California,1842,1524,California,Midsize City,NA,100.0,99.31,100.0,8,3,21,4,2,11,12,5,32,8.914075364857796,3.3330870428394697
Vassar College,2352,2334,New York,Suburb,private,99.99,98.11,100.0,6,3,15,3,1,8,9,4,23,1.4923614709925466,7.911130557014218
Villanova University,6948,6525,Pennsylvania,Suburb,NA,100.0,100.0,100.0,17,8,39,9,4,21,26,12,60,1.9670767457856964,23.956533001779547
Virginia Commonwealth University,23666,20036,Virginia,Midsize City,NA,100.0,100.0,100.0,119,35,258,69,19,157,188,54,415,179.79715912024832,8.016999550515344
Virginia Military Institute,1724,1722,Virginia,Town,public,100.0,97.61,100.0,8,2,17,4,1,10,12,3,27,8.64240972711814,3.363089084451415
Virginia Tech,27189,26603,Virginia,Small City,public,100.0,100.0,100.0,120,37,265,69,20,158,189,57,423,158.98363376391652,29.551866178921887
Virginia State University,4299,3976,Virginia,Suburb,public,100.0,99.99,100.0,18,6,40,10,3,23,28,9,63,22.27339186429096,5.969892500994549
Virginia Union University,1298,1201,Virginia,Midsize City,NA,99.93,91.11,100.0,5,2,10,3,1,6,8,3,16,4.980230315723484,2.2644713491544377
Virginia Wesleyan University,1438,1354,Virginia,Large City,NA,100.0,94.86,100.0,6,2,14,4,1,8,10,3,22,8.700804387436506,1.2404466423044163
Viterbo University,1770,1394,Wisconsin,Small City,NA,82.71,46.8,99.29,1,0,3,1,0,2,2,0,5,0.47149846132093426,1.274466494614708
Voorhees College,475,464,South CaroliNA,Town,private,99.89,93.43,100.0,4,2,10,2,1,6,6,3,16,6.254055134373247,0.5127614586067873
Wabash College,865,864,IndiaNA,Town,NA,94.93,72.98,99.91,2,1,5,1,0,2,3,1,7,1.6254216424782588,1.3446550559646615
Wagner College,1797,1736,New York,Large City,NA,99.88,94.89,100.0,4,2,11,2,1,6,6,3,17,2.076972493513594,4.588983660898218
Wake Forest University,5099,5046,North CaroliNA,Midsize City,NA,100.0,99.99,100.0,16,6,41,9,3,22,25,9,63,1.146347832237767,23.83675036268236
Walden University,7443,453,Minnesota,Large City,NA,100.0,100.0,100.0,42,16,102,22,8,54,64,24,156,0.018331807371777496,63.272083194114295
Waldorf University,2124,1482,Iowa,Town,private,100.0,99.57,100.0,10,4,25,5,2,14,15,6,39,1.1067939121238726,13.868110321855944
Walla Walla University,1650,1556,Washington,Suburb,NA,99.98,97.75,100.0,5,2,15,3,1,8,8,3,23,4.064035413619456,4.209871574431238
Walsh University,2012,1744,Ohio,Suburb,private,98.53,81.05,100.0,3,1,6,1,1,3,4,2,9,3.7669875450115335,0.4483426820068321
Warner Pacific College,404,396,Oregon,Large City,NA,73.47,43.87,98.79,1,0,3,0,0,1,1,0,4,0.45994701839408925,0.8616541452807901
Warner University,1003,869,Florida,Rural,NA,100.0,99.7,100.0,9,4,21,5,2,11,14,6,32,13.547149364056063,0.29232277636674137
Warren Wilson College,589,579,North CaroliNA,Suburb,private,92.48,60.04,99.95,2,1,5,1,0,2,3,1,7,0.10538843904354145,2.4663408846516
Wartburg College,1525,1474,Iowa,Town,NA,97.82,56.98,100.0,3,1,9,1,0,5,4,1,14,3.0045541806393006,0.8140567137607564
Washburn University,5877,3944,Kansas,Midsize City,NA,98.39,79.63,99.98,3,1,6,1,1,3,4,2,9,3.1712349604448464,0.9520064006043334
Washington Adventist University,875,655,Maryland,Suburb,NA,97.45,77.46,99.98,2,1,6,1,1,3,3,2,9,1.1524568540123175,2.4980208411500784
Washington & Jefferson College,1411,1398,Pennsylvania,Suburb,NA,96.86,79.46,99.96,2,1,5,1,1,3,3,2,8,1.7953191255194823,1.6544965928262831
Washington and Lee University,1824,1823,Virginia,Town,private,100.0,97.99,100.0,7,3,17,4,1,9,11,4,26,2.285733846747462,8.53851055680986
Washington College,1489,1456,Maryland,Town,NA,98.95,85.57,100.0,3,1,7,2,1,4,5,2,11,2.028725790941073,2.5170629942022456
Washington State University,25279,22166,Washington,Town,NA,100.0,100.0,100.0,91,49,195,53,27,115,144,76,310,131.1939319438844,13.022763427421976
Washington University in St Louis,7673,7074,Missouri,Suburb,NA,100.0,100.0,100.0,25,9,67,13,5,36,38,14,103,0.7392152347893559,37.88800581057484
Wayland Baptist University,3563,990,Texas,Town,NA,100.0,100.0,100.0,55,17,148,30,9,79,85,26,227,83.71886325538792,1.4567305555894285
Wayne State College,2756,2404,Nebraska,Town,public,76.81,37.99,98.96,1,0,3,0,0,2,1,0,5,0.3093690864981227,1.1467277086341916
Wayne State University,17300,12389,Michigan,Large City,public,100.0,100.0,100.0,39,13,109,20,7,61,59,20,170,58.22120688287527,0.8616633493250444
Waynesburg University,1374,1330,Pennsylvania,Town,private,93.38,73.98,99.73,2,1,4,1,0,2,3,1,6,2.0719392928955958,0.6391778296867477
Webber InterNAtioNAl University,626,584,Florida,Town,NA,99.99,97.69,100.0,6,2,13,3,1,7,9,3,20,8.863452209743464,0.08003340635900964
Weber State University,27106,11311,Utah,Small City,NA,100.0,100.0,100.0,124,25,448,68,12,260,192,37,708,175.1158558762407,16.49663193948778
Webster University,3080,2297,Missouri,Suburb,private,99.99,95.05,100.0,6,2,19,3,1,10,9,3,29,2.3454539458970687,7.105346460303576
Wellesley College,2513,2374,Massachusetts,Suburb,private,100.0,98.72,100.0,7,3,18,4,1,9,11,4,27,1.2770837739534597,9.388858215133842
Wells College,486,481,New York,Rural,NA,77.44,48.95,96.68,1,0,2,1,0,1,2,0,3,0.8362157663908649,0.6474889429943731
Wentworth Institute of Technology,4263,3904,Massachusetts,Large City,private,100.0,99.83,100.0,9,4,21,5,2,11,14,6,32,11.69055048156741,2.3149335506245645
Wesley College,1447,1303,Delaware,Small City,private,98.65,85.46,100.0,3,1,7,1,1,3,4,2,10,0.20570676903403431,4.086284132232008
Wesleyan College,565,431,Georgia,Midsize City,NA,88.96,44.92,99.95,1,0,5,1,0,3,2,0,8,1.037763646485031,1.1561236444177962
Wesleyan University,2975,2896,Connecticut,Small City,private,100.0,99.37,100.0,8,3,19,4,2,10,12,5,29,0.07841210321546012,12.203404320202889
West Chester University of Pennsylvania,14450,13020,Pennsylvania,Suburb,NA,100.0,100.0,100.0,22,11,49,11,6,26,33,17,75,21.81864169865973,11.708010627837174
West Liberty University,2174,1869,West Virginia,Rural,NA,83.05,49.0,98.39,1,0,3,1,0,1,2,0,4,0.24908432166267724,1.5228691500120053
West Texas A&M University,7393,5615,Texas,Town,public,100.0,100.0,100.0,116,35,311,64,19,167,180,54,478,177.28700454082147,1.9621659375173688
West Virginia State University,3754,1786,West Virginia,Suburb,NA,96.76,71.66,99.98,2,1,5,1,0,3,3,1,8,0.5070876782807238,2.906616271812039
West Virginia University,22507,20712,West Virginia,Small City,public,100.0,100.0,100.0,32,12,75,17,6,41,49,18,116,1.6660757296629858,46.81120948199484
West Virginia University Institute of Technology,1621,1111,West Virginia,Small City,public,67.32,32.84,93.02,1,0,2,0,0,1,1,0,3,0.23757065835665506,0.8764092735666009
West Virginia Wesleyan College,1322,1289,West Virginia,Town,private,84.39,52.12,98.63,1,0,3,1,0,2,2,0,5,0.13638015268119244,1.7147504557582174
Western CaroliNA University,9408,8040,North CaroliNA,Town,NA,100.0,99.66,100.0,10,4,25,5,2,13,15,6,38,8.649805846026515,6.249809612213585
Western Connecticut State University,5082,4089,Connecticut,Small City,NA,95.13,84.64,99.64,2,1,4,1,1,2,3,2,6,1.6997838636285958,1.3187452352676652
Western Governors University,72383,72385,Utah,Suburb,NA,100.0,100.0,100.0,332,112,898,179,58,491,511,170,1389,46.997221006831225,464.46486222107
Western Illinois University,7596,6668,Illinois,Town,NA,99.99,98.89,100.0,6,3,15,3,1,8,9,4,23,8.336870044475578,0.8484740506812478
Western InterNAtioNAl University,593,597,ArizoNA,Midsize City,NA,98.65,80.38,100.0,3,1,7,1,1,4,4,2,11,0.83438121742991,3.4331906411453477
Western Kentucky University,17655,12919,Kentucky,Small City,NA,100.0,100.0,100.0,30,10,85,15,5,44,45,15,129,35.019998415285144,9.947592988597206
Western Michigan University,17938,15063,Michigan,Small City,NA,100.0,100.0,100.0,39,14,108,20,7,61,59,21,169,54.36387303110102,4.657948934033494
Western New England University,2737,2613,Massachusetts,Midsize City,private,99.92,96.62,100.0,5,2,10,2,1,5,7,3,15,4.727303543585102,2.3994619773219683
Western New Mexico University,2170,1266,New Mexico,Town,public,100.0,92.29,100.0,7,2,25,4,1,13,11,3,38,6.996306962703623,3.6352495800857234
Western Oregon University,4758,4065,Oregon,Town,public,100.0,99.52,100.0,7,3,15,4,2,8,11,5,23,7.723430332873547,2.6640671959029403
Western Colorado University,2427,1832,Colorado,Town,NA,99.82,84.61,100.0,4,1,13,2,1,7,6,2,20,1.3457801483425973,4.937516463370803
Western Washington University,14961,13728,Washington,Small City,NA,100.0,100.0,100.0,54,28,127,31,16,73,85,44,200,77.34832471019676,7.618382586214801
Westfield State University,5585,4800,Massachusetts,Suburb,NA,100.0,100.0,100.0,14,7,31,8,4,17,22,11,48,21.86534907404907,0.3160219648651173
Westminster College Missouri,765,760,Missouri,Town,NA,85.96,46.7,99.61,1,0,4,1,0,2,2,0,6,0.6666754220296528,1.2838847248911047
Westminster College Pennsylvania,1193,1170,Pennsylvania,Town,private,92.26,69.06,99.69,2,1,4,1,0,2,3,1,6,1.493387308840979,1.0592766474440931
Westminster College Utah,2033,1906,Utah,Midsize City,NA,100.0,95.96,100.0,9,2,32,5,1,18,14,3,50,8.193220127098906,5.536629318529024
Westmont College,1295,1294,California,Suburb,private,99.96,95.65,100.0,5,2,14,3,1,7,8,3,21,5.369711402687698,2.434447407380699
Wheaton College Illinois,2386,2310,Illinois,Suburb,private,99.99,96.99,100.0,6,2,15,3,1,8,9,3,23,0.5949219584200747,8.596156345317567
Wheaton College Massachusetts,1686,1675,Massachusetts,Suburb,private,99.26,88.15,100.0,3,1,8,2,1,4,5,2,12,2.5457932280777165,2.3517498656037756
Wheeling Jesuit University,721,670,West Virginia,Small City,NA,72.25,40.36,95.17,1,0,2,0,0,1,1,0,3,0.03681128972488785,1.2417311316703872
Boston University Wheelock College of Education and Human Development,613,593,Massachusetts,Large City,NA,86.05,59.61,98.72,1,1,3,1,0,2,2,1,5,1.5576234882317608,0.4068947748787028
Whitman College,1512,1455,Washington,Small City,NA,99.95,96.66,100.0,5,2,12,3,1,7,8,3,19,3.228332356734328,4.292321338302519
Whittier College,1684,1640,California,Suburb,NA,100.0,98.47,100.0,7,3,16,3,1,9,10,4,25,7.443164320557205,2.4762271489687944
Whitworth University,2252,2211,Washington,Suburb,private,100.0,99.61,100.0,8,4,28,5,2,15,13,6,43,7.544223486127383,5.50738967888529
Wichita State University,12403,8749,Kansas,Large City,NA,100.0,97.46,100.0,7,2,16,3,1,8,10,3,24,6.720392070991311,3.411570647726676
Widener University,3438,2919,Pennsylvania,Suburb,private,100.0,99.26,100.0,7,3,16,4,2,8,11,5,24,3.41888063077275,7.075776143860785
Wilberforce University,613,489,Ohio,Rural,private,85.27,51.39,99.36,1,0,3,1,0,2,2,0,5,0.36988508193911696,1.5389793319965503
Wiley College,1325,1188,Texas,Town,NA,100.0,99.95,100.0,16,5,42,9,3,23,25,8,65,22.003706237336,2.348316653434569
Wilkes University,2489,2233,Pennsylvania,Small City,NA,99.79,95.07,100.0,4,2,9,2,1,5,6,3,14,3.429728480473774,2.7402039256999395
Willamette University,1950,1901,Oregon,Midsize City,private,99.99,97.93,100.0,6,3,15,3,1,8,9,4,23,0.9990049239519618,7.777412221832314
William Carey University,3099,1676,Mississippi,Small City,private,100.0,100.0,100.0,26,11,57,13,6,30,39,17,87,35.825418672099644,3.2062438520586336
William Jewell College,922,909,Missouri,Suburb,NA,86.56,44.98,99.73,1,0,4,1,0,2,2,0,6,0.6321326540488418,1.3621712635473715
William Paterson University of New Jersey,8839,7285,New Jersey,Suburb,NA,100.0,100.0,100.0,32,14,79,16,7,41,48,21,120,47.831352175651176,0.6067782760349122
William Penn University,1284,1068,Iowa,Town,NA,99.77,81.41,100.0,4,1,13,2,1,7,6,2,20,1.6769604729149585,4.349015356494812
William Woods University,959,794,Missouri,Town,NA,79.76,44.5,98.98,1,0,3,1,0,2,2,0,5,0.7230952763983108,0.872285231385266
Williams Baptist College,492,447,Arkansas,Rural,NA,63.95,25.17,94.0,1,0,2,0,0,1,1,0,3,0.4767977872812013,0.5372611108114957
Williams College,2073,2047,Massachusetts,Town,private,99.99,97.57,100.0,6,2,16,3,1,8,9,3,24,1.1807790959176252,7.924858497517644
Wilmington College,1168,1098,Ohio,Town,NA,91.72,62.97,99.73,2,1,4,1,0,2,3,1,6,2.063569404502442,0.4235577343860198
Wilmington University,8441,3035,Delaware,Suburb,private,99.98,98.54,100.0,6,3,12,3,1,7,9,4,19,3.460799093114845,5.164658166980457
Wilson College,827,565,Pennsylvania,Small City,NA,84.41,57.68,98.39,1,1,3,1,0,1,2,1,4,1.0504334460491633,0.8049796187148907
Wingate University,2588,2537,North CaroliNA,Suburb,NA,99.62,88.39,100.0,4,1,9,2,1,5,6,2,14,2.1674226142917012,3.3692510078233457
WinoNA State University,7463,6522,Minnesota,Town,public,96.57,79.15,99.97,2,1,5,1,1,3,3,2,8,1.532205790692021,1.8380580836758398
Winston - Salem State University,4688,4072,North CaroliNA,Midsize City,NA,99.97,95.21,100.0,5,2,13,3,1,7,8,3,20,4.1230741199393055,3.999117441983967
Winthrop University,5014,4488,South CaroliNA,Small City,public,100.0,100.0,100.0,62,26,141,34,13,77,96,39,218,94.54901057244275,1.4112643791920765
Wisconsin Lutheran College,992,921,Wisconsin,Large City,NA,77.78,49.28,96.94,1,0,2,1,0,1,2,0,3,0.3031631392588071,1.1940835270144152
Wittenberg University,1860,1775,Ohio,Small City,NA,98.8,81.9,100.0,3,1,8,2,1,4,5,2,12,2.6203437910002707,1.7933767777833758
Wofford College,1679,1663,South CaroliNA,Small City,private,100.0,99.99,100.0,15,6,35,8,3,19,23,9,54,20.525603900024983,2.59217486544869
Woodbury University,1023,923,California,Large City,private,99.7,92.44,100.0,4,2,9,2,1,5,6,3,14,5.5469296007962035,0.24336456053912905
Worcester Polytechnic Institute,4435,4301,Massachusetts,Midsize City,NA,100.0,99.87,100.0,10,4,22,5,2,12,15,6,34,8.713479782285738,6.465969379933565
Worcester State University,5496,4153,Massachusetts,Midsize City,NA,100.0,100.0,100.0,15,7,32,8,4,18,23,11,50,22.124952988754366,0.4421041084627999
Wright State University - Main Campus,12120,9423,Ohio,Suburb,public,100.0,99.99,100.0,16,6,38,8,3,20,24,9,58,22.897833335620494,1.4234440336848426
Xavier University,4629,4370,Ohio,Large City,private,100.0,99.28,100.0,8,3,20,4,2,11,12,5,31,4.781251374960375,7.58393224211978
Xavier University of LouisiaNA,2289,2155,LouisiaNA,Large City,NA,100.0,99.72,100.0,11,4,29,6,2,15,17,6,44,6.21490093133929,10.497466664636528
Yale University,5751,5743,Connecticut,Midsize City,NA,100.0,100.0,100.0,19,8,47,10,4,25,29,12,72,0.15022879588008714,28.930304854177262
Yeshiva University,2755,2646,New York,Large City,NA,100.0,99.38,100.0,8,3,18,4,2,9,12,5,27,2.812053019721493,8.73504027086361
York College,431,398,Nebraska,Town,NA,78.69,34.46,99.85,1,0,4,1,0,2,2,0,6,0.017649001214030978,1.5122486083445248
York College of Pennsylvania,4169,3814,Pennsylvania,Suburb,NA,100.0,99.39,100.0,7,3,16,4,2,8,11,5,24,3.6123339504410126,7.098264917969158
Youngstown State University,11272,8834,Ohio,Small City,NA,100.0,99.99,100.0,15,6,35,8,3,19,23,9,54,19.67009930480441,2.9299670626340912
