school,real_size,size,state,setting,status,meanprob,lowprob,highprob,meaNActive,lowactive,highactive,meanincub,lowincub,highincub,meantot,lowtot,hightot,instate,outstate
Abilene Christian University,3669,3508,Texas,Midsize City,private,100.0,100.0,100.0,40,17,94,15,6,35,55,23,129,53.13930829861577,1.884838122438953
Adams State University,1956,1514,Colorado,Town,NA,98.34,80.77,100.0,3,1,7,1,0,3,4,1,10,1.537250483843228,2.5447466784363404
Adelphi University,5269,4874,New York,Suburb,private,100.0,99.99,100.0,11,7,19,5,3,9,16,10,28,13.542059479228117,2.671615908832217
Adrian College,1673,1606,Michigan,Town,private,99.51,92.06,100.0,4,2,8,2,1,4,6,3,12,4.3395941126869655,0.9625183039090509
Agnes Scott College,923,913,Georgia,Suburb,private,98.16,77.95,100.0,3,1,7,1,0,3,4,1,10,1.865285760550548,2.1137341803454857
Alabama A & M University,5032,4714,Alabama,Midsize City,public,100.0,100.0,100.0,16,7,34,7,3,16,23,10,50,16.77615484290856,6.799280563431733
Alabama State University,4212,3866,Alabama,Midsize City,NA,100.0,99.99,100.0,15,7,31,7,3,15,22,10,46,13.800409206372866,7.566185596737339
Alaska Pacific University,298,203,Alaska,Large City,private,52.29,30.99,78.91,1,0,1,0,0,0,1,0,1,0.0021194639627624087,0.7339272808545274
Albany State University,6266,3927,Georgia,Small City,NA,100.0,99.76,100.0,14,4,40,6,2,20,20,6,60,17.88338980380164,2.2511275005691656
Albertus Magnus College,1130,1012,Connecticut,Midsize City,NA,66.12,47.0,86.33,1,0,1,0,0,1,1,0,2,0.43994970388826926,0.6402687148334205
Albion College,1565,1554,Michigan,Town,NA,99.32,90.51,100.0,3,2,7,2,1,4,5,3,11,4.461050226279566,0.5211304440911414
Albright College,2019,1993,Pennsylvania,Small City,NA,99.91,97.88,100.0,5,3,9,2,1,5,7,4,14,2.5247597060579383,4.497461321480323
Alcorn State University,3169,2893,Mississippi,Rural,NA,100.0,100.0,100.0,27,14,52,13,6,26,40,20,78,36.174095799914454,3.726267790099768
Alderson Broaddus University,950,903,West Virginia,Town,private,62.11,37.87,84.5,1,0,1,0,0,1,1,0,2,0.15621395270972904,0.8126718282943218
Alfred University,1704,1600,New York,Town,NA,99.41,95.12,99.99,4,2,6,2,1,3,6,3,9,3.8612737712710077,1.2588963775105462
Alice Lloyd College,598,584,Kentucky,Rural,private,79.53,49.02,97.82,1,0,3,1,0,1,2,0,4,1.3008541591944223,0.28322586313015613
Allegheny College,1800,1752,Pennsylvania,Town,NA,99.44,94.03,100.0,4,2,7,2,1,3,6,3,10,1.922542431908053,3.247553378632399
Allen University,590,563,South CaroliNA,Midsize City,private,99.96,97.96,100.0,5,3,10,3,1,6,8,4,16,7.558285878297047,0.31280737017071697
Alma College,1427,1386,Michigan,Town,NA,99.12,89.02,100.0,3,2,7,2,1,4,5,3,11,4.461050226279566,0.26484184668239275
Alvernia University,2252,1670,Pennsylvania,Small City,NA,99.9,97.8,100.0,5,3,9,2,1,4,7,4,13,3.238728639328421,3.675931703425331
Alverno College,1312,1036,Wisconsin,Large City,NA,56.04,37.08,79.08,1,0,1,0,0,0,1,0,1,0.6257042951586773,0.19527644607687752
American InterContinental University - Atlanta,1905,932,Georgia,Midsize City,private,99.79,85.17,100.0,4,1,12,2,1,6,6,2,18,5.071900607339692,1.06881439645858
American InterNAtioNAl College,1374,1254,Massachusetts,Midsize City,private,99.24,93.44,99.99,3,2,6,2,1,3,5,3,9,3.2736004307746844,1.5958276621055758
American Jewish University,68,63,California,Large City,NA,36.71,20.5,61.23,0,0,1,0,0,0,0,0,1,0.366066046152848,0.0894565545582208
American Public University System,37910,2914,West Virginia,Town,NA,100.0,100.0,100.0,150,70,332,69,30,159,219,100,491,0.15079612776025866,218.8620456708602
American University,8124,7764,District of Columbia,Large City,NA,100.0,100.0,100.0,25,13,51,11,6,24,36,19,75,0.5189389862562392,35.90183628153209
Amherst College,1832,1836,Massachusetts,Suburb,private,99.99,98.96,100.0,6,3,12,3,1,6,9,4,18,0.9407876400535828,7.882400598735354
Amridge University,321,147,Alabama,Midsize City,NA,89.01,64.87,99.04,1,1,3,1,0,2,2,1,5,0.8346603614673296,1.3634500944175274
Anderson University IndiaNA,1565,1431,IndiaNA,Small City,NA,99.08,92.41,99.99,3,2,6,1,1,3,4,3,9,3.3119282631490816,1.3615034067344134
Anderson University South CaroliNA,2984,2550,South CaroliNA,Small City,private,100.0,100.0,100.0,26,13,53,14,7,28,40,20,81,37.69773163266337,2.3749490848874486
Andrews University,1704,1344,Michigan,Town,NA,99.96,97.91,100.0,5,3,11,2,1,5,7,4,16,1.4706037537698642,6.34086115218564
Angelo State University,8721,5332,Texas,Midsize City,NA,100.0,100.0,100.0,106,45,248,39,16,92,145,61,340,144.18723419083435,0.5476369449234896
AnNA Maria College,1121,866,Massachusetts,Rural,NA,98.41,90.24,99.95,3,2,5,1,1,2,4,3,7,3.775921433156235,0.3577951539368681
Antioch University - Seattle,90,17,Washington,Large City,NA,33.33,18.44,56.77,0,0,1,0,0,0,0,0,1,0.011001028575087106,0.39294444653512667
Appalachian State University,17014,16071,North CaroliNA,Town,public,100.0,100.0,100.0,22,10,48,10,5,23,32,15,71,20.558732301746307,11.679507464994499
AquiNAs College Michigan,1553,1317,Michigan,Midsize City,NA,99.32,90.35,100.0,3,2,7,2,1,4,5,3,11,4.677701672147448,0.30927766049403876
Arcadia University,2387,2177,Pennsylvania,Suburb,NA,99.95,98.3,100.0,5,3,10,2,1,5,7,4,15,2.893126286122129,4.62431648061634
ArizoNA Christian University,784,646,ArizoNA,Large City,NA,99.61,94.99,100.0,4,2,7,2,1,3,6,3,10,4.533128786802457,0.9949488007513869
ArizoNA State University - Tempe,42429,38814,ArizoNA,Midsize City,NA,100.0,100.0,100.0,192,104,369,84,45,167,276,149,536,198.38366379905028,77.67863456642647
Arkansas Baptist College,597,496,Arkansas,Midsize City,NA,94.14,72.32,99.81,2,1,4,1,0,2,3,1,6,0.6140305622410632,2.2095220300080687
Arkansas State University - Main Campus,9608,6894,Arkansas,Small City,public,100.0,99.97,100.0,14,6,32,6,2,14,20,8,46,15.259994320738771,4.7965728821820255
Arkansas Tech University,10780,6729,Arkansas,Town,public,100.0,99.99,100.0,15,6,34,7,3,16,22,9,50,18.40667847738283,3.1633249745204153
Armstrong State University,6283,4513,Georgia,Midsize City,public,100.0,99.76,100.0,14,4,41,6,2,20,20,6,61,18.033091710747915,2.2108123417598393
Asbury University,1731,1325,Kentucky,Town,NA,99.79,93.99,100.0,4,2,10,2,1,4,6,3,14,2.2909779726703388,3.8533604581576224
Ashford University,31543,31545,California,Large City,private,100.0,100.0,100.0,130,61,286,58,26,134,188,87,420,10.930732138124041,178.00811955894872
Ashland University,4812,3380,Ohio,Town,NA,100.0,99.79,100.0,8,4,15,4,2,7,12,6,22,10.421407300014415,1.2131586053473709
Assumption College,2085,1937,Massachusetts,Midsize City,private,99.92,98.06,100.0,5,3,9,2,1,4,7,4,13,5.257342694417081,1.9116112793682152
Point University,1925,1119,Georgia,Town,NA,99.92,90.58,100.0,5,2,13,2,1,7,7,3,20,5.197650209174561,1.8882608902702
Auburn University,23968,21762,Alabama,Small City,public,100.0,100.0,100.0,95,43,202,43,19,97,138,62,299,69.55675819756,67.94258496357007
Auburn University at Montgomery,4312,3239,Alabama,Midsize City,NA,100.0,100.0,100.0,15,7,31,7,3,15,22,10,46,20.93390397270234,1.4118304105140753
Augsburg University,2428,2033,Minnesota,Large City,NA,89.54,67.24,99.09,2,1,3,1,0,1,3,1,4,1.1365409549438548,1.115906846109918
AugustaNA College,2650,2637,Illinois,Small City,NA,98.93,90.46,99.99,3,2,7,1,1,3,4,3,10,3.6391923432684146,0.8901075021319771
AugustaNA University,1746,1679,South Dakota,Midsize City,NA,96.51,83.61,99.83,2,1,4,1,1,2,3,2,6,2.128209122900324,1.2218821378256417
Aurora University,3935,3461,Illinois,Suburb,private,99.95,98.13,100.0,5,3,11,2,1,5,7,4,16,5.3929065845503485,2.173371046259968
Austin College,1218,1204,Texas,Small City,NA,100.0,99.97,100.0,14,6,32,5,2,12,19,8,44,18.39114308088758,0.5171648152134314
Austin Peay State University,9591,7065,Tennessee,Midsize City,NA,100.0,100.0,100.0,23,9,57,10,4,26,33,13,83,31.143960572980742,1.9713221343661211
Ave Maria University,1071,1035,Florida,Rural,NA,99.99,98.91,100.0,6,3,13,3,1,7,9,4,20,6.56045697577802,2.445509429890991
Averett University,929,890,Virginia,Town,NA,99.23,89.49,99.99,3,2,6,2,1,3,5,3,9,2.6314014287877394,2.2186240591883997
Averett University - Non - TraditioNAl Programs,344,87,Virginia,Town,NA,83.66,53.77,96.62,1,1,2,1,0,1,2,1,3,1.80679060180236,0.0
Avila University,1274,1077,Missouri,Large City,NA,97.35,77.68,99.99,3,1,6,1,0,3,4,1,9,1.4504527549623278,2.166394890637623
Azusa Pacific University,5674,5075,California,Suburb,private,100.0,100.0,100.0,25,13,51,12,6,25,37,19,76,31.071685997453738,5.590018989225989
Bacone College,936,864,Oklahoma,Town,private,99.71,92.17,100.0,4,2,9,2,1,4,6,3,13,1.5410920573644686,4.263639662385592
Baker University,1774,1062,Kansas,Town,NA,98.62,85.37,99.99,3,1,6,1,1,3,4,2,9,0.8125248310749392,3.4502319771631593
Baldwin Wallace University,3191,2958,Ohio,Suburb,NA,99.97,98.69,100.0,6,3,11,3,1,5,9,4,16,6.244424930663934,1.9845206186790572
Ball State University,17000,15203,IndiaNA,Small City,NA,100.0,100.0,100.0,33,19,61,15,9,29,48,28,90,43.01216679576773,5.37466222229984
Bard College,1941,1862,New York,Town,NA,99.96,98.33,100.0,5,3,10,2,1,5,7,4,15,1.6502659910323043,6.066068090246693
BarNArd College,2549,2514,New York,Large City,NA,100.0,99.78,100.0,8,4,16,4,2,7,12,6,23,2.6235742779967794,8.920997312316935
Barry University,3504,2991,Florida,Suburb,NA,100.0,100.0,100.0,24,12,48,11,6,24,35,18,72,30.093714467728635,4.958213167313814
Barton College,888,830,North CaroliNA,Town,private,82.55,55.51,97.71,1,1,3,1,0,1,2,1,4,0.9789872524641099,0.7636387347584366
Bates College,1788,1787,Maine,Small City,NA,99.67,95.07,100.0,4,2,8,2,1,4,6,3,12,0.14883262569062558,5.544447351184485
Bay Path University,1946,1367,Massachusetts,Suburb,NA,99.76,96.58,100.0,4,2,7,2,1,4,6,3,11,5.227543990885971,0.7778585209342964
Baylor University,14311,14100,Texas,Midsize City,private,100.0,100.0,100.0,148,64,346,55,22,131,203,86,477,192.18240192020735,11.151206007918807
Beacon College,349,344,Florida,Suburb,private,91.74,72.71,99.32,2,1,3,1,0,2,3,1,5,1.3474797522863566,1.1311562137417976
Becker College,1885,1530,Massachusetts,Midsize City,private,99.83,97.01,100.0,4,2,8,2,1,4,6,3,12,5.248828779122478,1.1072315865748645
Belhaven University,2479,1248,Mississippi,Midsize City,private,100.0,100.0,100.0,15,8,32,7,3,15,22,11,47,10.58253531909977,11.915103312928604
Bellarmine University,2539,2410,Kentucky,Large City,NA,99.9,95.58,100.0,5,2,11,2,1,5,7,3,16,4.431857388510552,2.4361641034141894
Bellevue University,5743,4919,Nebraska,Suburb,NA,99.98,97.97,100.0,6,3,13,3,1,6,9,4,19,0.7128789405321733,7.885268806588339
Belmont Abbey College,1552,1381,North CaroliNA,Suburb,private,99.5,92.32,100.0,4,2,7,2,1,4,6,3,11,1.208626237610012,4.063623382282724
Belmont University,6496,6161,Tennessee,Large City,NA,100.0,100.0,100.0,22,10,51,10,4,23,32,14,74,6.69969264254556,25.37275262953194
Beloit College,1407,1346,Wisconsin,Small City,NA,96.13,80.72,99.89,2,1,5,1,0,2,3,1,7,0.14760978943759456,3.09470795561456
Bemidji State University,4819,3333,Minnesota,Town,NA,97.88,83.84,99.98,3,1,6,1,1,3,4,2,9,2.406185415605322,1.438677970098825
Benedict College,2089,2077,South CaroliNA,Midsize City,NA,100.0,99.99,100.0,13,7,27,7,3,14,20,10,41,16.037933051675758,3.921564020728122
Benedictine College,2080,1821,Kansas,Town,NA,99.58,91.88,100.0,4,2,8,2,1,4,6,3,12,0.4246966612686637,5.027696498457434
Benedictine University,2883,2473,Illinois,Suburb,private,99.35,93.32,100.0,4,2,7,2,1,3,6,3,10,4.224286629492172,0.8056389981402396
Bennett College,490,400,North CaroliNA,Large City,private,76.21,51.99,94.28,1,1,2,0,0,1,1,1,3,0.23635357535484683,1.1964454183706155
Bennington College,775,724,Vermont,Town,NA,96.13,81.56,99.86,2,1,4,1,1,2,3,2,6,0.00010621292646650043,3.23893147949279
Bentley University,4270,4171,Massachusetts,Small City,private,100.0,99.98,100.0,11,6,20,5,3,10,16,9,30,7.9817955886898995,7.727692271855577
Berea College,1668,1615,Kentucky,Town,NA,99.59,91.24,100.0,4,2,8,2,1,4,6,3,12,2.0618801754033047,3.421692454932967
Berry College,1976,1945,Georgia,Suburb,private,99.97,95.29,100.0,6,2,15,3,1,7,9,3,22,4.284468576802302,3.9170069901793667
Bethany College Kansas,777,710,Kansas,Town,NA,89.05,61.99,99.36,2,1,4,1,0,1,3,1,5,0.370811942977481,1.8265761863696919
Bethany College West Virginia,598,594,West Virginia,Rural,private,78.92,55.54,95.24,1,1,2,0,0,1,1,1,3,0.03137823616568257,1.5205718389148224
Bethany Lutheran College,651,522,Minnesota,Small City,NA,52.66,29.68,80.99,1,0,1,0,0,1,1,0,2,0.26294733374418056,0.4824735571727239
Bethel College - Mishawaka,1330,1044,IndiaNA,Small City,NA,98.1,88.31,99.97,3,1,5,1,1,3,4,2,8,2.7828205527150747,1.1715554260138061
Bethel College - North Newton,502,489,Kansas,Town,NA,62.79,36.11,88.51,1,0,2,0,0,1,1,0,3,0.25666142133431763,0.7273780043939808
Bethel University Minnesota,2898,2407,Minnesota,Suburb,NA,94.3,74.51,99.88,2,1,4,1,0,2,3,1,6,1.1881525183853778,1.6709409290084263
Bethel University Tennessee,4830,3454,Tennessee,Town,NA,100.0,99.97,100.0,14,6,34,6,2,16,20,8,50,14.302059037647206,5.680244894783415
Bethune - Cookman University,3988,3755,Florida,Small City,private,100.0,100.0,100.0,30,15,61,14,7,30,44,22,91,36.72222597645041,7.31942149915791
Biola University,4047,3882,California,Suburb,private,100.0,100.0,100.0,18,9,38,8,4,18,26,13,56,22.47645523378487,4.1638865958549705
Birmingham Southern College,1287,1272,Alabama,Midsize City,NA,99.94,96.13,100.0,5,2,11,2,1,5,7,3,16,3.743011061983925,3.5778195394289427
Black Hills State University,3951,2195,South Dakota,Town,NA,100.0,99.75,100.0,7,4,14,4,2,9,11,6,23,9.014829321437954,1.7185597034792004
Blackburn College,557,546,Illinois,Town,private,64.48,41.19,89.01,1,0,2,0,0,1,1,0,3,0.7999948685633153,0.23301486742693203
Bloomfield College,1839,1700,New Jersey,Suburb,NA,100.0,99.9,100.0,9,5,17,4,2,8,13,7,25,12.621696944968805,0.020337785100750228
Bloomsburg University of Pennsylvania,8578,7863,Pennsylvania,Small City,public,100.0,100.0,100.0,15,9,30,7,4,14,22,13,44,15.330672051210826,7.247260399850965
Blue Mountain College,590,531,Mississippi,Rural,NA,99.86,96.1,100.0,4,2,9,2,1,4,6,3,13,5.716327942450015,0.8405056060555531
Bluefield College,949,829,Virginia,Town,NA,98.89,85.92,99.98,3,1,6,2,1,3,5,2,9,3.571562817516293,0.9163075410471082
Bluefield State College,1380,1099,West Virginia,Town,NA,59.29,32.06,81.41,1,0,1,0,0,1,1,0,2,0.28624175149701797,0.6105035457801439
Bluffton University,735,660,Ohio,Town,NA,83.95,61.72,97.08,1,1,2,1,0,1,2,1,3,1.3915478778071313,0.435172137365805
Boise State University,20744,12477,Idaho,Midsize City,public,100.0,100.0,100.0,58,23,151,31,11,89,89,34,240,53.64844574045992,35.26932328256057
Boston College,9924,9681,Massachusetts,Small City,private,100.0,100.0,100.0,29,16,55,13,7,26,42,23,81,11.00423551827381,30.650737383225827
Boston University,18086,16840,Massachusetts,Large City,private,100.0,100.0,100.0,55,30,109,25,13,52,80,43,161,17.16405323391876,63.43183558890535
Bowdoin College,1819,1813,Maine,Town,private,99.91,97.27,100.0,5,3,10,2,1,5,7,4,15,0.16243560760858597,6.85494805306133
Bowie State University,5185,4389,Maryland,Suburb,NA,100.0,99.97,100.0,10,6,19,5,2,9,15,8,28,12.642119234817226,2.1921439559216322
Bowling Green State University - Main Campus,14679,13104,Ohio,Town,public,100.0,100.0,100.0,25,13,48,12,6,23,37,19,71,29.741704810207207,6.771234556570961
Bradley University,4645,4512,Illinois,Midsize City,NA,99.97,98.66,100.0,6,3,12,2,1,5,8,4,17,6.219567948732441,1.9456184052837977
Brandeis University,3630,3620,Massachusetts,Small City,NA,100.0,99.98,100.0,11,6,21,5,3,10,16,9,31,3.660983576679101,11.773659922605136
BreNAu University,1737,1080,Georgia,Small City,NA,99.74,84.59,100.0,4,1,11,2,1,6,6,2,17,4.81740736553103,1.1048248909332188
Brescia University,1177,715,Kentucky,Small City,NA,95.9,75.28,99.95,2,1,5,1,0,3,3,1,8,2.4647763016315367,0.7240950879459387
Brevard College,673,656,North CaroliNA,Town,NA,96.4,79.25,99.92,2,1,5,1,0,2,3,1,7,0.48479341308579377,2.8203374712163787
Brewton - Parker College,782,438,Georgia,Rural,NA,97.44,76.07,99.99,2,1,6,1,0,3,3,1,9,1.880255951245175,1.7684613631572237
Briar Cliff University,943,720,Iowa,Small City,NA,96.37,74.99,99.97,2,1,5,1,0,3,3,1,8,1.1657674469241368,2.135336653771529
Bridgewater College,1880,1876,Virginia,Suburb,private,99.99,97.97,100.0,6,3,11,3,1,6,9,4,17,7.873195093319005,0.9922454723773836
Bridgewater State University,9562,7858,Massachusetts,Suburb,NA,100.0,100.0,100.0,27,16,50,13,7,24,40,23,74,39.34280257635843,0.8301544413594883
Brigham Young University - Hawaii,3138,2702,Hawaii,Town,private,100.0,99.94,100.0,11,5,26,5,2,13,16,7,39,0.00085177260899924,16.641460200139424
Brigham Young University - Idaho,51883,17230,Idaho,Town,NA,100.0,100.0,100.0,186,82,452,89,36,240,275,118,692,37.815152125343815,237.14803657759285
Brigham Young University - Provo,31232,28156,Utah,Midsize City,NA,100.0,100.0,100.0,126,53,307,60,23,157,186,76,464,59.73871159355608,125.90381401880497
Brown University,6986,6666,Rhode Island,Midsize City,NA,100.0,100.0,100.0,22,12,44,10,5,21,32,17,65,0.24117982885792397,31.870945001218985
Bryan College - Dayton,1238,833,Tennessee,Town,NA,99.49,88.62,100.0,4,2,9,2,1,4,6,3,13,2.563868034826605,2.6981924771170123
Bryant University,3476,3418,Rhode Island,Suburb,private,100.0,99.71,100.0,7,4,14,3,2,6,10,6,20,0.20875893383112107,10.375577284783894
Bryn Athyn College of the New Church,329,313,Pennsylvania,Suburb,private,59.0,38.22,82.94,1,0,1,0,0,1,1,0,2,0.4718403385091885,0.4181477952113101
Bryn Mawr College,1340,1325,Pennsylvania,Suburb,NA,99.84,96.39,100.0,4,2,9,2,1,4,6,3,13,0.3890613317531905,6.0488147353563155
Bucknell University,3608,3585,Pennsylvania,Town,private,100.0,99.93,100.0,9,5,18,4,2,9,13,7,27,1.796304446605156,11.760485253490353
BueNA Vista University,1805,1522,Iowa,Town,private,99.34,83.84,100.0,3,1,9,2,1,4,5,2,13,3.9307286992442045,1.0774865548630994
Butler University,4288,4182,IndiaNA,Large City,NA,100.0,99.83,100.0,8,4,16,4,2,8,12,6,24,6.49801469246521,5.333632666156441
Cabrini University,1687,1479,Pennsylvania,Suburb,private,99.73,96.09,100.0,4,2,8,2,1,4,6,3,12,1.8728750278544544,4.0408128422078295
Caldwell University,1605,1440,New Jersey,Suburb,NA,100.0,99.63,100.0,7,4,14,3,2,7,10,6,21,9.72807646631875,0.5596505930466085
California Baptist University,7421,6367,California,Large City,NA,100.0,100.0,100.0,36,19,74,17,8,35,53,27,109,50.17301228570935,3.014552046956536
California Institute of Technology,962,961,California,Midsize City,NA,99.69,94.22,100.0,4,2,8,2,1,4,6,3,12,2.3574653372243413,3.3895053353358233
California Lutheran University,2968,2858,California,Midsize City,private,100.0,100.0,100.0,15,8,30,7,3,14,22,11,44,18.01777079164318,3.23722497649381
California State University Maritime Academy,1050,1007,California,Midsize City,NA,99.88,97.0,100.0,5,2,9,2,1,4,7,3,13,6.4281197704440105,0.27198974325166564
California Polytechnic State University - San Luis Obispo,21348,20584,California,Suburb,NA,100.0,100.0,100.0,104,54,211,48,24,101,152,78,312,139.7933017048496,11.371929833905464
California State Polytechnic University - PomoNA,24318,21668,California,Suburb,NA,100.0,100.0,100.0,122,64,246,56,28,117,178,92,363,176.80257897090252,1.6469256349241936
California State University - Bakersfield,8816,7502,California,Large City,NA,100.0,100.0,100.0,44,23,89,20,10,43,64,33,132,63.83459712813363,0.9176680965202999
California State University - Channel Islands,7054,5858,California,Suburb,NA,100.0,100.0,100.0,35,19,71,16,8,34,51,27,105,51.6445977912438,0.0
California State University - Chico,16709,15446,California,Small City,NA,100.0,100.0,100.0,83,44,168,38,19,80,121,63,248,120.01109257074968,1.4765926440965407
California State University - Dominguez Hills,13279,10084,California,Small City,NA,100.0,100.0,100.0,67,35,134,30,15,64,97,50,198,96.74393467727467,0.32763390998436054
California State University - East Bay,13473,11539,California,Midsize City,NA,100.0,100.0,100.0,67,35,135,31,15,64,98,50,199,97.05875147696612,0.6533133282696166
California State University - Fresno,22260,19432,California,Large City,NA,100.0,100.0,100.0,112,59,225,51,26,107,163,85,332,161.70601522755908,1.1891746101229288
California State University - Fullerton,35161,28475,California,Suburb,public,100.0,100.0,100.0,177,93,355,81,41,169,258,134,524,256.37069476268556,0.9442461503036276
California State University - Long Beach,31564,27507,California,Large City,public,100.0,100.0,100.0,158,83,317,72,36,151,230,119,468,228.51306865045385,1.5512521655583613
California State University - Los Angeles,24820,21004,California,Large City,public,100.0,100.0,100.0,125,65,251,57,29,119,182,94,370,180.69020038104577,1.1541601422450327
California State University - Monterey Bay,6762,6109,California,Suburb,NA,100.0,100.0,100.0,34,18,68,16,8,33,50,26,101,48.562321682636814,0.8186359871277779
California State University - Northridge,35836,29739,California,Large City,NA,100.0,100.0,100.0,180,94,361,82,41,171,262,135,532,260.6756314654431,1.045974757049139
California State University - Sacramento,28449,23491,California,Large City,public,100.0,100.0,100.0,143,75,287,65,33,137,208,108,424,206.556427202206,1.29787439808086
California State University - San BerNArdino,18324,16381,California,Midsize City,public,100.0,100.0,100.0,92,48,185,42,21,88,134,69,273,133.57017892025118,0.3392505219461704
California State University - San Marcos,14616,11634,California,Suburb,NA,100.0,100.0,100.0,73,39,148,34,17,70,107,56,218,106.56914735601711,0.4690439067238822
California State University - Stanislaus,9058,7621,California,Suburb,NA,100.0,100.0,100.0,45,24,91,21,10,43,66,34,134,66.05295736781989,0.19784949575325173
California University of Pennsylvania,5553,4534,Pennsylvania,Suburb,public,100.0,99.88,100.0,8,5,16,4,2,8,12,7,24,10.724020325239538,1.4444262482174497
Calumet College of Saint Joseph,624,427,IndiaNA,Suburb,private,79.4,59.38,94.72,1,1,2,1,0,1,2,1,3,1.3384995053141366,0.23926614919937786
Calvin College,3737,3524,Michigan,Midsize City,NA,100.0,99.78,100.0,8,4,18,4,2,9,12,6,27,6.985367830406855,5.462095604389472
Cambridge College,750,221,Massachusetts,Large City,private,95.86,83.41,99.72,2,1,4,1,1,2,3,2,6,3.1756904048867547,0.0018504719406446657
Cameron University,4149,2814,Oklahoma,Small City,NA,100.0,99.66,100.0,9,4,23,5,2,11,14,6,34,10.889441308092787,3.1174185342546132
Campbell University,4382,3634,North CaroliNA,Town,NA,99.99,98.98,100.0,7,3,14,3,1,7,10,4,21,4.966110918535361,4.796537538912788
Campbellsville University,3704,2128,Kentucky,Town,private,100.0,99.13,100.0,7,3,18,3,1,9,10,4,27,8.342319790137509,2.5178191020516127
Canisius College,2397,2303,New York,Large City,private,99.92,98.63,100.0,5,3,8,2,1,4,7,4,12,6.551672200313109,0.5867466984419254
Capella University,9208,1382,Minnesota,Large City,NA,100.0,100.0,100.0,30,14,65,14,6,31,44,20,96,0.1640704437825259,42.95135510861242
Capital University,2703,2493,Ohio,Suburb,NA,99.87,96.95,100.0,5,2,9,2,1,4,7,3,13,5.685467043611994,0.9692194606867787
CardiNAl Stritch University,1542,901,Wisconsin,Suburb,NA,66.87,45.29,88.57,1,0,1,0,0,1,1,0,2,0.6730603368212503,0.4301168835641678
Carleton College,2068,2055,Minnesota,Town,NA,99.91,96.88,100.0,5,2,10,2,1,5,7,3,15,0.24447582682826707,6.693781564539248
Carlos Albizu University - Miami,376,291,Florida,Suburb,NA,99.42,92.98,100.0,3,2,7,2,1,3,5,3,10,5.117700877370406,0.0
Carlow University,1365,1075,Pennsylvania,Large City,NA,94.64,80.3,99.66,2,1,4,1,1,2,3,2,6,2.6054692376450364,0.3165857920956203
Carnegie Mellon University,6530,6298,Pennsylvania,Large City,NA,100.0,100.0,100.0,21,11,42,9,5,20,30,16,62,2.661345067205335,27.50415311803446
Carroll College,1360,1287,MontaNA,Town,NA,99.91,74.1,100.0,4,1,29,3,0,26,7,1,55,4.3659335374183765,2.6577149401300715
Carroll University,2983,2737,Wisconsin,Small City,NA,91.43,74.62,99.14,2,1,3,1,0,1,3,1,4,1.10027228713893,1.3547029761524565
Carson - Newman University,1688,1608,Tennessee,Suburb,NA,99.93,94.88,100.0,5,2,12,2,1,5,7,3,17,4.104934631395742,3.1089335577834856
Carthage College,2740,2596,Wisconsin,Suburb,NA,97.33,85.65,99.94,3,1,5,1,1,2,4,2,7,0.4347687654766011,3.185201769747456
Case Western Reserve University,5147,4978,Ohio,Large City,private,100.0,99.99,100.0,12,6,24,5,3,11,17,9,35,4.8692482043604155,12.42341436175389
Castleton University,1857,1590,Vermont,Town,NA,88.3,69.38,98.21,1,1,3,1,0,1,2,1,4,0.007109627765351373,2.133464984996735
Catawba College,1322,1268,North CaroliNA,Suburb,NA,95.44,76.92,99.87,2,1,4,1,0,2,3,1,6,1.5107827970125152,1.5659163286171156
Catholic University of America,3308,3194,District of Columbia,Large City,NA,100.0,99.92,100.0,9,5,18,4,2,9,13,7,27,0.08350742307571667,13.411427195584205
Cazenovia College,897,713,New York,Town,NA,94.57,81.37,99.59,2,1,4,1,1,2,3,2,6,1.9989137356165938,0.907795789077979
Cedar Crest College,1432,931,Pennsylvania,Midsize City,NA,97.54,87.19,99.93,3,1,5,1,1,2,4,2,7,2.05291936754875,1.6448408794586942
Cedarville University,3536,3109,Ohio,Town,private,100.0,99.44,100.0,7,4,14,3,2,7,10,6,21,2.8626127772032417,7.421004243998462
CenteNAry University,1366,1125,New Jersey,Suburb,private,99.98,99.07,100.0,6,3,12,3,1,6,9,4,18,7.812775292355145,0.8322891882642245
CenteNAry College of LouisiaNA,536,524,LouisiaNA,Midsize City,NA,99.34,88.88,100.0,4,2,8,1,1,3,5,3,11,2.5019294017861426,2.4934282579922877
Central Baptist College,745,599,Arkansas,Small City,private,90.18,62.76,99.48,2,1,4,1,0,2,3,1,6,1.1283923955386495,1.182446230599526
Central Christian College of Kansas,869,730,Kansas,Town,NA,98.98,86.58,100.0,3,1,7,1,1,3,4,2,10,0.21695689206713037,4.337901258008498
Central College,1232,1198,Iowa,Town,NA,98.08,76.69,100.0,3,1,7,1,0,4,4,1,11,2.9801798579060623,0.9622317814995993
Central Connecticut State University,9550,7605,Connecticut,Suburb,NA,99.78,97.64,100.0,4,3,7,2,1,3,6,4,10,4.213061990862743,1.8893969031460847
Central Methodist University - College of Liberal Arts & Sciences,1058,1034,Missouri,Town,NA,90.16,59.61,99.7,2,1,4,1,0,2,3,1,6,1.6754633255412092,0.6379210035154377
Central Michigan University,17801,15585,Michigan,Town,NA,100.0,100.0,100.0,39,19,86,19,8,44,58,27,130,55.991268366188784,1.875287275130923
Central Penn College,1197,316,Pennsylvania,Suburb,NA,94.43,80.01,99.63,2,1,4,1,0,2,3,1,6,2.019807764846351,0.8641375511528346
Central State University,1788,1710,Ohio,Rural,public,99.11,90.93,99.99,3,2,6,1,1,3,4,3,9,2.1399433751151684,2.5712394478325598
Central Washington University,12080,10446,Washington,Town,NA,100.0,100.0,100.0,29,19,49,15,10,28,44,29,77,42.687657880863,1.4053447920316806
Centre College,1447,1449,Kentucky,Town,NA,99.18,87.92,100.0,3,1,8,2,1,4,5,2,12,2.0829466395198137,2.7135865913652526
Chadron State College,2151,1616,Nebraska,Town,NA,85.58,63.2,98.51,1,1,3,1,0,1,2,1,4,0.21409785168493237,1.7181499424669562
ChamiNAde University of Honolulu,1813,1524,Hawaii,Large City,NA,99.05,90.1,99.99,3,2,7,1,1,3,4,3,10,0.002243369936429167,4.635293113346763
Champlain College,3933,2603,Vermont,Small City,NA,100.0,99.52,100.0,7,4,13,3,2,6,10,6,19,0.004434389679976393,9.880229971282196
Chapman University,7023,6515,California,Midsize City,NA,100.0,100.0,100.0,32,16,65,14,7,31,46,23,96,34.60056268236719,11.462973371247383
Charleston Southern University,3062,2804,South CaroliNA,Midsize City,private,100.0,100.0,100.0,27,13,53,14,7,28,41,20,81,36.88568438954055,3.527023647206082
Chatham University,1207,951,Pennsylvania,Large City,NA,96.86,83.88,99.9,2,1,5,1,1,2,3,2,7,1.6473022344443597,1.8046376004689033
Chestnut Hill College,1363,1118,Pennsylvania,Large City,NA,99.12,92.36,99.99,3,2,6,1,1,3,4,3,9,1.5665927028572617,3.1539681679529905
Cheyney University of Pennsylvania,718,671,Pennsylvania,Suburb,public,85.44,65.61,97.64,1,1,3,1,0,1,2,1,4,1.063710236814574,0.8593569265919785
Chicago State University,2032,1297,Illinois,Large City,NA,96.58,83.87,99.89,2,1,5,1,1,2,3,2,7,3.065078378770035,0.30753304370118545
Chowan University,1500,1440,North CaroliNA,Town,private,99.62,92.12,100.0,4,2,7,2,1,4,6,3,11,0.8890117436642534,4.675005997466264
Christian Brothers University,1789,1426,Tennessee,Large City,NA,99.97,96.34,100.0,6,2,13,2,1,6,8,3,19,5.155193826384954,2.873303293055109
Christopher Newport University,4951,4867,Virginia,Midsize City,NA,100.0,100.0,100.0,17,7,31,9,4,17,26,11,48,24.727820213039276,0.6943066187688351
Citadel Military College of South CaroliNA,2837,2559,South CaroliNA,Midsize City,NA,100.0,100.0,100.0,20,10,41,10,5,21,30,15,62,23.471288584876987,7.1320845522035885
City University of Seattle,929,235,Washington,Large City,NA,97.76,90.67,99.86,2,2,4,1,1,2,3,3,6,3.120625105799709,0.6666003639614183
Claflin University,2040,1955,South CaroliNA,Town,private,100.0,100.0,100.0,17,8,33,9,4,18,26,12,51,22.909102031945803,2.187213944034682
Claremont McKenNA College,1341,1337,California,Suburb,NA,99.95,97.95,100.0,5,3,11,2,1,5,7,4,16,4.5758255769106,3.050300065565004
Clarion University of Pennsylvania,4319,3483,Pennsylvania,Town,public,99.99,99.46,100.0,6,4,12,3,2,6,9,6,18,8.402069185733795,1.0100702890612052
Clark Atlanta University,3305,3187,Georgia,Large City,NA,100.0,99.97,100.0,12,6,27,5,2,13,17,8,40,2.5748727994758767,14.932118508325111
Clark University,2240,2199,Massachusetts,Midsize City,private,99.94,98.22,100.0,5,3,10,2,1,5,7,4,15,3.6439557460898957,3.8292799863744826
Clarke University,765,708,Iowa,Small City,NA,87.42,57.26,99.55,1,1,4,1,0,2,2,1,6,1.0880496171291942,0.9796495803070485
Clarkson University,3086,3021,New York,Town,private,99.98,99.31,100.0,6,3,10,3,2,5,9,5,15,6.3279565642048565,2.221979888190682
Clayton State University,6553,3743,Georgia,Suburb,NA,100.0,99.71,100.0,14,4,41,6,2,21,20,6,62,19.01513622031546,1.2177441717423059
Clemson University,19409,18642,South CaroliNA,Suburb,public,100.0,100.0,100.0,142,71,283,73,35,150,215,106,433,183.13226961733363,31.378194533638908
Cleveland State University,12077,9268,Ohio,Large City,NA,100.0,100.0,100.0,20,11,37,9,5,18,29,16,55,27.192482647501706,1.548523729536181
Coastal CaroliNA University,9899,9021,South CaroliNA,Small City,NA,100.0,100.0,100.0,61,31,120,31,15,63,92,46,183,72.92808894968432,18.881453741403348
Coe College,1393,1369,Iowa,Midsize City,private,97.84,77.99,99.99,3,1,7,1,0,3,4,1,10,2.191044970757416,1.636194977589034
Cogswell College,606,436,California,Large City,NA,98.29,87.81,99.97,3,1,6,1,1,3,4,2,9,3.909585372912417,0.144078942483258
Coker College,1025,909,South CaroliNA,Town,private,100.0,99.93,100.0,10,5,19,5,2,10,15,7,29,12.836592958595398,1.658795013466055
Colby College,1923,1917,Maine,Town,NA,99.73,95.7,100.0,4,2,8,2,1,4,6,3,12,0.16883701086409675,5.716617688989476
Colby - Sawyer College,983,920,New Hampshire,Rural,NA,87.27,63.64,98.08,1,1,3,1,0,1,2,1,4,0.24523591777958703,1.811900542511933
Colgate University,2882,2854,New York,Town,private,100.0,99.73,100.0,7,4,14,3,2,7,10,6,21,2.3475614802008833,8.567611626593006
College of Charleston,9901,9083,South CaroliNA,Midsize City,public,100.0,100.0,100.0,65,32,129,33,16,68,98,48,197,77.61297689077753,19.78782208629489
College of Mount Saint Vincent,1693,1613,New York,Large City,NA,99.42,95.39,99.99,4,2,6,2,1,3,6,3,9,4.390056183890514,0.7530339197484801
Mount St. Joseph University,1315,1000,Ohio,Suburb,NA,96.82,83.5,99.88,2,1,5,1,1,2,3,2,7,2.4790600848328728,0.9628174501028336
Notre Dame of Maryland University,817,528,Maryland,Large City,NA,91.71,73.35,99.15,2,1,3,1,0,2,3,1,5,1.8687150047972187,0.6163147983236171
College of Our Lady of the Elms,1174,973,Massachusetts,Suburb,private,98.28,89.87,99.95,3,2,5,1,1,2,4,3,7,3.7674075178616326,0.2870973435810233
College of Saint Benedict,1940,1916,Minnesota,Suburb,NA,84.2,58.94,98.06,1,1,3,1,0,1,2,1,4,0.8741369008148482,0.9670248035882609
College of Saint Elizabeth,757,587,New Jersey,Suburb,NA,99.45,94.02,100.0,4,2,7,2,1,3,6,3,10,5.16717942616081,0.019322016297755585
College of Saint Mary,833,761,Nebraska,Large City,NA,55.88,28.02,87.37,1,0,1,0,0,1,1,0,2,0.10688166189583734,0.70950843503004
Northeast Catholic College,69,70,New Hampshire,Rural,NA,13.6,5.79,26.43,0,0,0,0,0,0,0,0,0,0.021324862415616264,0.12449139426298048
College of the Atlantic,352,330,Maine,Town,private,62.63,39.34,85.81,1,0,1,0,0,1,1,0,2,0.06561438336898547,0.9160271101146003
College of the Holy Cross,2852,2827,Massachusetts,Midsize City,private,100.0,99.63,100.0,7,4,13,3,2,6,10,6,19,4.614542089674587,5.6663450142734595
College of the Ozarks,1510,1477,Missouri,Town,private,93.21,64.43,99.88,2,1,5,1,0,2,3,1,7,2.151447224842689,0.5359322342357573
College of William and Mary,6287,6199,Virginia,Suburb,NA,100.0,100.0,100.0,21,10,40,10,4,20,31,14,60,21.18251888682825,10.049638660456681
Colorado Christian University,6541,1840,Colorado,Midsize City,NA,100.0,100.0,100.0,16,7,39,7,3,18,23,10,57,3.0528910567314713,20.246167114571968
Colorado College,2106,2091,Colorado,Large City,private,99.94,97.1,100.0,5,2,11,2,1,5,7,3,16,0.42728687570083335,6.926922433347494
Colorado School of Mines,4790,4584,Colorado,Suburb,public,100.0,99.89,100.0,11,5,28,5,2,12,16,7,40,3.112809446197565,13.054968805445496
Colorado State University - Fort Collins,25523,22154,Colorado,Midsize City,public,100.0,100.0,100.0,31,13,81,14,5,39,45,18,120,20.483248779286157,24.8558988134815
Colorado State University - Pueblo,4627,3292,Colorado,Midsize City,NA,99.95,95.32,100.0,5,2,13,2,1,6,7,3,19,3.9870285711946725,3.505546459910596
Colorado Technical University - Colorado Springs,22305,14445,Colorado,Large City,NA,100.0,99.98,100.0,16,6,45,7,3,21,23,9,66,21.320141694451927,1.990276413683365
Columbia College Chicago,7029,6436,Illinois,Large City,NA,100.0,99.99,100.0,12,6,26,6,3,12,18,9,38,5.954471609934009,12.104142141724619
Columbia College Missouri,12747,5163,Missouri,Midsize City,private,100.0,100.0,100.0,34,16,77,16,7,37,50,23,114,12.285577153606924,37.52300756193854
Columbia College South CaroliNA,1383,804,South CaroliNA,Midsize City,NA,100.0,99.99,100.0,13,6,25,7,3,14,20,9,39,18.489691074181206,0.8870405068585596
Columbia InterNAtioNAl University,497,454,South CaroliNA,Midsize City,NA,99.64,93.64,100.0,4,2,7,2,1,4,6,3,11,4.51310871658646,1.0730890701888918
Columbia Southern University,15049,8567,Alabama,Town,private,100.0,100.0,100.0,67,31,150,31,13,72,98,44,222,4.696908617946588,93.30119266000699
Columbia University in the City of New York,8157,7592,New York,Large City,NA,100.0,100.0,100.0,29,15,59,13,7,27,42,22,86,5.816606538814566,36.449306308799045
Columbus State University,6798,4693,Georgia,Midsize City,NA,100.0,99.85,100.0,15,5,42,7,2,21,22,7,63,18.401358401835743,2.8029611581833684
Concord University,1853,1696,West Virginia,Town,public,91.65,67.14,99.1,2,1,3,1,0,2,3,1,5,0.3210061282561195,2.155263906799897
Concordia College at Moorhead,2032,1997,Minnesota,Suburb,NA,99.13,81.32,100.0,3,1,10,2,1,7,5,2,17,0.7665675370104107,3.961823999787521
Concordia College - New York,1131,1024,New York,Suburb,NA,97.4,88.14,99.85,2,1,4,1,1,2,3,2,6,2.6468174609690656,0.9962637743020082
Concordia University - Ann Arbor,906,780,Michigan,Midsize City,NA,95.71,77.4,99.91,2,1,5,1,0,2,3,1,7,2.4652308461633217,0.6766840397215776
Concordia University - Chicago,1458,1299,Illinois,Suburb,private,97.14,83.7,99.96,2,1,5,1,1,3,3,2,8,1.5623429197824745,1.9800192867309616
Concordia University - Irvine,1851,1645,California,Large City,private,100.0,99.86,100.0,9,5,19,4,2,9,13,7,28,10.872161570739586,2.1736230002750405
Concordia University - Portland,1378,1124,Oregon,Large City,NA,97.92,88.67,99.97,3,1,5,1,1,3,4,2,8,1.112922011306483,2.748198465820487
Concordia University - Saint Paul,2867,1417,Minnesota,Large City,NA,94.89,76.02,99.82,2,1,4,1,0,2,3,1,6,1.0919920264995928,1.8744436900517962
Concordia University - Nebraska,1682,1231,Nebraska,Town,NA,97.24,79.58,99.98,3,1,6,1,0,2,4,1,8,0.13364389335645388,3.435635602163455
Concordia University - Texas,1725,1347,Texas,Large City,NA,100.0,100.0,100.0,20,9,47,7,3,18,27,12,65,26.880656111827463,0.5400018077363901
Concordia University - Wisconsin,3713,2616,Wisconsin,Suburb,NA,99.71,94.87,100.0,4,2,8,2,1,4,6,3,12,1.2977570566254049,4.539170057521004
Connecticut College,1815,1766,Connecticut,Small City,private,99.81,96.45,100.0,4,2,8,2,1,4,6,3,12,0.1447994293554451,6.101157503046088
Converse College,920,860,South CaroliNA,Small City,NA,100.0,99.68,100.0,8,4,16,4,2,8,12,6,24,10.353602349815997,1.3201978486848172
Cooper Union for the Advancement of Science and Art,864,859,New York,Large City,NA,98.7,90.22,99.98,3,2,6,1,1,3,4,3,9,1.2551318805034426,3.0708084876807242
Coppin State University,2509,1854,Maryland,Large City,NA,99.95,98.35,100.0,5,3,10,2,1,5,7,4,15,5.711035960008044,1.9047774309069203
Corban University,1021,936,Oregon,Midsize City,private,96.95,83.93,99.98,2,1,5,1,1,3,3,2,8,0.6568306300150994,2.820772221481259
Cornell College,1006,1002,Iowa,Town,private,97.92,82.19,99.99,3,1,6,1,0,3,4,1,9,0.41549147467296155,3.4388403132308736
Cornell University,14907,14898,New York,Small City,NA,100.0,100.0,100.0,47,25,92,21,11,43,68,36,135,15.56131099994546,52.10569572597166
Cornerstone University,1757,1260,Michigan,Midsize City,NA,99.57,92.36,100.0,4,2,8,2,1,4,6,3,12,4.467615421608896,0.9802478932188664
CoveNAnt College,1033,983,Georgia,Rural,private,99.35,89.55,100.0,3,2,8,2,1,4,5,3,12,0.7634797254259867,4.254689548710058
Creighton University,4256,4011,Nebraska,Large City,NA,99.98,97.68,100.0,6,3,13,3,1,6,9,4,19,0.1970369291287893,8.197349249436622
Crown College,1055,698,Minnesota,Rural,NA,78.76,46.33,99.78,1,0,3,1,0,3,2,0,6,0.37160325677896594,1.1742312326063087
Culver - Stockton College,1092,969,Missouri,Rural,NA,91.51,66.1,99.7,2,1,4,1,0,2,3,1,6,0.974468855660848,1.4854326076812983
Cumberland University,1974,1578,Tennessee,Town,NA,99.9,92.63,100.0,5,2,12,2,1,5,7,3,17,5.810747768355344,1.0501381966353545
CUNY BerNArd M Baruch College,15253,11598,New York,Large City,NA,100.0,100.0,100.0,31,19,51,14,8,25,45,27,76,43.90346723677667,0.9783193046864467
CUNY Brooklyn College,14691,10786,New York,Large City,NA,100.0,100.0,100.0,30,18,50,14,8,24,44,26,74,41.51523018637429,1.881136977332353
CUNY City College,13211,10225,New York,Large City,public,100.0,100.0,100.0,26,16,44,12,7,21,38,23,65,38.092671493705176,0.47344491576687076
College of Staten Island CUNY,12509,9710,New York,Large City,public,100.0,100.0,100.0,25,15,41,12,7,20,37,22,61,36.32909498568298,0.03444786284107207
CUNY Graduate School and University Center,2066,418,New York,Large City,NA,99.75,97.41,100.0,4,3,7,2,1,3,6,4,10,6.002552002592853,0.0
CUNY Hunter College,16846,12612,New York,Large City,NA,100.0,100.0,100.0,34,21,58,16,9,28,50,30,86,47.53521457619635,2.612408960836875
CUNY John Jay College of CrimiNAl Justice,12916,10276,New York,Large City,public,100.0,100.0,100.0,26,16,43,12,7,21,38,23,64,37.46801095132499,0.13779145136428828
CUNY Lehman College,11978,7216,New York,Large City,NA,100.0,100.0,100.0,24,15,40,11,6,19,35,21,59,34.745653145696,0.13090187879607385
CUNY Queens College,16680,12149,New York,Large City,NA,100.0,100.0,100.0,33,20,55,15,9,27,48,29,82,48.46203649721626,0.0
CUNY York College,8393,5056,New York,Large City,NA,100.0,100.0,100.0,17,10,28,8,5,13,25,15,41,24.385004335799522,0.0
Curry College,2561,2059,Massachusetts,Suburb,private,99.99,99.3,100.0,6,3,11,3,2,5,9,5,16,7.036750990989016,1.8788615887458908
Daemen College,1799,1560,New York,Suburb,NA,99.56,96.09,99.99,4,2,6,2,1,3,6,3,9,4.95951416671152,0.45574935481269874
Dakota State University,2963,1397,South Dakota,Town,public,99.99,99.44,100.0,6,4,11,3,2,6,9,6,17,6.871590473093419,2.2532420277623757
Dakota Wesleyan University,793,668,South Dakota,Town,NA,93.47,77.8,99.35,2,1,3,1,0,2,3,1,5,1.767495712239252,0.953621267855461
Dallas Baptist University,3159,2423,Texas,Large City,NA,100.0,100.0,100.0,36,16,85,13,5,32,49,21,117,48.48268431926854,0.9681325095283866
Dartmouth College,4415,4360,New Hampshire,Town,NA,100.0,100.0,100.0,14,7,28,6,3,14,20,10,42,0.0943215068383027,19.87181642592563
Davenport University,5597,2621,Michigan,Suburb,NA,100.0,99.98,100.0,12,6,27,6,3,14,18,9,41,17.91641805374089,0.2868350273294241
Davidson College,1812,1810,North CaroliNA,Suburb,private,99.97,98.13,100.0,6,3,12,3,1,6,9,4,18,0.5317955445484054,7.6705430620946
Davis & Elkins College,839,785,West Virginia,Town,NA,77.73,49.64,95.94,1,0,2,0,0,1,1,0,3,0.1284475998436934,1.3686473945427895
Defiance College,583,525,Ohio,Town,NA,84.33,61.49,97.52,1,1,2,1,0,1,2,1,3,0.9635592027840977,0.8848717676703215
Delaware State University,4054,3571,Delaware,Small City,NA,100.0,99.73,100.0,7,4,14,3,2,7,10,6,21,0.8636815868216571,9.90721493968003
Delaware Valley University,1991,1756,Pennsylvania,Suburb,private,99.91,97.86,100.0,5,3,9,2,1,5,7,4,14,2.220546856229646,4.826187259081355
Delta State University,3034,2198,Mississippi,Town,NA,100.0,100.0,100.0,26,13,51,12,6,25,38,19,76,34.42988291491047,4.028668458539211
Denison University,2344,2319,Ohio,Suburb,NA,99.91,97.2,100.0,5,2,10,2,1,5,7,3,15,1.5201783539069502,5.4780711521722045
DePaul University,14822,12886,Illinois,Large City,NA,100.0,100.0,100.0,22,12,46,10,5,21,32,17,67,16.32460117085965,15.926945327703146
DePauw University,2156,2140,IndiaNA,Town,NA,99.82,96.41,100.0,4,2,9,2,1,4,6,3,13,2.559737301829385,3.7550924472781695
DeSales University,2350,1811,Pennsylvania,Suburb,private,99.94,98.36,100.0,5,3,10,2,1,5,7,4,15,3.1207685547011237,4.352055728330008
Dickinson College,2386,2346,Pennsylvania,Small City,private,99.98,98.91,100.0,6,3,11,3,1,6,9,4,17,1.022320733436575,7.497851344452278
Dickinson State University,1426,922,North Dakota,Town,public,100.0,96.74,100.0,6,2,22,4,1,16,10,3,38,6.992873278920701,3.339215452586855
DigiPen Institute of Technology,1024,964,Washington,Small City,NA,98.37,89.3,99.97,3,2,6,1,1,3,4,3,9,1.7674985910639949,2.3366754813177235
Dillard University,1292,1200,LouisiaNA,Large City,NA,99.99,98.79,100.0,7,3,15,3,1,7,10,4,22,5.990333824847964,3.715291120628735
Doane University,1066,1062,Nebraska,Town,NA,60.48,34.25,88.19,1,0,1,0,0,1,1,0,2,0.15020302407271036,0.7735097836544409
Dominican College of Blauvelt,1420,1271,New York,Suburb,private,99.48,95.11,99.99,4,2,7,2,1,3,6,3,10,3.1494512927447498,2.105049618883945
Dominican University,2171,2014,Illinois,Suburb,NA,97.16,85.4,99.93,2,1,5,1,1,2,3,2,7,3.126254456954289,0.43202389836533406
Dominican University of California,1304,1135,California,Small City,private,99.99,99.08,100.0,6,3,13,3,1,6,9,4,19,8.492732270746073,0.6079559593028498
Dordt College,1445,1341,Iowa,Town,NA,99.55,90.13,100.0,4,2,10,2,1,5,6,3,15,1.5962046580961258,3.7875901599897914
Drake University,3100,2955,Iowa,Midsize City,NA,99.81,92.87,100.0,4,2,10,2,1,5,6,3,15,2.8187659037165664,3.4363096876373445
Drew University,1534,1507,New Jersey,Suburb,private,99.99,99.12,100.0,6,3,12,3,1,6,9,4,18,6.6622166734633375,2.168918869279899
Drexel University,15528,13572,Pennsylvania,Large City,private,100.0,100.0,100.0,42,23,82,19,10,39,61,33,121,14.231780736524952,46.46877944912286
Drury University,3277,2478,Missouri,Midsize City,NA,99.85,91.83,100.0,5,2,11,2,1,5,7,3,16,5.126779308112667,1.3788053858513267
Duke University,6699,6669,North CaroliNA,Large City,NA,100.0,100.0,100.0,25,13,53,12,6,25,37,19,78,1.2072833195682233,35.83643856305469
Duquesne University,5941,5826,Pennsylvania,Large City,NA,100.0,99.96,100.0,10,5,19,5,2,9,15,7,28,8.98152223302578,5.6128192348346815
D'Youville College,1734,1295,New York,Large City,private,99.34,95.16,99.98,3,2,6,2,1,3,5,3,9,4.796811885905518,0.2129345028993056
Earlham College,1061,1051,IndiaNA,Town,private,97.08,83.8,99.94,2,1,5,1,1,2,3,2,7,0.7321706695735448,2.7925442248595207
East CaroliNA University,23267,19999,North CaroliNA,Small City,public,100.0,100.0,100.0,28,14,60,13,6,28,41,20,88,26.987280967789783,13.926244738509094
East Central University,3082,2551,Oklahoma,Town,NA,100.0,98.64,100.0,7,3,17,3,1,9,10,4,26,8.21727251137825,2.417206849904735
East Stroudsburg University of Pennsylvania,6051,5552,Pennsylvania,Small City,public,100.0,100.0,100.0,13,8,26,6,3,13,19,11,39,8.60487775228599,11.071840601175264
East Tennessee State University,11319,9641,Tennessee,Small City,NA,100.0,100.0,100.0,27,11,66,12,4,31,39,15,97,33.96181285757598,5.698930586078169
East Texas Baptist University,1421,1216,Texas,Town,NA,100.0,99.99,100.0,17,7,39,6,2,14,23,9,53,22.022301129764838,0.6546400325535789
Eastern Connecticut State University,5069,4210,Connecticut,Town,public,96.96,88.47,99.78,2,1,4,1,1,2,3,2,6,2.174304530257482,1.31620804536154
Eastern Illinois University,5569,4319,Illinois,Town,NA,99.99,99.31,100.0,6,3,13,3,1,6,9,4,19,8.545827537123415,0.6219353011989416
Eastern Kentucky University,14138,10744,Kentucky,Town,NA,100.0,100.0,100.0,25,11,60,12,5,29,37,16,89,31.952559448714815,5.5555606818279255
Eastern Mennonite University,1102,942,Virginia,Small City,NA,98.93,87.6,99.98,3,1,6,2,1,3,5,2,9,3.062089886194116,1.463461869495084
Eastern Michigan University,17218,12410,Michigan,Suburb,NA,100.0,100.0,100.0,38,18,82,18,8,42,56,26,124,49.08468287973388,6.56857550854603
Eastern Nazarene College,694,571,Massachusetts,Suburb,private,92.34,75.06,99.26,2,1,3,1,0,2,3,1,5,1.5410186683230633,1.0216192022076274
Eastern New Mexico University - Main Campus,4600,2590,New Mexico,Town,NA,100.0,100.0,100.0,22,8,56,9,3,26,31,11,82,18.87600354504629,11.916898162205321
Eastern Oregon University,2736,1668,Oregon,Town,public,99.86,96.77,100.0,4,2,10,2,1,6,6,3,16,2.9210512737075995,3.6648960752916553
Eastern University,1882,1462,Pennsylvania,Suburb,NA,99.8,96.39,100.0,4,2,8,2,1,4,6,3,12,1.9473761339348525,4.244427588770075
Eastern Washington University,11474,10060,Washington,Town,NA,100.0,100.0,100.0,28,18,48,15,9,27,43,27,75,39.33601117498646,3.174694483485213
Eckerd College,2036,1915,Florida,Large City,private,100.0,99.57,100.0,7,4,15,3,2,7,10,6,22,5.036035437837899,5.714811217495446
Edgewood College,1566,1361,Wisconsin,Large City,NA,62.79,43.05,84.57,1,0,1,0,0,1,1,0,2,0.7274694059654832,0.2604799837628573
Edinboro University of Pennsylvania,4294,3888,Pennsylvania,Town,public,99.99,99.55,100.0,7,4,13,3,2,6,10,6,19,7.640502323578613,2.062868688613491
Edward Waters College,3443,853,Florida,Large City,private,100.0,100.0,100.0,28,14,56,13,7,28,41,21,84,37.37554949271046,3.61883968654089
Elizabeth City State University,1365,1179,North CaroliNA,Town,NA,89.57,65.56,99.24,2,1,3,1,0,2,3,1,5,1.6437316831496165,0.6140280788624158
Elizabethtown College,1674,1636,Pennsylvania,Suburb,private,99.32,93.57,99.99,3,2,7,2,1,3,5,3,10,2.1108646722779483,2.870433342227065
Elmhurst College,2874,2732,Illinois,Suburb,private,99.7,95.33,100.0,4,2,8,2,1,4,6,3,12,3.8635046299440106,1.9483528991331558
Elmira College,936,833,New York,Small City,NA,93.1,77.85,99.27,2,1,3,1,0,2,3,1,5,1.342293816649515,1.3255148620297077
Elon University,6049,5885,North CaroliNA,Suburb,NA,100.0,100.0,100.0,15,8,30,7,3,14,22,11,44,2.0573504400205986,19.517905115087686
Embry Riddle AeroNAutical University - DaytoNA Beach,5733,5378,Florida,Small City,NA,100.0,100.0,100.0,27,14,55,13,6,27,40,20,82,22.389941338495525,17.11702978518634
Embry Riddle AeroNAutical University - Prescott,2607,2471,ArizoNA,Rural,NA,100.0,99.94,100.0,10,5,22,5,2,11,15,7,33,3.145293973612166,11.631692395929235
Emerson College,3814,3748,Massachusetts,Large City,NA,100.0,99.99,100.0,12,6,24,5,3,11,17,9,35,2.979870353110896,14.148180959744922
Emmanuel College Georgia,954,822,Georgia,Town,NA,99.1,84.77,100.0,3,1,8,2,1,4,5,2,12,2.0598982395807015,2.6314738094389782
Emmanuel College Massachusetts,1947,1804,Massachusetts,Large City,NA,99.89,97.57,100.0,5,3,9,2,1,4,7,4,13,5.35525272030501,1.3980675094808628
Emory and Henry College,999,966,Virginia,Rural,NA,99.04,86.57,99.99,3,1,6,2,1,3,5,2,9,2.9517916227119954,1.6815513424016137
Emory University,6938,6794,Georgia,Large City,NA,100.0,100.0,100.0,27,12,59,12,5,28,39,17,87,5.521006328178508,32.966639784024686
Emporia State University,3605,3340,Kansas,Town,NA,99.12,89.73,99.99,3,2,7,1,1,3,4,3,10,2.3290960471912525,2.3846073322681094
Endicott College,3348,2946,Massachusetts,Suburb,NA,99.99,99.41,100.0,6,4,12,3,2,6,9,6,18,6.7047082944995156,2.6893223665856945
Erskine College,573,568,South CaroliNA,Rural,NA,99.94,97.47,100.0,5,2,10,3,1,5,8,3,15,6.855552687133065,0.5810305010326368
Eureka College,615,593,Illinois,Town,private,62.48,41.42,86.1,1,0,1,0,0,1,1,0,2,0.9411704336039003,0.03838386062989615
Evangel University,1632,1461,Missouri,Midsize City,NA,99.77,93.32,100.0,4,2,10,2,1,4,6,3,14,0.9675454534891901,5.0998991877637865
Everglades University,2101,2099,Florida,Small City,NA,100.0,100.0,100.0,16,8,33,8,4,16,24,12,49,21.314679717984188,2.5495694051431816
Fairfield University,4118,3879,Connecticut,Suburb,private,100.0,99.94,100.0,9,5,17,4,2,8,13,7,25,0.5301602109946967,12.598351998537645
Fairleigh Dickinson University - Florham Campus,2747,2640,New Jersey,Suburb,NA,100.0,99.99,100.0,12,6,23,5,3,11,17,9,34,15.398194689959213,1.7620353664844914
Fairleigh Dickinson University - Metropolitan Campus,5471,2374,New Jersey,Suburb,NA,100.0,100.0,100.0,24,13,48,11,6,23,35,19,71,32.38099107060774,2.819316823274099
Fairmont State University,3661,3108,West Virginia,Town,public,87.15,61.57,98.22,1,1,3,1,0,1,2,1,4,0.7645905459940061,1.281771493338872
Farmingdale State College,9552,7407,New York,Suburb,NA,100.0,100.0,100.0,19,12,32,9,5,15,28,17,47,27.62452296256188,0.13251387341405393
Faulkner University,2673,1744,Alabama,Midsize City,NA,100.0,99.91,100.0,11,5,23,5,2,11,16,7,34,10.866137376618154,4.85960778858876
Fayetteville State University,5394,3905,North CaroliNA,Midsize City,NA,99.98,98.22,100.0,6,3,13,3,1,6,9,4,19,6.840824504872669,1.6854402948863711
Felician University,1626,1430,New Jersey,Suburb,NA,100.0,99.73,100.0,7,4,15,3,2,7,10,6,22,10.50659816652698,0.3967009903011317
Ferris State University,12513,8469,Michigan,Town,public,100.0,100.0,100.0,27,13,60,13,6,31,40,19,91,38.77076101735685,1.697916598301266
Ferrum College,1137,1118,Virginia,Rural,NA,99.59,90.86,100.0,4,2,7,2,1,4,6,3,11,4.774339119297515,0.7088791897418449
Finlandia University,399,336,Michigan,Town,NA,77.98,50.5,96.97,1,0,2,0,0,1,1,0,3,1.0405834596987655,0.46824179010223416
Fisk University,663,639,Tennessee,Large City,NA,95.07,72.75,99.91,2,1,5,1,0,2,3,1,7,0.8237327019523228,2.1731131679070828
Fitchburg State University,4119,3386,Massachusetts,Suburb,public,100.0,99.99,100.0,11,6,21,5,3,10,16,9,31,16.13386948327185,0.35243286133853935
Five Towns College,626,591,New York,Suburb,NA,85.85,68.81,96.74,1,1,2,1,0,1,2,1,3,1.5979688293446608,0.35403407612503457
Flagler College - St Augustine,2681,2591,Florida,Suburb,NA,100.0,100.0,100.0,17,9,35,8,4,17,25,13,52,20.974407053265413,4.50778130103802
Florida Agricultural and Mechanical University,8027,6875,Florida,Midsize City,NA,100.0,100.0,100.0,64,33,131,31,15,65,95,48,196,88.4436710137045,6.8535308655422496
Florida Atlantic University,25033,16325,Florida,Small City,public,100.0,100.0,100.0,216,113,434,105,53,217,321,166,651,312.68335706337854,7.906338437939259
Florida Gulf Coast University,13857,10973,Florida,Suburb,NA,100.0,100.0,100.0,119,63,240,58,29,120,177,92,360,172.98101183643746,4.0175656336469965
Florida Institute of Technology,3634,3269,Florida,Small City,private,100.0,100.0,100.0,21,11,42,10,5,21,31,16,63,22.920766695456816,7.662668147642017
Florida InterNAtioNAl University,47621,26655,Florida,Suburb,public,100.0,100.0,100.0,424,223,855,207,103,427,631,326,1282,622.8759182210156,7.819864578851639
Florida Memorial University,1173,1129,Florida,Suburb,private,100.0,99.93,100.0,10,5,19,5,2,10,15,7,29,13.474797522863568,0.645689031073548
Florida Southern College,2615,2356,Florida,Midsize City,NA,100.0,100.0,100.0,17,9,34,8,4,17,25,13,51,21.750228728824222,3.013036994433048
Florida State University,33009,29286,Florida,Midsize City,NA,100.0,100.0,100.0,285,149,576,139,69,287,424,218,863,412.21991694691513,11.300201456074062
Fontbonne University,892,765,Missouri,Suburb,NA,85.13,53.43,99.12,1,1,3,1,0,2,2,1,5,1.2929453555571109,0.6083710611965002
Fordham University,9595,9132,New York,Large City,NA,100.0,100.0,100.0,27,15,52,12,6,24,39,21,76,11.964428434984205,27.158909583910944
Fort Hays State University,12499,5889,Kansas,Town,NA,100.0,99.97,100.0,11,6,22,5,2,10,16,8,32,6.939075498892173,9.411588000554055
Fort Lewis College,3303,2921,Colorado,Town,public,99.97,96.85,100.0,6,2,14,3,1,6,9,3,20,2.0971436313132856,6.060989432031078
Fort Valley State University,2345,2115,Georgia,Town,NA,99.96,90.9,100.0,5,2,15,2,1,8,7,3,23,6.473110456356797,1.2476555913539855
Framingham State University,4128,3558,Massachusetts,Small City,public,100.0,99.99,100.0,12,7,21,5,3,10,17,10,31,16.883094029196876,0.22054569868017346
Francis Marion University,3462,3006,South CaroliNA,Suburb,public,100.0,100.0,100.0,34,17,68,18,9,37,52,26,105,51.72116286966905,0.5961135304351708
Franciscan University of Steubenville,2201,2011,Ohio,Small City,NA,99.98,98.64,100.0,6,3,12,3,1,6,9,4,18,0.900413332698732,7.832878984009434
Franklin and Marshall College,2281,2263,Pennsylvania,Small City,NA,99.97,98.76,100.0,5,3,11,3,1,5,8,4,16,1.3182556825892677,6.7020400356038445
Franklin College,1017,962,IndiaNA,Suburb,private,95.16,81.77,99.67,2,1,4,1,1,2,3,2,6,2.70559942740849,0.3176531826222395
Franklin Pierce University,1712,1563,New Hampshire,Rural,NA,99.01,91.22,99.98,3,2,6,1,1,3,4,3,9,0.2805039594669524,4.323187089766546
Welch College,344,222,Tennessee,Rural,private,70.45,40.55,94.17,1,0,2,0,0,1,1,0,3,0.5216973779031379,0.6935558731444488
Freed - Hardeman University,1469,1261,Tennessee,Town,NA,99.88,94.29,100.0,5,2,10,2,1,5,7,3,15,3.0066243621259785,3.704026940662773
Fresno Pacific University,2803,2342,California,Large City,private,100.0,100.0,100.0,14,7,28,6,3,13,20,10,41,20.08238329194524,0.34198355147457027
Friends University,1149,906,Kansas,Large City,NA,92.91,70.61,99.66,2,1,4,1,0,2,3,1,6,0.6373994966285954,1.995183798983684
Frostburg State University,4726,3849,Maryland,Suburb,public,100.0,99.92,100.0,9,5,16,4,2,8,13,7,24,12.153548251288264,0.8916911450017488
Full Sail University,16908,16908,Florida,Suburb,NA,100.0,100.0,100.0,82,41,172,38,18,82,120,59,254,57.029698606867015,62.89851558781119
Furman University,2732,2658,South CaroliNA,Suburb,NA,100.0,100.0,100.0,15,7,30,7,3,15,22,10,45,11.946464249787688,9.703514110038428
Gallaudet University,1125,1074,District of Columbia,Large City,NA,99.71,94.09,100.0,4,2,8,2,1,4,6,3,12,0.07157779120775715,5.729039379054914
Gannon University,3074,2530,Pennsylvania,Small City,private,99.92,98.08,100.0,5,3,9,2,1,4,7,4,13,4.6376938535047865,2.4512206770763005
Gardner - Webb University,2218,1781,North CaroliNA,Town,NA,99.97,98.04,100.0,6,3,12,3,1,6,9,4,18,2.0291491611430317,6.150800160764006
Geneva College,1412,1247,Pennsylvania,Suburb,NA,97.59,86.93,99.93,3,1,5,1,1,2,4,2,7,2.04257199170425,1.6758942609195269
George Fox University,2700,2494,Oregon,Town,private,99.94,98.65,100.0,5,3,9,2,1,5,7,4,14,2.318833527536452,5.044464223897243
George Mason University,25006,20221,Virginia,Suburb,NA,100.0,100.0,100.0,83,38,156,43,18,83,126,56,239,103.50704183057881,22.464140747772745
George Washington University,11996,10893,District of Columbia,Large City,NA,100.0,100.0,100.0,37,19,74,17,9,35,54,28,109,0.40858989147761365,53.57319438765981
Georgetown College,1059,976,Kentucky,Town,private,94.64,72.11,99.91,2,1,5,1,0,2,3,1,7,2.356810673034429,0.5644345700149876
Georgetown University,7465,6987,District of Columbia,Large City,private,100.0,100.0,100.0,24,12,48,11,5,23,35,17,71,0.33104728433587677,34.04604097550941
Georgia College & State University,5987,5442,Georgia,Town,NA,100.0,99.28,100.0,12,4,37,6,1,19,18,5,56,17.880395765662715,0.05113585650744534
Georgia Gwinnett College,12290,8289,Georgia,Suburb,public,100.0,100.0,100.0,26,8,77,12,3,39,38,11,116,36.410497807472254,0.9115050569080041
Georgia Institute of Technology - Main Campus,15576,13974,Georgia,Large City,NA,100.0,100.0,100.0,46,18,116,21,8,57,67,26,173,32.28171921389407,34.539849673669806
Georgia Southern University,17763,15755,Georgia,Town,NA,100.0,100.0,100.0,39,12,114,18,5,57,57,17,171,51.144159489124334,5.398012214660111
Georgia Southwestern State University,2604,1779,Georgia,Town,public,99.96,89.47,100.0,5,2,16,2,1,8,7,3,24,7.655755521232345,0.2888160918806296
Georgia State University,25771,19882,Georgia,Large City,NA,100.0,100.0,100.0,55,16,162,25,6,81,80,22,243,74.39286563788036,4.8725898902327005
Georgian Court University,1612,1343,New Jersey,Small City,private,100.0,99.65,100.0,7,4,14,3,2,7,10,6,21,9.893426207955898,0.46157076102606615
Gettysburg College,2411,2404,Pennsylvania,Small City,NA,99.96,98.56,100.0,5,3,10,2,1,5,7,4,15,1.3741315121495665,6.395511381602144
Glenville State College,1655,1037,West Virginia,Town,NA,66.42,39.65,87.14,1,0,1,0,0,1,1,0,2,0.33206752086128816,0.7569298055465473
Goddard College,189,173,Vermont,Rural,NA,48.78,28.91,72.51,0,0,1,0,0,0,0,0,1,0.0,0.6674385342446095
Gonzaga University,5194,5106,Washington,Midsize City,private,100.0,100.0,100.0,14,8,32,7,4,19,21,12,51,9.00984240299634,12.761675164073555
Gordon College,1593,1528,Massachusetts,Suburb,NA,99.52,93.93,100.0,4,2,7,2,1,3,6,3,10,2.188076230712858,3.1339486299385384
Goshen College,888,816,IndiaNA,Small City,private,92.88,75.85,99.43,2,1,3,1,0,2,3,1,5,1.4986618392833495,1.1373340806615766
Goucher College,1534,1447,Maryland,Small City,NA,99.74,95.52,100.0,4,2,8,2,1,4,6,3,12,0.786682092122906,5.157007559646694
Grace Bible College,873,822,Michigan,Small City,NA,95.32,76.62,99.89,2,1,5,1,0,2,3,1,7,2.3076661582594076,0.7468011560628942
Grace College and Theological SemiNAry,1761,1439,IndiaNA,Town,private,99.42,93.92,100.0,4,2,7,2,1,3,6,3,10,2.68843917734036,2.451339668203018
Graceland University - Lamoni,1405,1061,Iowa,Rural,private,100.0,99.45,100.0,8,4,16,3,2,7,11,6,23,1.0760930279299723,9.948436645284424
Grambling State University,4075,3734,LouisiaNA,Town,NA,100.0,100.0,100.0,22,10,50,10,4,22,32,14,72,15.883677516482312,16.092092486317895
Grand Canyon University,49564,15998,ArizoNA,Large City,NA,100.0,100.0,100.0,231,114,489,101,48,222,332,162,711,106.57037075558206,225.550408997403
Grand Valley State University,21935,19373,Michigan,Suburb,NA,100.0,100.0,100.0,48,23,105,23,10,54,71,33,159,68.73431250041783,2.2625460446829204
Grand View University,1787,1574,Iowa,Midsize City,NA,99.96,94.41,100.0,5,2,14,2,1,6,7,3,20,4.346220173917166,3.3653155511693034
Granite State College,1758,807,New Hampshire,Town,NA,75.8,0.0,96.23,1,0,2,0,0,1,1,0,3,1.4181033506384815,0.00019251092922053205
Grantham University,7817,3296,Kansas,Suburb,NA,100.0,100.0,100.0,34,16,76,15,7,35,49,23,111,0.14747396584955266,49.068698990973076
Greensboro College,944,772,North CaroliNA,Large City,NA,97.12,82.23,99.94,2,1,5,1,1,2,3,2,7,0.701003217813807,2.831713523099844
Greenville University,988,887,Illinois,Town,NA,89.33,67.15,99.2,2,1,3,1,0,2,3,1,5,0.9725427813906969,1.2594028162422548
Grinnell College,1717,1662,Iowa,Town,private,99.84,95.39,100.0,4,2,10,2,1,5,6,3,15,0.8638635696437834,5.545405102253518
Grove City College,2376,2315,Pennsylvania,Town,NA,99.89,97.17,100.0,5,2,9,2,1,4,7,3,13,2.1150036226157485,4.679214491834662
Guilford College,1669,1429,North CaroliNA,Large City,NA,99.29,90.93,100.0,3,2,7,2,1,3,5,3,10,1.087763613849011,3.8392063060834043
Gustavus Adolphus College,2184,2150,Minnesota,Town,private,91.7,68.35,99.74,2,1,4,1,0,2,3,1,6,0.9827928238496336,1.4984858209374663
Gwynedd Mercy University,2081,1934,Pennsylvania,Suburb,private,99.64,95.51,100.0,4,2,7,2,1,4,6,3,11,3.5367330636500136,2.0738307640153937
Hamilton College,1894,1886,New York,Suburb,private,99.94,98.21,100.0,5,3,10,2,1,5,7,4,15,1.7374279271783766,5.693052970448767
Hamline University,2166,2082,Minnesota,Large City,NA,92.53,72.04,99.59,2,1,4,1,0,2,3,1,6,0.9355274973295019,1.6511463639097665
Hampden - Sydney College,1044,1039,Virginia,Rural,NA,99.39,88.99,100.0,3,2,7,2,1,3,5,3,10,3.7448886601310547,1.3302025499655168
Hampshire College,1264,1268,Massachusetts,Suburb,private,99.36,92.57,100.0,3,2,7,2,1,3,5,3,10,0.9578154706427879,4.082778868626782
Hampton University,3796,3651,Virginia,Midsize City,NA,100.0,99.98,100.0,12,6,24,6,3,12,18,9,36,4.93716036539017,12.64118296405172
Hannibal - LaGrange University,913,706,Missouri,Town,NA,86.76,58.07,99.17,1,1,3,1,0,2,2,1,5,1.0350486246628545,0.9823914683896796
Hanover College,1096,1081,IndiaNA,Town,NA,96.62,83.17,99.89,2,1,5,1,1,2,3,2,7,1.9019277158844035,1.4771691497624855
Hardin - Simmons University,1741,1585,Texas,Midsize City,NA,100.0,100.0,100.0,21,9,48,8,3,18,29,12,66,27.838878374725628,0.3793093826657869
Harding University,4187,3945,Arkansas,Town,NA,100.0,100.0,100.0,17,8,39,7,3,17,24,11,56,1.9417604156666666,22.46955800143231
Harris - Stowe State University,1441,1163,Missouri,Large City,NA,91.7,62.15,99.81,2,1,4,1,0,2,3,1,6,2.2068344422159525,0.27962825453672635
Harrisburg University of Science and Technology,509,463,Pennsylvania,Small City,NA,67.69,46.64,88.79,1,0,1,0,0,1,1,0,2,0.9271248756671774,0.20141184680015045
Hartwick College,1198,1180,New York,Town,private,97.08,87.56,99.8,2,1,4,1,1,2,3,2,6,2.667155246069816,0.861355088760512
Harvard University,9964,7147,Massachusetts,Midsize City,NA,100.0,100.0,100.0,35,18,72,16,8,34,51,26,106,6.321582106242401,43.95617700420258
Harvey Mudd College,867,844,California,Suburb,NA,99.08,90.63,99.99,3,2,7,1,1,3,4,3,10,2.6796034578388475,1.9950093257715118
Hastings College,1156,1073,Nebraska,Town,NA,63.26,36.31,90.5,1,0,2,0,0,1,1,0,3,0.13297483756993847,0.8646406580969532
Haverford College,1293,1294,Pennsylvania,Suburb,private,99.27,92.63,99.99,3,2,7,2,1,3,5,3,10,0.3642276297263911,4.541308150015983
Hawaii Pacific University,3565,2411,Hawaii,Large City,NA,99.98,98.65,100.0,6,3,13,3,1,6,9,4,19,0.004121694469001517,8.697023145808554
Heidelberg University,1049,1031,Ohio,Town,NA,96.93,82.98,99.91,2,1,5,1,1,2,3,2,7,1.9201021977809325,1.552851407754155
Henderson State University,2838,2565,Arkansas,Town,public,99.99,98.15,100.0,7,3,16,3,1,7,10,4,23,4.37296548239505,5.19984049264847
Hendrix College,1240,1228,Arkansas,Small City,NA,99.89,94.68,100.0,5,2,11,2,1,5,7,3,16,1.0625398424867094,5.704530938495815
Heritage University,812,734,Washington,Rural,private,94.94,85.59,99.3,2,1,3,1,1,2,3,2,5,2.9776117343235766,0.0
Herzing University - Atlanta,593,365,Georgia,Large City,NA,83.1,38.6,99.62,1,0,4,1,0,2,2,0,6,1.7754646163827847,0.0
High Point University,4467,4418,North CaroliNA,Midsize City,NA,100.0,99.93,100.0,10,5,19,5,2,9,15,7,28,1.4208072882126588,12.775750014910058
Hilbert College,744,680,New York,Suburb,private,88.41,72.85,97.45,1,1,2,1,0,1,2,1,3,2.091886467505738,0.06040234554791521
Hiram College,1209,853,Ohio,Town,NA,96.93,83.68,99.89,2,1,5,1,1,2,3,2,7,2.4112367428893315,1.0636058542761055
Hobart and William Smith Colleges,2239,2220,New York,Town,private,99.92,98.18,100.0,5,3,9,2,1,4,7,4,13,2.7136416120143876,4.391283575579096
Hodges University,1076,573,Florida,Suburb,NA,100.0,99.93,100.0,9,5,19,5,2,9,14,7,28,13.678961121694833,0.28116638253827597
Hofstra University,6863,6494,New York,Suburb,NA,100.0,100.0,100.0,17,9,31,8,4,15,25,13,46,10.764499114039943,13.535941648639572
Hollins University,647,632,Virginia,Suburb,NA,97.23,79.28,99.96,2,1,5,1,0,3,3,1,8,1.6754831452760257,1.8950465815974162
Holy Cross College,555,526,IndiaNA,Suburb,NA,82.96,61.35,96.92,1,1,2,1,0,1,2,1,3,0.8608725450845195,0.9041532461234474
Holy Family University,2095,1630,Pennsylvania,Large City,private,99.67,95.73,100.0,4,2,8,2,1,4,6,3,12,3.5077604112854144,2.190972576954993
Holy Names University,591,543,California,Large City,private,98.07,86.76,99.97,3,1,5,1,1,3,4,2,8,3.799765559066562,0.1335347271978034
Hood College,1132,1048,Maryland,Small City,NA,97.31,85.16,99.92,2,1,5,1,1,2,3,2,7,2.25515533075233,1.3547738774310707
Hope College,3150,3019,Michigan,Small City,private,100.0,99.18,100.0,7,3,15,3,1,7,10,4,22,6.99521562340085,2.9702030872062863
Hope InterNAtioNAl University,866,579,California,Suburb,NA,99.67,94.7,100.0,4,2,8,2,1,4,6,3,12,5.205459176293498,0.49909223102113454
Houghton College,1036,971,New York,Rural,private,96.37,84.18,99.8,2,1,4,1,1,2,3,2,6,1.766481905893734,1.5404735664105074
Houston Baptist University,2320,2098,Texas,Large City,NA,100.0,100.0,100.0,28,12,66,10,4,24,38,16,90,38.00948309496053,0.3389514845250043
Howard Payne University,980,860,Texas,Town,private,100.0,99.89,100.0,12,5,27,4,2,10,16,7,37,15.819072796266193,0.19450313319370455
Howard University,6354,6090,District of Columbia,Large City,NA,100.0,100.0,100.0,22,11,47,10,5,22,32,16,69,0.20578614972230178,32.48235236135459
Humboldt State University,7860,7270,California,Town,NA,100.0,100.0,100.0,37,19,75,17,8,36,54,27,111,51.219961177706494,2.6805436341359963
Humphreys University - Stockton and Modesto Campuses,324,208,California,Large City,NA,90.75,70.79,99.22,2,1,3,1,0,2,3,1,5,2.372107979070455,0.0
Huntingdon College,1101,878,Alabama,Midsize City,private,99.92,96.38,100.0,5,2,10,2,1,5,7,3,15,4.370302389546328,2.697588881718281
Huntington University,1075,859,IndiaNA,Town,NA,95.74,82.09,99.78,2,1,4,1,1,2,3,2,6,2.0020291746151617,1.1479976006312256
Huston - Tillotson University,1052,1003,Texas,Large City,NA,100.0,99.93,100.0,13,5,30,5,2,11,18,7,41,17.147135230809262,0.1655258324149687
Idaho State University,10565,6279,Idaho,Small City,public,100.0,100.0,100.0,26,9,73,15,4,45,41,13,118,36.518189217781206,3.974224170701996
Illinois College,956,950,Illinois,Town,NA,85.49,62.54,98.38,1,1,3,1,0,1,2,1,4,1.284697641869324,0.6419434945597317
Illinois Institute of Technology,2895,2631,Illinois,Large City,NA,99.87,96.64,100.0,5,2,10,2,1,4,7,3,14,3.3176257784537486,3.3297859402870937
Illinois State University,18336,17165,Illinois,Suburb,NA,100.0,100.0,100.0,20,11,40,9,5,18,29,16,58,28.43746465134185,0.7744660753944534
Illinois Wesleyan University,1650,1646,Illinois,Small City,NA,93.88,77.0,99.7,2,1,4,1,0,2,3,1,6,2.2525345710920015,0.5370831951214535
Immaculata University,1481,885,Pennsylvania,Suburb,NA,98.8,91.23,99.98,3,2,6,1,1,3,4,3,9,2.0736141192377495,2.341248218252177
IndiaNA State University,11578,9369,IndiaNA,Small City,public,100.0,100.0,100.0,22,13,40,10,6,19,32,19,59,29.04372324030995,3.067998370718663
IndiaNA University - Bloomington,33427,32212,IndiaNA,Small City,public,100.0,100.0,100.0,68,38,128,31,17,61,99,55,189,65.77523851114212,33.20173488102799
IndiaNA University - East,3292,1887,IndiaNA,Rural,public,99.99,99.45,100.0,6,4,11,3,2,6,9,6,17,7.916595364763953,1.2359824621993156
IndiaNA University - Kokomo,2877,2215,IndiaNA,Small City,NA,99.97,99.1,100.0,6,3,10,3,1,5,9,4,15,8.182579240819967,0.018193041264707194
IndiaNA University - Northwest,3700,2608,IndiaNA,Small City,NA,100.0,99.77,100.0,7,4,13,3,2,6,10,6,19,10.536393541831794,0.02509787822943734
IndiaNA University of Pennsylvania - Main Campus,10255,9526,Pennsylvania,Town,NA,100.0,100.0,100.0,16,9,31,7,4,15,23,13,46,19.382704431916927,3.8579055355697327
IndiaNA University - Purdue University - Fort Wayne,9952,5913,IndiaNA,Large City,public,100.0,100.0,100.0,19,11,35,9,5,17,28,16,52,27.587962026196927,0.9275639533287177
IndiaNA University - Purdue University - IndiaNApolis,21615,17521,IndiaNA,Large City,NA,100.0,100.0,100.0,43,24,78,20,11,38,63,35,116,59.61184869500545,2.876074942568149
IndiaNA University - South Bend,4877,3767,IndiaNA,Midsize City,NA,100.0,99.97,100.0,9,5,17,4,3,8,13,8,25,13.665279137587488,0.26686764869553053
IndiaNA University - Southeast,4824,3218,IndiaNA,Suburb,NA,100.0,99.94,100.0,9,5,18,4,2,9,13,7,27,10.665095417342767,2.879348266750487
IndiaNA Wesleyan University,2803,2634,IndiaNA,Town,private,99.96,98.54,100.0,5,3,10,2,1,5,7,4,15,4.659007893497283,3.144745518202146
Institute of American Indian and Alaska Native Culture and Arts Development,612,264,New Mexico,Rural,NA,94.08,66.5,99.98,2,1,5,1,0,3,3,1,8,1.3431788236870061,1.4758209066688994
IoNA College,3177,2949,New York,Suburb,private,100.0,99.72,100.0,7,4,12,3,2,6,10,6,18,6.92646852574122,3.1242375005599348
Iowa State University,30573,28743,Iowa,Small City,public,100.0,100.0,100.0,55,21,143,25,9,72,80,30,215,61.44491189480142,18.65255773324703
Iowa Wesleyan University,625,550,Iowa,Town,private,82.85,51.65,98.74,1,1,3,1,0,1,2,1,4,0.6127751964601231,1.1457858597572415
Ithaca College,6062,5936,New York,Suburb,NA,100.0,100.0,100.0,14,8,27,7,4,13,21,12,40,7.382615991572333,13.620298734131834
Jackson State University,6498,5935,Mississippi,Midsize City,NA,100.0,100.0,100.0,50,25,98,24,11,47,74,36,145,62.395918079512086,11.000945609076698
Jacksonville State University,7492,5523,Alabama,Small City,NA,100.0,100.0,100.0,25,11,53,12,5,26,37,16,79,30.555827145890934,6.03457312726219
Jacksonville University,2878,2180,Florida,Large City,NA,100.0,100.0,100.0,20,10,41,10,5,20,30,15,61,25.915166144982052,3.7584433436689424
James Madison University,19972,18905,Virginia,Small City,NA,100.0,100.0,100.0,64,30,120,33,14,64,97,44,184,73.75277218171145,23.422401226252454
University of Jamestown,916,871,North Dakota,Town,NA,99.4,84.76,100.0,3,1,9,2,1,6,5,2,15,3.250785353315595,1.8389932333335093
Jarvis Christian College,908,835,Texas,Rural,NA,100.0,99.75,100.0,10,4,24,4,2,9,14,6,33,13.751330018433311,0.3579252910922635
John Brown University,1972,1489,Arkansas,Town,NA,99.99,98.43,100.0,7,3,16,3,1,7,10,4,23,1.1497499803122517,8.495372483927987
John Carroll University,3079,2987,Ohio,Suburb,private,99.96,98.49,100.0,5,3,10,2,1,5,7,4,15,4.792069918700524,3.002488224302998
Johns Hopkins University,6106,5668,Maryland,Large City,NA,100.0,100.0,100.0,19,10,38,9,4,18,28,14,56,1.9901676786688252,25.41042767819553
Johnson & Wales University - Providence,7717,7267,Rhode Island,Midsize City,private,100.0,100.0,100.0,18,10,33,8,4,16,26,14,49,0.7116781835151854,24.927429662236396
Johnson C Smith University,1395,1329,North CaroliNA,Large City,NA,99.86,95.96,100.0,4,2,9,2,1,5,6,3,14,0.7547199394853632,5.817539557966603
Johnson State College,1377,882,Vermont,Rural,NA,71.08,47.89,90.69,1,0,2,0,0,1,1,0,3,0.005994392037453118,1.231270355294111
Judson College,313,230,Alabama,Rural,NA,83.79,56.82,97.99,1,1,3,1,0,1,2,1,4,1.2805037843629217,0.5328291685931275
Judson University,1078,761,Illinois,Midsize City,private,85.89,64.16,98.25,1,1,3,1,0,1,2,1,4,1.3552854243896164,0.6001339878850303
Juniata College,1487,1400,Pennsylvania,Town,NA,98.52,89.7,99.97,3,2,6,1,1,3,4,3,9,1.9142645312324533,2.2876606312521206
Kalamazoo College,1434,1427,Michigan,Small City,NA,99.19,90.03,100.0,3,2,7,2,1,3,5,3,10,3.2563368833475566,1.549252678152444
Kansas State University,18484,16770,Kansas,Small City,NA,100.0,100.0,100.0,17,9,34,7,4,15,24,13,49,10.908110406708499,13.903420349161749
Kansas Wesleyan University,693,631,Kansas,Town,NA,97.86,81.33,99.99,3,1,6,1,0,2,4,1,8,0.27864071432151055,3.539412495939656
Kaplan University - Davenport Campus,25486,3127,Iowa,Midsize City,NA,100.0,100.0,100.0,100,47,219,45,20,103,145,67,322,2.2209364437554706,142.00937982127982
Kean University,11985,9516,New Jersey,Suburb,NA,100.0,100.0,100.0,55,31,110,25,13,53,80,44,163,79.43677171151218,1.378823735127277
Keene State College,3778,3624,New Hampshire,Town,NA,99.82,93.92,100.0,4,2,8,2,1,4,6,3,12,1.4082611064466586,4.908809792114689
Kent State University at Kent,23179,19108,Ohio,Suburb,public,100.0,100.0,100.0,38,21,72,18,9,35,56,30,107,46.8144770925468,9.160492484748747
Kentucky Christian University,589,439,Kentucky,Town,NA,84.76,59.01,98.44,1,1,3,1,0,1,2,1,4,0.7899924043690824,1.0862196270148152
Kentucky State University,1762,1122,Kentucky,Town,public,99.3,90.86,100.0,3,2,7,2,1,4,5,3,11,1.6089511968983643,3.3478097109499587
Kentucky Wesleyan College,716,673,Kentucky,Small City,private,89.25,64.0,99.41,2,1,3,1,0,2,3,1,5,1.282421003092477,0.9423720163625702
Kenyon College,1678,1661,Ohio,Town,NA,99.76,95.42,100.0,4,2,8,2,1,4,6,3,12,0.5893614541300791,5.411200754670322
Kettering University,1891,1807,Michigan,Small City,NA,99.85,95.56,100.0,4,2,10,2,1,5,6,3,15,4.165616436459727,2.33476134782686
Keuka College,1645,1312,New York,Town,private,99.07,93.97,99.97,3,2,5,1,1,3,4,3,8,4.372623796661299,0.29684198705114134
Keystone College,1454,1065,Pennsylvania,Suburb,private,96.82,85.3,99.87,2,1,4,1,1,2,3,2,6,2.5019954792000387,0.9399694078484968
King University,1798,1608,Tennessee,Small City,NA,99.96,95.9,100.0,5,2,12,2,1,6,7,3,18,3.6656105236878367,4.027240668307503
King's College,2198,2025,Pennsylvania,Small City,NA,99.88,97.51,100.0,5,3,9,2,1,4,7,4,13,2.951071590851328,3.7249166011915587
Knox College,1354,1334,Illinois,Town,private,95.67,78.68,99.89,2,1,5,1,0,2,3,1,7,1.1780316593942153,1.9542327872875767
Kutztown University of Pennsylvania,7489,7053,Pennsylvania,Town,NA,100.0,100.0,100.0,13,8,26,6,3,12,19,11,38,13.399851718627172,6.188210549565317
Kuyper College,182,146,Michigan,Suburb,NA,43.93,23.6,72.92,0,0,1,0,0,0,0,0,1,0.5252156263463801,0.05242658241657821
La Roche College,1379,1163,Pennsylvania,Suburb,NA,94.77,80.67,99.67,2,1,4,1,1,2,3,2,6,2.5144123302134385,0.4339655989328726
La Salle University,3822,3322,Pennsylvania,Large City,NA,100.0,99.91,100.0,9,5,17,4,2,8,13,7,25,4.790835016003383,7.920773751166388
La Sierra University,2027,1830,California,Large City,private,100.0,99.94,100.0,10,5,20,5,2,10,15,7,30,13.87390314919294,0.5018627836805741
Lafayette College,2590,2551,Pennsylvania,Suburb,NA,100.0,99.68,100.0,7,4,14,3,2,7,10,6,21,1.1133776408681728,9.472776485930638
LaGrange College,940,888,Georgia,Town,NA,97.69,73.91,100.0,3,1,7,1,0,3,4,1,10,2.4072066636960523,1.3472877210931098
Lake Erie College,959,724,Ohio,Suburb,private,94.71,77.68,99.74,2,1,4,1,0,2,3,1,6,1.5552593928432643,1.3756467403532837
Lake Forest College,1505,1487,Illinois,Suburb,NA,98.11,87.04,99.97,3,1,6,1,1,3,4,2,9,1.3003838157627223,2.6584433555048204
Lake Superior State University,1962,1706,Michigan,Town,public,99.86,95.34,100.0,4,2,10,2,1,5,6,3,15,5.954632163702084,0.5853125539784853
Lakeland University,1997,779,Wisconsin,Rural,private,86.34,64.09,98.47,1,1,3,1,0,1,2,1,4,0.8327610305131189,1.1533574593818152
Lamar University,9270,5967,Texas,Midsize City,NA,100.0,100.0,100.0,112,48,263,41,17,98,153,65,361,152.55907080352358,1.0390564430144937
Lander University,2785,2600,South CaroliNA,Town,NA,100.0,100.0,100.0,28,14,55,14,7,29,42,21,84,41.13331612279839,0.8946669305724104
Lane College,1416,1370,Tennessee,Small City,NA,99.3,86.32,100.0,3,1,8,2,1,4,5,2,12,3.2125575376140594,1.7330669111315946
Langston University,2028,1822,Oklahoma,Rural,NA,99.99,98.39,100.0,7,3,15,3,1,7,10,4,22,3.237707166389572,6.222599408564237
Lasell College,1733,1669,Massachusetts,Small City,NA,99.59,95.18,100.0,4,2,7,2,1,3,6,3,10,4.3974372496622225,1.0937344317941244
Lawrence Technological University,2191,1672,Michigan,Small City,NA,99.93,96.8,100.0,5,2,11,2,1,5,7,3,16,6.620999489629054,0.6751807388608728
Lawrence University,1471,1434,Wisconsin,Small City,private,93.82,76.6,99.64,2,1,4,1,0,2,3,1,6,0.23778778366738784,2.537957777173377
Le Moyne College,2793,2410,New York,Suburb,NA,99.98,99.37,100.0,6,4,10,3,2,5,9,6,15,7.333224227756225,1.1397278608629537
Le Moyne - Owen College,867,770,Tennessee,Large City,private,95.59,69.75,99.96,2,1,5,1,0,2,3,1,7,2.7080212576682614,0.4074589177545799
Lebanon Valley College,1756,1624,Pennsylvania,Suburb,private,99.14,92.77,99.99,3,2,6,1,1,3,4,3,9,2.667553492712035,2.0841932874157005
Lee University,4856,3854,Tennessee,Small City,NA,100.0,99.98,100.0,14,6,32,6,3,15,20,9,47,7.811731790181195,12.154660300171619
Lees - McRae College,920,891,North CaroliNA,Rural,NA,98.0,84.61,99.98,3,1,6,1,1,3,4,2,9,0.6660873487272956,3.228224657338295
Lehigh University,5065,5013,Pennsylvania,Small City,NA,100.0,100.0,100.0,14,8,27,6,3,13,20,11,40,2.4523280751464402,17.665339227233673
Lenoir - Rhyne University,1698,1441,North CaroliNA,Small City,private,98.89,88.37,99.99,3,1,6,1,1,3,4,2,9,1.7256496836987396,2.7572330558717044
Lesley University,2097,1645,Massachusetts,Midsize City,private,99.9,97.51,100.0,5,3,9,2,1,4,7,4,13,3.8780884166914658,3.019648245351126
LeTourneau University,2606,1301,Texas,Small City,NA,100.0,100.0,100.0,25,11,58,9,4,22,34,15,80,31.25149450399453,3.066763072963421
Lewis & Clark College,2113,2067,Oregon,Large City,NA,99.99,99.22,100.0,7,3,14,3,1,7,10,4,21,0.46051945295440677,9.07391056607774
Lewis - Clark State College,3746,2215,Idaho,Small City,NA,100.0,99.29,100.0,9,3,24,5,2,15,14,5,39,11.410317545735948,2.490401737815668
Lewis University,4502,3687,Illinois,Suburb,private,99.95,98.43,100.0,5,3,11,2,1,5,7,4,16,6.60701644389938,1.0773636689399022
Liberty University,45756,26892,Virginia,Small City,NA,100.0,100.0,100.0,162,77,331,77,35,164,239,112,495,65.21253520923867,174.1038557645158
Life University,760,624,Georgia,Small City,NA,94.15,66.89,99.95,2,1,5,1,0,3,3,1,8,1.380251582044627,1.4498290294506984
Limestone College,2599,1943,South CaroliNA,Town,private,100.0,100.0,100.0,20,10,41,11,5,22,31,15,63,27.453443334806217,3.492790796759314
Lincoln Memorial University,1923,1355,Tennessee,Town,NA,99.93,94.27,100.0,5,2,12,2,1,6,7,3,18,4.818836306421089,2.371932067112895
Lincoln University California,107,72,California,Large City,private,54.45,33.4,79.88,1,0,1,0,0,1,1,0,2,0.7833813387670947,0.0
Lincoln University Missouri,2513,1804,Missouri,Small City,NA,99.76,91.93,100.0,4,2,10,2,1,5,6,3,15,3.0964916212739912,2.924358948090641
Lincoln University of Pennsylvania,2002,1826,Pennsylvania,Suburb,NA,99.86,97.25,100.0,4,2,9,2,1,4,6,3,13,1.5665927028572617,4.971198149106271
Lindenwood University,6931,6215,Missouri,Small City,private,100.0,99.93,100.0,12,5,29,5,2,14,17,7,43,8.469051706480514,8.800688891813964
Lindsey Wilson College,2071,1919,Kentucky,Town,NA,99.69,91.73,100.0,4,2,9,2,1,5,6,3,14,4.816320358636839,0.9504863597800985
Linfield College - McMinnville Campus,1536,1505,Oregon,Town,NA,98.56,91.17,99.99,3,2,6,1,1,3,4,3,9,1.2620004239615956,2.9684521595765063
Lipscomb University,2994,2723,Tennessee,Large City,NA,100.0,99.22,100.0,8,3,19,4,1,9,12,4,28,6.761472595191983,5.057575999517503
Livingstone College,1153,1140,North CaroliNA,Suburb,private,98.03,85.87,99.97,3,1,5,1,1,3,4,2,8,0.9400426292522317,2.9690523511625635
Lock Haven University,3471,3176,Pennsylvania,Town,public,99.97,98.88,100.0,6,3,11,3,1,5,9,4,16,6.5643752357506395,1.5134901035785273
LIU Brooklyn,3947,3396,New York,Large City,NA,100.0,99.95,100.0,9,5,16,4,2,8,13,7,24,9.201395059153711,3.9609196172504624
LIU Post,6317,2845,New York,Suburb,private,100.0,100.0,100.0,14,8,24,6,4,11,20,12,35,16.41549797417697,3.476985792553998
Longwood University,4469,3959,Virginia,Town,NA,100.0,100.0,100.0,15,7,28,8,3,15,23,10,43,22.716189979055834,0.5027524415694096
Loras College,1395,1335,Iowa,Small City,NA,94.23,71.25,99.9,2,1,5,1,0,2,3,1,7,1.404899230908575,1.4442263487312044
LouisiaNA College,985,866,LouisiaNA,Suburb,NA,99.95,96.58,100.0,5,2,12,2,1,5,7,3,17,6.562203402399082,0.9417376598849392
LouisiaNA State University - Alexandria,3372,1844,LouisiaNA,Rural,public,100.0,100.0,100.0,17,8,37,8,3,18,25,11,55,23.246498327452958,1.1188071573645013
LouisiaNA State University and Agricultural & Mechanical College,25448,22060,LouisiaNA,Midsize City,NA,100.0,100.0,100.0,149,67,332,64,27,148,213,94,480,133.2742050482881,79.26105152583663
LouisiaNA State University - Shreveport,2641,1641,LouisiaNA,Midsize City,public,100.0,99.99,100.0,14,6,30,6,3,14,20,9,44,17.063158520181492,2.7811388953992653
LouisiaNA Tech University,11323,8090,LouisiaNA,Town,NA,100.0,100.0,100.0,59,27,132,26,11,61,85,38,193,72.3272048207777,13.477246641123566
Lourdes University,1046,827,Ohio,Suburb,NA,92.92,74.68,99.43,2,1,3,1,0,2,3,1,5,2.123572223611555,0.5207824441425616
Loyola Marymount University,6395,6164,California,Large City,NA,100.0,100.0,100.0,29,15,62,14,7,30,43,22,92,33.202190386063315,9.87607018403457
Loyola University Maryland,3927,3886,Maryland,Large City,private,100.0,99.98,100.0,11,6,20,5,3,10,16,9,30,1.8300709722017074,13.706942521330687
Loyola University Chicago,11426,10681,Illinois,Large City,private,100.0,100.0,100.0,18,9,37,8,4,17,26,13,54,10.5693439693718,15.5532563275546
Loyola University New Orleans,2607,2446,LouisiaNA,Large City,private,100.0,99.97,100.0,12,6,26,5,2,12,17,8,38,8.006174085715656,9.623836561527442
Lubbock Christian University,1482,1276,Texas,Large City,NA,100.0,99.99,100.0,17,7,40,6,2,15,23,9,55,22.526628636553344,0.5989201088558048
Luther College,2046,2014,Iowa,Town,NA,96.71,75.49,99.98,2,1,6,1,0,3,3,1,9,1.8263690001811475,1.5830370854251055
Lycoming College,1222,1199,Pennsylvania,Small City,private,97.44,86.56,99.92,3,1,5,1,1,2,4,2,7,1.5189947739725629,2.137417226542527
University of Lynchburg,2051,1928,Virginia,Small City,private,99.99,98.56,100.0,6,3,12,3,1,6,9,4,18,6.943538301112558,2.387096928130933
Lyndon State College,1069,871,Vermont,Town,NA,56.53,33.57,80.19,1,0,1,0,0,1,1,0,2,0.004480857835305487,0.8265679529389834
Lynn University,2205,1826,Florida,Small City,NA,100.0,99.97,100.0,11,6,21,5,2,11,16,8,32,9.391525546238244,6.1621719689612835
Lyon College,670,652,Arkansas,Town,NA,89.25,60.15,99.46,2,1,4,1,0,2,3,1,6,0.9699903084677666,1.250280273786493
Macalester College,2138,2093,Minnesota,Large City,NA,99.86,96.24,100.0,4,2,9,2,1,4,6,3,13,0.18199867108326548,6.333053291034987
MadonNA University,2455,1358,Michigan,Small City,NA,99.97,97.81,100.0,6,3,12,3,1,6,9,4,18,7.940603750824334,0.22783387879636277
Maharishi University of MaNAgement,325,261,Iowa,Town,NA,72.92,45.11,94.9,1,0,2,0,0,1,1,0,3,0.3228279083789917,0.9789965231459133
Maine Maritime Academy,1021,989,Maine,Rural,NA,74.91,46.28,93.97,1,0,2,0,0,1,1,0,3,0.6289378698539339,0.7507811494432627
Malone University,1334,1099,Ohio,Small City,NA,97.3,84.59,99.92,2,1,5,1,1,2,3,2,7,2.645110335798093,0.9595058309998851
Manchester University,1264,1244,IndiaNA,Town,NA,97.57,87.69,99.92,3,1,5,1,1,2,4,2,7,3.2604475129446917,0.4522229775186656
Manhattan College,3666,3479,New York,Large City,NA,100.0,99.95,100.0,9,5,16,4,2,8,13,7,24,7.388426787315404,5.787429317766035
Manhattanville College,1731,1633,New York,Suburb,NA,99.76,96.48,100.0,4,2,8,2,1,4,6,3,12,2.826952129004282,3.1949028016236904
Mansfield University of Pennsylvania,1827,1655,Pennsylvania,Town,NA,98.26,89.98,99.95,3,2,5,1,1,2,4,3,7,3.1600885829102228,0.8857193666287692
MaraNAtha Baptist University,933,591,Wisconsin,Town,NA,92.39,70.16,99.74,2,1,4,1,0,2,3,1,6,0.1249393439608309,2.4411681251962585
Marian University IndiaNA,2301,1961,IndiaNA,Large City,NA,99.88,97.73,100.0,5,3,8,2,1,4,7,4,12,5.831624981486164,0.8565160372659435
Marian University Wisconsin,1508,1254,Wisconsin,Small City,NA,61.7,42.14,83.75,1,0,1,0,0,1,1,0,2,0.6649997339850677,0.29419352711517344
Marietta College,1063,960,Ohio,Town,NA,94.72,78.33,99.7,2,1,4,1,0,2,3,1,6,1.61840526292863,1.3144509218223466
Marist College,5697,5085,New York,Suburb,private,100.0,100.0,100.0,14,8,26,6,3,13,20,11,39,8.646464065690383,11.67763243594965
Marquette University,8334,8026,Wisconsin,Large City,NA,100.0,99.91,100.0,9,5,18,4,2,9,13,7,27,1.4206812498771901,11.79666592319487
Mars Hill University,1265,1199,North CaroliNA,Suburb,private,98.95,88.23,99.99,3,1,7,1,1,3,4,2,10,1.1079073844758445,3.425387055689666
Marshall University,9492,7846,West Virginia,Small City,NA,100.0,99.23,100.0,7,3,13,3,1,7,10,4,20,1.5928405351442891,8.473093135913908
Martin Luther College,896,743,Minnesota,Town,private,83.28,59.64,97.56,1,1,3,1,0,1,2,1,4,0.05921747805395802,1.7217363857303623
Martin Methodist College,979,810,Tennessee,Town,NA,97.4,75.52,99.99,3,1,6,1,0,3,4,1,9,3.0409465580406585,0.599702740312146
Martin University,263,159,IndiaNA,Large City,NA,52.92,35.13,74.91,1,0,1,0,0,0,1,0,1,0.7521909613196964,0.0
Mary Baldwin University,1133,720,Virginia,Small City,private,99.51,90.79,100.0,4,2,7,2,1,3,6,3,10,3.765897853175268,1.5325651713275654
Marymount Manhattan College,2149,1915,New York,Large City,private,99.99,99.35,100.0,6,3,13,3,2,6,9,5,19,2.17904840365181,7.303673237827559
Marymount University,2306,2069,Virginia,Midsize City,NA,100.0,99.17,100.0,7,3,13,3,2,7,10,5,20,6.518102141967235,3.7754583614984623
Maryville College,1184,1158,Tennessee,Suburb,NA,99.54,89.47,100.0,4,2,9,2,1,4,6,3,13,2.931115531113682,2.439451436843089
Maryville University of Saint Louis,3184,2375,Missouri,Suburb,private,99.9,94.25,100.0,5,2,11,2,1,5,7,3,16,4.1505796019089045,2.717661266456462
Marywood University,1957,1756,Pennsylvania,Small City,NA,99.72,96.22,100.0,4,2,8,2,1,4,6,3,12,2.6882482444010343,3.178277647567428
Massachusetts College of Liberal Arts,1407,1201,Massachusetts,Town,public,99.59,95.6,100.0,4,2,7,2,1,3,6,3,10,4.699681242620613,0.7798816304483525
Massachusetts Institute of Technology,4551,4510,Massachusetts,Midsize City,private,100.0,100.0,100.0,17,9,36,8,4,16,25,13,52,2.0773953318830247,23.054930082857165
Massachusetts Maritime Academy,1687,1607,Massachusetts,Suburb,NA,99.9,97.78,100.0,5,3,9,2,1,4,7,4,13,5.368023593246914,1.5594338875195868
Mayville State University,1097,600,North Dakota,Rural,NA,99.93,92.79,100.0,5,2,12,3,1,7,8,3,19,5.9857030057272045,1.1957997478509057
McDaniel College,1588,1543,Maryland,Suburb,private,98.92,91.35,99.98,3,2,6,1,1,3,4,3,9,4.173555520315206,0.34486424364414453
McKendree University,2103,1692,Illinois,Suburb,NA,97.67,86.24,99.96,3,1,5,1,1,2,4,2,7,2.8956677007213334,0.8593418867557037
McMurry University,1106,956,Texas,Midsize City,private,100.0,99.95,100.0,13,6,31,5,2,12,18,8,43,17.853193740313174,0.22358739517082427
McNeese State University,6924,5567,LouisiaNA,Small City,NA,100.0,100.0,100.0,37,17,82,16,7,38,53,24,120,46.228506975288525,6.8400864532351635
McPherson College,723,673,Kansas,Town,private,95.65,74.14,99.93,2,1,5,1,0,2,3,1,7,0.24957132682231992,2.863888712570566
Medaille College,1526,1426,New York,Large City,NA,98.89,93.4,99.95,3,2,5,1,1,2,4,3,7,4.326137430716727,0.16848895523906365
Menlo College,746,728,California,Suburb,private,99.42,92.56,100.0,4,2,7,2,1,4,6,3,11,4.275651419065265,0.8521893580084574
Mercer University,4746,4135,Georgia,Midsize City,NA,100.0,99.71,100.0,12,4,32,5,2,16,17,6,48,11.829444686894405,5.302438903684985
Mercy College,6862,5055,New York,Suburb,private,100.0,100.0,100.0,14,9,24,7,4,12,21,13,36,18.24008783750142,2.5512229275425917
Mercyhurst University,2452,2373,Pennsylvania,Small City,NA,99.79,96.69,100.0,4,2,8,2,1,4,6,3,12,2.913821037811129,3.222022653805074
Meredith College,1682,1600,North CaroliNA,Large City,NA,95.07,75.72,99.86,2,1,4,1,0,2,3,1,6,2.0036337183490422,1.0012188261105632
Merrimack College,3535,3323,Massachusetts,Suburb,NA,100.0,99.92,100.0,9,5,17,4,2,8,13,7,25,10.604081499427489,2.3832703683138194
Colorado Mesa University,9461,7145,Colorado,Small City,public,100.0,99.63,100.0,10,4,26,4,2,12,14,6,38,7.998613859383646,6.040832134730676
Messiah College,2760,2637,Pennsylvania,Suburb,private,99.96,98.64,100.0,5,3,10,2,1,5,7,4,15,3.226311788315021,4.641070480742043
Methodist University,1938,1755,North CaroliNA,Midsize City,NA,99.91,96.79,100.0,5,2,10,2,1,5,7,3,15,1.555099092391549,5.4557867865675975
Metropolitan College of New York,777,681,New York,Large City,NA,90.06,75.28,98.04,2,1,3,1,0,1,3,1,4,2.2226293717248464,0.08267487081857296
Metropolitan State University of Denver,19668,12759,Colorado,Large City,public,100.0,99.95,100.0,14,5,40,6,2,18,20,7,58,19.020650715105603,1.4634374797108851
Metropolitan State University,7317,2878,Minnesota,Large City,NA,98.12,86.7,99.96,3,1,5,1,1,2,4,2,7,3.9751769442276226,0.0
Miami University - Oxford,17153,16619,Ohio,Town,NA,100.0,100.0,100.0,30,16,57,14,7,28,44,23,85,27.428694976339557,15.930164189724035
Michigan State University,38997,35404,Michigan,Small City,NA,100.0,100.0,100.0,89,43,195,42,19,98,131,62,293,114.01446468680513,17.346391502964735
Michigan Technological University,5886,5492,Michigan,Town,NA,100.0,99.96,100.0,11,5,24,5,2,12,16,7,36,15.021166913506471,1.3445155635390904
Mid - America Christian University,1622,1170,Oklahoma,Large City,private,99.97,96.57,100.0,6,2,13,2,1,6,8,3,19,2.660858029321037,5.303973354974261
Mid - Atlantic Christian University,192,166,North CaroliNA,Town,private,34.57,17.43,57.59,0,0,1,0,0,0,0,0,1,0.15443557480572379,0.26903372231126516
MidAmerica Nazarene University,1311,998,Kansas,Suburb,NA,94.66,72.44,99.91,2,1,5,1,0,2,3,1,7,0.4246966612686637,2.49511761768048
Middle Tennessee State University,19520,15812,Tennessee,Midsize City,public,100.0,100.0,100.0,48,19,117,21,7,54,69,26,171,63.69513117846336,4.925040014373389
Middlebury College,2547,2528,Vermont,Town,NA,99.99,99.26,100.0,7,3,14,3,1,7,10,4,21,0.0008231501801153784,9.611350106871182
Midland University,1660,1187,Nebraska,Town,NA,95.79,77.34,99.92,2,1,5,1,0,2,3,1,7,0.1813141181456771,2.9705658695635373
Midway University,1003,760,Kentucky,Rural,private,94.09,70.83,99.89,2,1,5,1,0,2,3,1,7,2.388410369209192,0.4350976720236819
Midwestern State University,5328,4199,Texas,Midsize City,public,100.0,100.0,100.0,63,27,149,23,9,55,86,36,204,86.02146174122647,0.6845041385875622
Miles College,1654,1555,Alabama,Suburb,private,99.97,97.33,100.0,5,3,12,3,1,6,8,4,18,4.624329456079863,3.373166301694395
Millersville University of Pennsylvania,6756,5671,Pennsylvania,Suburb,NA,100.0,99.98,100.0,10,6,20,5,3,9,15,9,29,13.12254204599458,1.902727493090429
Millikin University,1951,1840,Illinois,Small City,private,97.06,84.1,99.94,2,1,5,1,1,2,3,2,7,2.6588064749310183,0.8633179803839306
Mills College,764,739,California,Large City,private,99.39,92.68,100.0,3,2,7,2,1,3,5,3,10,4.444041800295575,0.6407764860913088
Millsaps College,808,797,Mississippi,Midsize City,NA,99.98,98.11,100.0,6,3,12,3,1,6,9,4,18,4.42648984261514,3.9150774837265216
Milwaukee School of Engineering,2607,2508,Wisconsin,Large City,private,93.79,76.36,99.76,2,1,4,1,0,2,3,1,6,0.9037950930069784,1.869356361082767
Minnesota State University - Mankato,12781,10832,Minnesota,Small City,NA,99.99,99.16,100.0,7,3,13,3,1,6,10,4,19,5.952171463845542,3.475892638906953
Minnesota State University - Moorhead,5126,4157,Minnesota,Suburb,NA,100.0,99.3,100.0,8,3,19,4,2,12,12,5,31,1.914517363872918,10.558716878211227
Minot State University,2959,1952,North Dakota,Town,public,100.0,99.97,100.0,14,5,41,9,3,28,23,8,69,20.127028711460284,2.792928804635291
Misericordia University,2148,1660,Pennsylvania,Suburb,private,99.74,96.35,100.0,4,2,8,2,1,4,6,3,12,3.226311788315021,2.706244482945938
Mississippi College,3246,2793,Mississippi,Suburb,private,100.0,100.0,100.0,27,13,53,13,6,26,40,19,79,30.35516709952303,9.257983742779977
Mississippi State University,18312,16803,Mississippi,Town,public,100.0,100.0,100.0,140,70,275,67,32,134,207,102,409,176.42933190582264,30.582065879346544
Mississippi University for Women,2577,2113,Mississippi,Town,NA,100.0,100.0,100.0,22,11,43,11,5,21,33,16,64,29.754219803009054,3.042363297233335
Mississippi Valley State University,1974,1667,Mississippi,Town,public,100.0,100.0,100.0,17,8,32,8,4,16,25,12,48,22.45490873803442,2.1286821811729792
Missouri Baptist University,4507,1519,Missouri,Suburb,NA,100.0,98.64,100.0,7,3,17,3,1,8,10,4,25,6.405877859326463,4.051459269905794
Missouri Southern State University,6025,4358,Missouri,Small City,NA,100.0,99.11,100.0,8,3,20,4,1,9,12,4,29,8.872339882979585,3.0880615524478894
Missouri State University - Springfield,20365,15363,Missouri,Midsize City,NA,100.0,100.0,100.0,27,10,66,12,4,30,39,14,96,32.08304566346266,6.083398406957477
Missouri Valley College,1793,1296,Missouri,Town,NA,99.48,89.33,100.0,4,2,9,2,1,4,6,3,13,2.3383790834774523,2.9082302637553212
Missouri Western State University,5290,3498,Missouri,Small City,NA,99.99,96.89,100.0,6,2,16,3,1,7,9,3,23,8.56424848634081,0.6294746386185538
Mitchell College,706,575,Connecticut,Small City,NA,78.69,58.43,94.39,1,1,2,0,0,1,1,1,3,0.15867796891028008,1.3835607214275187
Molloy College,3534,2800,New York,Suburb,private,100.0,99.81,100.0,7,4,12,3,2,6,10,6,18,10.241527497163508,0.06200615311392972
Monmouth College,1035,1016,Illinois,Town,NA,82.41,60.18,97.25,1,1,2,1,0,1,2,1,3,1.5246961024383185,0.211017224819641
Monmouth University,4708,4502,New Jersey,Suburb,NA,100.0,100.0,100.0,20,11,39,9,5,19,29,16,58,26.765989427512995,2.1895858363262546
MontaNA State University,14652,12403,MontaNA,Town,NA,100.0,99.99,100.0,45,6,383,35,3,353,80,9,736,61.646144628180565,18.4331287615251
MontaNA State University - Billings,4022,2400,MontaNA,Midsize City,public,100.0,43.14,100.0,14,0,148,12,0,140,26,0,288,25.34473238814438,1.0500921881223735
MontaNA State University - Northern,1164,855,MontaNA,Town,NA,99.95,27.44,100.0,4,0,42,4,0,39,8,0,81,7.106847084072406,0.5519643404814476
MontaNA Tech of the University of MontaNA,1657,1529,MontaNA,Town,NA,100.0,53.6,100.0,6,1,58,5,0,54,11,1,112,9.49904389451091,1.7003280624728911
Montclair State University,16852,14944,New Jersey,Suburb,NA,100.0,100.0,100.0,78,43,156,36,19,76,114,62,232,113.01654840898924,1.3392005682564716
Montreat College,757,543,North CaroliNA,Suburb,NA,89.21,63.44,99.33,2,1,3,1,0,2,3,1,5,0.729204496691374,1.4881178658183458
Moravian College,2083,1886,Pennsylvania,Small City,private,99.96,98.58,100.0,5,3,10,2,1,5,7,4,15,2.4792312523421396,5.302907377739058
Morehead State University,9660,5835,Kentucky,Town,NA,100.0,100.0,100.0,18,8,42,8,4,21,26,12,63,20.508202817421378,5.90325765535789
Morehouse College,2202,2090,Georgia,Large City,private,100.0,98.96,100.0,7,3,16,3,1,8,10,4,24,1.9790592098297146,8.373601899462894
Morgan State University,6436,5825,Maryland,Large City,public,100.0,100.0,100.0,14,8,26,7,3,13,21,11,39,12.382652158818793,8.301974031917654
Morningside College,1322,1252,Iowa,Small City,NA,95.03,67.92,99.96,2,1,5,1,0,3,3,1,8,2.3076217154498297,0.6890501995435423
Morris College,745,731,South CaroliNA,Small City,private,100.0,99.31,100.0,7,3,13,3,2,7,10,5,20,9.44785734787131,0.559761252683548
Mount Aloysius College,1689,999,Pennsylvania,Town,NA,97.52,87.16,99.92,3,1,5,1,1,2,4,2,7,3.27184024203082,0.42167112268072793
Mount Holyoke College,2213,2161,Massachusetts,Suburb,NA,99.99,99.26,100.0,6,3,13,3,2,6,9,5,19,1.9837422636423965,7.283509067319238
Mount Marty College,875,457,South Dakota,Town,private,89.31,71.6,98.21,2,1,3,1,0,1,3,1,4,1.6923470850181954,0.5391291124821788
Mount Mary University,700,624,Wisconsin,Large City,private,30.99,19.58,49.09,0,0,0,0,0,0,0,0,0,0.34408698356954637,0.026666495618777174
Mount Mercy University,1517,1083,Iowa,Midsize City,NA,99.07,79.82,100.0,3,1,9,1,0,4,4,1,13,4.262524049522613,0.40183643565816357
University of Mount Olive,3206,1472,North CaroliNA,Town,private,99.83,94.85,100.0,4,2,10,2,1,4,6,3,14,3.8206018288894272,2.5280912922490497
Mount Saint Mary College,2036,1737,New York,Suburb,private,99.78,97.34,100.0,4,3,7,2,1,3,6,4,10,4.695122960401767,1.3995653419328993
Mount Saint Mary's University,2603,2056,California,Large City,NA,100.0,99.99,100.0,13,7,26,6,3,12,19,10,38,18.508299293487994,0.35591975032403744
Mount St Mary's University,1815,1696,Maryland,Town,private,99.78,96.15,100.0,4,2,8,2,1,4,6,3,12,2.4014505970067654,3.700493576296116
Mount Vernon Nazarene University,1829,1440,Ohio,Town,NA,98.66,89.64,99.97,3,2,6,1,1,3,4,3,9,3.760687373972886,0.5443051484231346
Muhlenberg College,2369,2279,Pennsylvania,Midsize City,NA,99.99,99.54,100.0,7,4,13,3,2,6,10,6,19,0.9560975280317766,8.815145921365508
Murray State University,8559,6584,Kentucky,Town,NA,100.0,100.0,100.0,16,7,37,7,3,18,23,10,55,15.136254467711616,7.843222344895488
Muskingum University,1559,1363,Ohio,Town,NA,97.99,87.07,99.95,3,1,5,1,1,2,4,2,7,3.2718915647935742,0.6305709550945735
Naropa University,391,368,Colorado,Midsize City,NA,73.44,46.58,96.55,1,0,2,0,0,1,1,0,3,0.05598931474700575,1.2653334804142689
NatioNAl Louis University,1883,1250,Illinois,Large City,NA,94.8,80.08,99.74,2,1,4,1,0,2,3,1,6,2.953706544126907,0.0
NatioNAl University,7881,2899,California,Large City,private,100.0,100.0,100.0,42,21,88,19,9,42,61,30,130,52.208339502319184,9.077811773337668
Nazareth College,2195,2099,New York,Suburb,NA,99.86,98.02,100.0,5,3,8,2,1,4,7,4,12,5.996741206849782,0.5668206776021264
Nebraska Wesleyan University,1776,1566,Nebraska,Large City,NA,72.01,43.44,94.54,1,0,2,0,0,1,1,0,3,0.2545757267691149,1.0132444142055912
Neumann University,2085,1462,Pennsylvania,Suburb,private,99.77,96.48,100.0,4,2,8,2,1,4,6,3,12,2.86001468341973,3.2100581947294953
Nevada State College,4217,1708,Nevada,Rural,public,100.0,100.0,100.0,53,19,151,28,9,84,81,28,235,81.41833446553721,0.1458508962979956
New College of Florida,836,835,Florida,Small City,NA,99.99,99.32,100.0,7,3,13,3,2,7,10,5,20,9.024031068341964,0.6563471653596005
New England College,1841,1811,New Hampshire,Rural,NA,98.49,86.91,99.97,3,1,5,1,1,3,4,2,8,0.5216389421666132,3.6650544681738855
New Jersey City University,6508,5210,New Jersey,Large City,NA,100.0,100.0,100.0,31,17,61,14,7,30,45,24,91,44.55486579864261,0.09957907364196898
New Jersey Institute of Technology,8479,6380,New Jersey,Large City,public,100.0,100.0,100.0,39,22,78,18,9,38,57,31,116,55.66774635117246,1.5036473698860466
New Mexico Highlands University,1933,1315,New Mexico,Town,public,100.0,99.0,100.0,9,3,22,4,1,10,13,4,32,6.149001154825686,6.202729627487171
New Mexico Institute of Mining and Technology,1471,1294,New Mexico,Town,NA,99.96,92.24,100.0,5,2,14,2,1,7,7,3,21,6.021322559418176,1.694352450153841
New Mexico State University - Main Campus,11711,9703,New Mexico,Suburb,public,100.0,100.0,100.0,55,20,141,23,7,65,78,27,206,46.847830226923605,30.860388733156782
New York Institute of Technology,3663,3234,New York,Suburb,NA,100.0,99.9,100.0,8,5,14,4,2,7,12,7,21,9.430921491005034,2.2614204191720546
New York University,26418,25347,New York,Large City,NA,100.0,100.0,100.0,90,48,180,41,21,85,131,69,265,22.685346580951112,108.53767236262057
Newberry College,1177,1158,South CaroliNA,Town,private,100.0,99.97,100.0,11,5,21,6,3,11,17,8,32,15.038490290909207,1.1974779787057106
Newman University,2811,1013,Kansas,Large City,private,99.14,88.7,100.0,3,2,7,1,1,3,4,3,10,1.5959802746506877,3.134561881110234
Niagara University,2998,2827,New York,Suburb,private,99.99,99.58,100.0,6,4,11,3,2,5,9,6,16,7.798087887201945,1.4398556322997234
Nicholls State University,5684,4662,LouisiaNA,Small City,public,100.0,100.0,100.0,28,13,62,13,6,30,41,19,92,39.21595628056794,1.9069110411944936
Nichols College,1339,1232,Massachusetts,Suburb,private,99.27,93.4,99.99,3,2,6,2,1,3,5,3,9,3.5375318049073634,1.370763615562555
Norfolk State University,4684,4011,Virginia,Midsize City,NA,100.0,100.0,100.0,15,7,28,8,3,15,23,10,43,18.981805915446888,3.8004753331696155
North CaroliNA A & T State University,10339,9347,North CaroliNA,Large City,NA,100.0,99.99,100.0,14,6,29,6,3,14,20,9,43,11.988229359049532,7.732813912726376
North CaroliNA Central University,6355,5363,North CaroliNA,Large City,NA,100.0,99.65,100.0,8,4,17,4,2,8,12,6,25,7.110751031272239,4.6972070212177295
North CaroliNA State University,24149,21384,North CaroliNA,Large City,NA,100.0,100.0,100.0,29,14,62,13,6,29,42,20,91,29.30247167183385,12.20784814871337
North CaroliNA Wesleyan College,2090,1754,North CaroliNA,Small City,NA,99.87,95.47,100.0,4,2,9,2,1,4,6,3,13,1.6585037816092945,4.960540068505672
North Central College,2772,2634,Illinois,Midsize City,NA,98.97,91.47,99.99,3,2,6,1,1,3,4,3,9,3.9889940210911976,0.5841048834293785
North Central University,1081,912,Minnesota,Large City,NA,79.72,52.41,97.1,1,1,2,1,0,1,2,1,3,0.3227080914133125,1.269644231716386
North Dakota State University - Main Campus,11981,10782,North Dakota,Midsize City,NA,100.0,100.0,100.0,26,11,66,15,5,42,41,16,108,34.98893152321798,6.302676442895582
North Greenville University,2359,2080,South CaroliNA,Rural,NA,100.0,100.0,100.0,20,10,40,10,5,22,30,15,62,28.921374889682088,1.7400142858420733
North Park University,2033,1812,Illinois,Large City,NA,98.91,90.06,99.99,3,2,6,1,1,3,4,3,9,1.9858696149042296,2.520516949206726
Northcentral University,90,14,California,Large City,NA,37.59,18.14,67.82,0,0,1,0,0,0,0,0,1,0.0,0.4692462672638115
Northeastern Illinois University,7113,4164,Illinois,Large City,NA,100.0,99.78,100.0,8,4,15,3,2,7,11,6,22,11.14659516864886,0.020020291746151615
Northeastern State University,6830,4753,Oklahoma,Town,NA,100.0,99.98,100.0,14,6,34,7,3,18,21,9,52,18.382824706286993,2.600884211330515
Northeastern University,13824,13786,Massachusetts,Large City,private,100.0,100.0,100.0,39,21,75,18,9,35,57,30,110,18.581620130470085,37.4832859389679
Northern ArizoNA University,27092,21990,ArizoNA,Small City,NA,100.0,100.0,100.0,128,69,250,57,30,114,185,99,364,128.69901327946545,56.624447770428155
Northern Illinois University,13456,11788,Illinois,Suburb,public,100.0,100.0,100.0,15,8,31,7,4,14,22,12,45,20.47986863522087,1.5028712576489058
Northern Kentucky University,12326,8962,Kentucky,Suburb,public,100.0,100.0,100.0,22,10,49,10,5,24,32,15,73,21.806423668601234,9.960065229495278
Northern Michigan University,7018,6207,Michigan,Town,NA,100.0,99.99,100.0,14,7,31,7,3,16,21,10,47,18.014895983680837,2.9002851762134663
Northern State University,3164,1346,South Dakota,Town,NA,100.0,99.54,100.0,7,4,13,3,2,7,10,6,20,6.3275144120129685,3.620661570990935
Northland College,631,594,Wisconsin,Town,private,62.42,39.45,86.74,1,0,1,0,0,1,1,0,2,0.14307570034224185,0.8329160774022059
Northwest Christian University,604,444,Oregon,Midsize City,NA,84.9,62.95,98.2,1,1,3,1,0,1,2,1,4,0.64354641502603,1.2387509979376583
Northwest Missouri State University,5478,4806,Missouri,Town,NA,99.99,97.37,100.0,7,3,17,3,1,8,10,4,25,7.006482997717784,2.7975168744008085
Northwest Nazarene University,1482,1125,Idaho,Suburb,NA,99.5,89.24,100.0,3,2,9,2,1,6,5,3,15,2.5385000498447527,2.749348889232154
Northwest University,946,929,Washington,Suburb,NA,96.87,85.21,99.99,2,1,6,1,1,4,3,2,10,2.4495623627193956,1.0069210524859065
Northwestern College - 2,1039,997,Iowa,Town,private,95.67,73.2,99.95,2,1,5,1,0,3,3,1,8,1.497562797202545,1.6340027662637784
University of Northwestern - St Paul,3325,2033,Minnesota,Suburb,NA,97.8,82.71,99.99,3,1,6,1,1,3,4,2,9,1.2365044041358575,2.5721063178626298
Northwestern Oklahoma State University,1881,1329,Oklahoma,Town,NA,99.93,95.0,100.0,5,2,12,2,1,6,7,3,18,4.153879325263127,3.0972003927632947
Northwestern State University of LouisiaNA,9440,5471,LouisiaNA,Town,public,100.0,100.0,100.0,52,24,116,23,10,53,75,34,169,60.503801304908315,14.76240147286409
Northwestern University,8699,8205,Illinois,Small City,NA,100.0,100.0,100.0,25,13,52,11,5,24,36,18,76,3.8603673951653312,31.94441219622446
Norwich University,3229,2542,Vermont,Town,private,100.0,99.76,100.0,8,4,17,4,2,8,12,6,25,0.0022105565320840403,11.93870377037086
Notre Dame College,1736,1216,Ohio,Suburb,NA,98.39,88.6,99.96,3,2,5,1,1,3,4,3,8,3.966496135732596,0.1592343949610835
Notre Dame de Namur University,922,718,California,Suburb,private,99.82,96.11,100.0,4,2,9,2,1,4,6,3,13,5.92294862675308,0.360203802569807
Nova Southeastern University,4501,3154,Florida,Suburb,NA,100.0,100.0,100.0,37,19,74,18,9,37,55,28,111,46.29069330834242,8.30192593177868
Nyack College,1397,1131,New York,Suburb,NA,99.28,93.85,99.99,3,2,6,2,1,3,5,3,9,2.6293850737398508,2.290072287424546
Oakland City University,1112,572,IndiaNA,Town,NA,95.67,83.11,99.72,2,1,4,1,1,2,3,2,6,2.922962594938136,0.2126948540673545
Oakland University,15902,12549,Michigan,Suburb,NA,100.0,100.0,100.0,35,17,78,17,8,40,52,25,118,51.6254134721845,0.8981536153389749
Oakwood University,1648,1521,Alabama,Midsize City,private,99.99,98.87,100.0,6,3,13,3,1,6,9,4,19,1.347898720382023,7.794745435942469
Oberlin College,2828,2790,Ohio,Town,NA,100.0,99.73,100.0,8,4,16,4,2,8,12,6,24,0.4771021295338736,11.038935276080668
Occidental College,1976,1952,California,Large City,private,100.0,99.61,100.0,7,4,15,3,2,7,10,6,22,6.98454016059634,3.758053246022427
Oglethorpe University,1253,1166,Georgia,Suburb,NA,99.46,85.47,100.0,4,1,9,2,1,5,6,2,14,2.694634325032894,2.5058900744507846
Ohio Christian University,3988,2429,Ohio,Town,NA,100.0,99.8,100.0,8,4,16,4,2,8,12,6,24,7.21967781309347,4.899347076234994
Ohio Dominican University,1176,957,Ohio,Large City,NA,95.66,80.59,99.77,2,1,4,1,0,2,3,1,6,2.4907537644783107,0.640339733513062
Ohio Northern University,2315,2092,Ohio,Town,private,99.82,96.29,100.0,4,2,8,2,1,4,6,3,12,4.303274109521213,2.0271910136855715
Ohio State University - Lima Campus,1007,844,Ohio,Rural,public,90.58,71.4,98.83,2,1,3,1,0,1,3,1,4,2.3457521368748786,0.013505686473925999
Ohio State University - Main Campus,45943,42003,Ohio,Large City,NA,100.0,100.0,100.0,85,45,162,39,19,77,124,64,239,90.61666230842876,32.72323448786374
Ohio State University - Newark Campus,2605,2218,Ohio,Suburb,NA,99.78,96.09,100.0,4,2,8,2,1,4,6,3,12,6.047971112620574,0.06632231669508773
Ohio University - Main Campus,23167,17695,Ohio,Town,public,100.0,100.0,100.0,38,21,71,18,9,34,56,30,105,49.08538967969088,6.787298139850367
Ohio Valley University,528,435,West Virginia,Small City,NA,75.18,49.41,94.72,1,0,2,0,0,1,1,0,3,0.05034062348882887,1.3364775356373841
Ohio Wesleyan University,1557,1545,Ohio,Suburb,private,99.32,91.98,100.0,3,2,7,2,1,3,5,3,10,1.789132985752026,3.189918850042482
Oklahoma Baptist University,1962,1835,Oklahoma,Town,NA,100.0,99.03,100.0,8,3,19,3,1,8,11,4,27,3.4978548164400878,7.663105889084577
Oklahoma Christian University,1976,1846,Oklahoma,Large City,NA,100.0,99.48,100.0,9,4,21,4,1,9,13,5,30,2.2338765602163857,10.101882765354517
Oklahoma City University,1715,1579,Oklahoma,Large City,NA,99.99,98.27,100.0,7,3,16,3,1,7,10,4,23,2.397882687422146,7.131186169796358
Oklahoma Panhandle State University,1136,852,Oklahoma,Rural,public,99.9,94.84,100.0,5,2,11,2,1,5,7,3,16,1.4732274530034646,5.399339574562984
Oklahoma State University - Main Campus,20992,18221,Oklahoma,Town,NA,100.0,100.0,100.0,84,36,198,35,14,86,119,50,284,41.57555324666016,77.52483293903562
Oklahoma Wesleyan University,1005,609,Oklahoma,Town,NA,99.5,89.81,100.0,4,2,9,2,1,4,6,3,13,1.4930212959420908,3.7713322035175123
Old Dominion University,19543,15036,Virginia,Midsize City,public,100.0,100.0,100.0,66,29,122,35,14,66,101,43,188,95.14013070072079,5.140294444794735
Olivet College,1178,1032,Michigan,Rural,private,97.99,83.86,99.98,3,1,6,1,1,3,4,2,9,3.801248095681926,0.09928497918133072
Olivet Nazarene University,3377,3113,Illinois,Suburb,NA,99.95,98.08,100.0,5,3,11,2,1,5,7,4,16,3.1795874481918434,4.476368081651587
Oral Roberts University,3384,2866,Oklahoma,Large City,private,100.0,99.98,100.0,13,6,32,6,2,14,19,8,46,3.0001810511260576,16.281049222819725
Oregon Institute of Technology,5380,2284,Oregon,Town,NA,100.0,99.75,100.0,7,4,13,3,2,8,10,6,21,7.090818756387725,3.086557227520481
Oregon State University,25835,18829,Oregon,Small City,NA,100.0,100.0,100.0,42,25,80,21,12,42,63,37,122,28.98320505837414,33.67563903243412
Ottawa University - Online,156,85,Kansas,Town,NA,61.04,33.36,88.88,1,0,2,0,0,1,1,0,3,0.036868491462388166,0.898223813661794
Ottawa University - Ottawa,669,646,Kansas,Town,NA,76.53,47.93,95.89,1,0,2,0,0,1,1,0,3,0.32330830974709623,1.1189837926974953
Otterbein University,2483,2294,Ohio,Suburb,private,99.84,96.52,100.0,4,2,8,2,1,4,6,3,12,5.245784688943522,1.1791067436460838
Ouachita Baptist University,1542,1500,Arkansas,Town,private,100.0,99.1,100.0,8,3,19,3,1,7,11,4,26,1.484352141765353,9.692027519033987
University of Holy Cross,912,457,LouisiaNA,Large City,private,99.85,94.6,100.0,4,2,10,2,1,5,6,3,15,6.390642529133747,0.05908675796396776
Our Lady of the Lake University,1344,1221,Texas,Large City,NA,100.0,99.99,100.0,16,7,38,6,2,14,22,9,52,21.955057462193036,0.20657727214941363
Pace University - New York,8670,7878,New York,Large City,NA,100.0,100.0,100.0,22,12,40,10,5,19,32,17,59,15.54097321484471,16.049307693734335
Pacific Lutheran University,2764,2655,Washington,Suburb,NA,100.0,99.69,100.0,7,4,15,4,2,9,11,6,24,7.29734895480778,2.7827119089832473
Pacific Union College,1227,1077,California,Rural,NA,99.98,98.74,100.0,6,3,12,3,1,6,9,4,18,7.65810168551758,0.8851987338262044
Pacific University,1876,1818,Oregon,Suburb,NA,99.16,92.4,100.0,3,2,7,2,1,4,5,3,11,1.1380144173969475,3.6313893587323087
Paine College,425,328,Georgia,Midsize City,NA,83.65,50.42,99.09,1,0,3,1,0,2,2,0,5,0.9371339374836621,0.867262039630406
Palm Beach Atlantic University,3005,2350,Florida,Midsize City,NA,100.0,100.0,100.0,19,10,39,9,5,19,28,15,58,24.13213738185566,4.434729460318299
Park University,9864,4134,Missouri,Suburb,NA,100.0,99.95,100.0,13,5,31,6,2,15,19,7,46,14.077007465523405,4.547300231951979
Paul Quinn College,518,492,Texas,Large City,private,99.94,95.69,100.0,5,2,12,2,1,5,7,3,17,6.657123089608302,0.6875834561204515
Paul Smiths College of Arts and Science,768,760,New York,Rural,private,87.08,69.21,97.46,1,1,2,1,0,1,2,1,3,1.3916855804656227,0.650825126754847
William Peace University,932,814,North CaroliNA,Large City,NA,78.45,51.52,96.49,1,1,2,0,0,1,1,1,3,1.157595352022034,0.3747363512037577
Peirce College,1388,307,Pennsylvania,Large City,NA,95.69,82.14,99.8,2,1,4,1,1,2,3,2,6,2.648928216191935,0.49109146097303324
Pennsylvania State University - Brandywine,1439,1245,Pennsylvania,Suburb,NA,96.06,83.36,99.82,2,1,4,1,1,2,3,2,6,2.781374627001532,0.44735666297778004
Pennsylvania State University - University Park,40833,39785,Pennsylvania,Small City,NA,100.0,100.0,100.0,86,47,167,39,21,80,125,68,247,54.38787691385957,70.82176760501895
Pennsylvania State University - Abington,3891,3312,Pennsylvania,Suburb,NA,99.99,99.37,100.0,6,3,12,3,2,6,9,5,18,7.404582154324019,1.7564585546827056
Pennsylvania State University - AltooNA,3478,3374,Pennsylvania,Small City,NA,99.99,99.4,100.0,6,4,12,3,2,6,9,6,18,5.854545252817957,3.3981391277974478
Pennsylvania State University - Beaver,652,563,Pennsylvania,Suburb,NA,79.23,57.71,95.44,1,1,2,0,0,1,1,1,3,1.183739796610771,0.38508991019205296
Pennsylvania State University - Berks,2718,2411,Pennsylvania,Suburb,public,99.84,97.24,100.0,4,2,9,2,1,4,6,3,13,5.070214163804876,1.385954643981803
Pennsylvania State University - Erie - Behrend College,4341,4138,Pennsylvania,Suburb,NA,100.0,99.63,100.0,7,4,13,3,2,6,10,6,19,7.942645698238006,2.2240466494047
Pennsylvania State University - Greater Allegheny,497,453,Pennsylvania,Suburb,public,69.41,47.66,90.2,1,0,2,0,0,1,1,0,3,0.9209164501604775,0.2615589903713982
Pennsylvania State University - Harrisburg,4288,3960,Pennsylvania,Suburb,public,100.0,99.86,100.0,8,5,16,4,2,8,12,7,24,6.351219293353945,5.719512988275297
Pennsylvania State University - Lehigh Valley,899,739,Pennsylvania,Suburb,public,87.32,68.19,98.22,1,1,3,1,0,1,2,1,4,1.7880265459295563,0.2733975515455226
Pennsylvania State University - New Kensington,597,484,Pennsylvania,Rural,NA,72.52,50.83,92.1,1,0,2,0,0,1,1,0,3,1.2044345482997705,0.08567886026084785
Pennsylvania State University - Schuylkill,733,595,Pennsylvania,Town,NA,85.31,65.65,97.49,1,1,2,1,0,1,2,1,3,1.142350293232772,0.7717949769703402
Pennsylvania State University - SheNAngo,490,241,Pennsylvania,Suburb,NA,64.35,43.57,86.38,1,0,1,0,0,1,1,0,2,0.8898743226269783,0.14032415574525695
Pennsylvania State University - Wilkes - Barre,456,387,Pennsylvania,Rural,NA,64.36,43.57,86.66,1,0,1,0,0,1,1,0,2,0.8940132729647782,0.136101278781326
Pennsylvania State University - Worthington Scranton,1030,904,Pennsylvania,Suburb,public,88.44,69.99,98.48,1,1,3,1,0,1,2,1,4,2.100517296433449,0.05453522783570163
Pennsylvania State University - York,966,793,Pennsylvania,Suburb,NA,88.98,70.23,98.66,2,1,3,1,0,1,3,1,4,1.7694012694094567,0.4325264819731576
Pepperdine University,3603,3300,California,Suburb,NA,100.0,100.0,100.0,17,8,35,7,4,16,24,12,51,14.525500711345009,9.532073605463367
Peru State College,2046,1105,Nebraska,Rural,public,81.51,54.67,97.64,1,1,3,1,0,1,2,1,4,0.2535721430893418,1.4306460937302634
Pfeiffer University,812,733,North CaroliNA,Rural,NA,92.7,71.17,99.64,2,1,4,1,0,2,3,1,6,0.7963503987808191,1.8094150866721879
Cairn University,770,727,Pennsylvania,Suburb,private,90.28,71.9,98.96,2,1,3,1,0,1,3,1,4,0.9105690743159778,1.4147878684206765
Thomas Jefferson University,2690,2279,Pennsylvania,Large City,private,99.99,99.48,100.0,7,4,13,3,2,6,10,6,19,2.5516628832536377,7.087060553008833
Philander Smith College,893,845,Arkansas,Midsize City,private,94.17,71.18,99.85,2,1,4,1,0,2,3,1,6,0.5944527761985945,2.234795518143938
Piedmont College,1281,1160,Georgia,Town,NA,98.32,70.12,100.0,3,1,8,1,0,4,4,1,12,3.6676967201836614,0.4087813433638704
University of Pikeville,1562,1049,Kentucky,Town,NA,99.21,88.07,100.0,3,1,8,2,1,4,5,2,12,3.1336365373306934,1.7004349875045186
Pine Manor College,419,417,Massachusetts,Suburb,NA,80.11,59.48,95.09,1,1,2,1,0,1,2,1,3,1.3877681930202173,0.22353274983082216
Pittsburg State University,5709,5109,Kansas,Town,NA,99.81,94.6,100.0,4,2,9,2,1,4,6,3,13,2.9650775249174486,3.3157393617960023
Pitzer College,1070,1046,California,Suburb,NA,99.4,93.15,100.0,3,2,7,2,1,3,5,3,10,3.126204034145322,1.9719832420521728
Platt College - Aurora,236,236,Colorado,Large City,private,20.7,8.03,49.06,0,0,0,0,0,0,0,0,0,0.23181540842619924,0.0
Plymouth State University,4148,3971,New Hampshire,Town,NA,99.96,96.46,100.0,5,2,10,2,1,5,7,3,15,1.763402084368268,5.971090459938151
Point Loma Nazarene University,3097,2571,California,Large City,private,100.0,100.0,100.0,14,7,29,7,3,14,21,10,43,18.413122121488254,2.3731521699504343
Point Park University,3282,2758,Pennsylvania,Large City,private,100.0,99.45,100.0,7,4,14,3,2,6,10,6,20,4.4162600104324925,5.500439282435905
PomoNA College,1600,1578,California,Suburb,private,99.98,98.45,100.0,6,3,12,3,1,6,9,4,18,3.799765559066562,4.490662048123556
Portland State University,21163,13990,Oregon,Large City,NA,100.0,100.0,100.0,30,18,59,15,8,32,45,26,91,24.67321530636495,19.999437765696083
Post University,7845,2617,Connecticut,Suburb,private,100.0,100.0,100.0,19,9,42,9,4,20,28,13,62,1.4970317999815346,26.557502081087772
University of the Potomac - VA Campus,37,37,Virginia,Suburb,NA,17.7,7.96,30.54,0,0,0,0,0,0,0,0,0,0.19433503565897478,0.0
Prairie View A & M University,7977,7341,Texas,Town,NA,100.0,100.0,100.0,92,40,216,34,14,81,126,54,297,122.78693698610869,3.4439676483540373
Pratt Institute - Main,3642,3537,New York,Large City,NA,100.0,99.98,100.0,12,6,23,5,3,11,17,9,34,2.8531007098481034,13.936118066243246
Presbyterian College,1014,975,South CaroliNA,Town,NA,100.0,99.73,100.0,8,4,16,4,2,9,12,6,25,10.57223045373368,1.4894278503163465
Prescott College,386,291,ArizoNA,Small City,NA,80.52,55.51,97.58,1,1,2,1,0,1,2,1,3,0.29290986007031256,1.3367713965343855
Presentation College,762,475,South Dakota,Town,private,82.9,61.66,96.29,1,1,2,1,0,1,2,1,3,1.211395870803433,0.5512400572696781
Princeton University,5397,5260,New Jersey,Suburb,private,100.0,100.0,100.0,19,10,40,9,4,19,28,14,59,5.814799247572965,22.14148744105387
Principia College,456,441,Illinois,Rural,private,87.73,64.55,98.85,1,1,3,1,0,1,2,1,4,0.05647022601623402,2.0320614380237005
Providence Christian College,165,161,California,Midsize City,private,61.2,38.6,85.64,1,0,1,0,0,1,1,0,2,0.7614173759979238,0.1821150773702357
Providence College,4076,3826,Rhode Island,Midsize City,private,100.0,99.92,100.0,9,5,17,4,2,8,13,7,25,0.3321164856404199,12.52457299129321
Purdue University - Main Campus,32130,30277,IndiaNA,Small City,NA,100.0,100.0,100.0,70,38,134,32,17,64,102,55,198,63.61590704423577,37.99012489126413
Queens University of Charlotte,1717,1449,North CaroliNA,Large City,private,99.48,92.02,100.0,4,2,7,2,1,4,6,3,11,1.4073781077947698,3.8393796256818327
Quincy University,992,874,Illinois,Town,NA,96.79,82.44,99.93,2,1,5,1,1,2,3,2,7,0.9850917205054156,2.438136141234952
Quinnipiac University,7311,6959,Connecticut,Suburb,private,100.0,100.0,100.0,16,9,30,7,4,15,23,13,45,0.7619318215604411,22.975856471925663
Radford University,8419,8049,Virginia,Small City,NA,100.0,100.0,100.0,28,12,52,15,6,28,43,18,80,41.28306433187951,1.7729418124909073
Ramapo College of New Jersey,5616,4910,New Jersey,Suburb,NA,100.0,100.0,100.0,26,14,52,12,6,25,38,20,77,37.74796810124677,0.32733153575068125
Randolph College,666,645,Virginia,Small City,NA,95.66,75.67,99.77,2,1,4,1,0,2,3,1,6,2.1219284974655626,1.0048984890024217
Randolph - Macon College,1452,1428,Virginia,Suburb,private,99.88,95.0,100.0,4,2,8,2,1,4,6,3,12,5.509660875844988,1.2254649283189951
Reed College,1446,1408,Oregon,Large City,NA,99.94,97.65,100.0,5,3,11,2,1,5,7,4,16,0.1476023887674381,7.281448153384041
Regent University,4280,2263,Virginia,Large City,NA,100.0,99.99,100.0,14,7,29,7,3,15,21,10,44,9.989871292523514,11.359988358198201
Regis University,4084,2378,Colorado,Large City,NA,99.99,98.22,100.0,6,3,15,3,1,7,9,4,22,2.5499694926881915,6.676970963109749
Reinhardt University,1408,1260,Georgia,Rural,NA,98.85,73.22,100.0,3,1,9,1,0,5,4,1,14,4.077879945216447,0.3785720897462782
Rensselaer Polytechnic Institute,6366,6340,New York,Small City,NA,100.0,100.0,100.0,15,8,30,7,4,14,22,12,44,6.1420111004265685,16.33640780145352
Rhode Island College,7079,5461,Rhode Island,Suburb,public,99.98,99.19,100.0,6,3,11,3,1,5,9,4,16,4.50887666933732,4.205597888754258
Rhodes College,1984,1979,Tennessee,Large City,NA,100.0,99.57,100.0,9,4,19,4,2,9,13,6,28,1.8190763834780463,10.488640004161951
Rice University,4004,3916,Texas,Large City,NA,100.0,100.0,100.0,32,14,74,13,5,29,45,19,103,35.50465647791094,9.464935495692675
Rider University,4092,3711,New Jersey,Suburb,private,100.0,100.0,100.0,16,9,32,7,4,16,23,13,48,20.661828132075026,3.0378841679782
Ripon College,759,739,Wisconsin,Town,NA,60.22,37.66,85.25,1,0,1,0,0,1,1,0,2,0.27809079784830104,0.6410096627656
Rivier University,1427,908,New Hampshire,Small City,private,96.04,77.42,99.81,2,1,4,1,0,2,3,1,6,0.5872539034454325,2.6369336464503172
Roanoke College,2036,1973,Virginia,Suburb,NA,99.98,98.33,100.0,6,3,11,3,1,6,9,4,17,5.383605717579707,3.3541847587763804
Robert Morris University,4245,3840,Pennsylvania,Suburb,NA,99.99,99.48,100.0,7,4,13,3,2,6,10,6,19,7.501847487262316,2.007380961162267
Roberts Wesleyan College,1322,1248,New York,Suburb,NA,97.89,89.88,99.88,3,2,5,1,1,2,4,3,7,3.2046538523039287,0.6462230243393136
Rochester College,1152,762,Michigan,Suburb,NA,97.72,82.97,99.98,3,1,6,1,1,3,4,2,9,3.564901063826055,0.21171480229496362
Rochester Institute of Technology,13510,12447,New York,Suburb,private,100.0,100.0,100.0,31,17,57,14,7,27,45,24,84,20.358122885850978,24.36613105994309
Rockford University,1059,918,Illinois,Midsize City,NA,90.02,67.6,99.4,2,1,3,1,0,2,3,1,5,1.2815604070906443,1.0162375667249364
Rockhurst University,2208,1445,Missouri,Large City,NA,97.76,78.27,99.99,3,1,6,1,0,3,4,1,9,2.5928141132858795,1.1996076126357966
Rocky Mountain College,898,868,MontaNA,Midsize City,private,99.43,55.23,100.0,3,1,23,2,0,20,5,1,43,3.459270023258011,1.6967677057394552
Roger Williams University,4704,4042,Rhode Island,Suburb,private,100.0,99.94,100.0,9,5,17,4,2,8,13,7,25,0.3115568936722034,12.980166340442304
Rollins College,2614,2453,Florida,Suburb,private,100.0,100.0,100.0,15,8,31,7,4,15,22,12,46,18.333891175047704,4.217999787360704
Roosevelt University,2576,2117,Illinois,Large City,NA,99.77,95.38,100.0,4,2,9,2,1,4,6,3,13,2.7560607530700882,3.2811594604734955
Rosemont College,634,520,Pennsylvania,Suburb,NA,84.22,63.9,97.35,1,1,2,1,0,1,2,1,3,1.0140428327609752,0.8287193144131859
Rowan University,15399,13634,New Jersey,Suburb,NA,100.0,100.0,100.0,71,39,142,33,17,69,104,56,211,102.79242271775904,1.221647817365647
Rust College,862,792,Mississippi,Town,NA,99.83,95.23,100.0,4,2,9,2,1,4,6,3,13,4.367860838077191,1.9590243502204048
Rutgers University - Camden,5489,4493,New Jersey,Small City,NA,100.0,100.0,100.0,26,14,51,12,6,25,38,20,76,36.025574959193165,1.1469070106601735
Rutgers University - New Brunswick,35638,33677,New Jersey,Small City,NA,100.0,100.0,100.0,164,90,325,75,39,158,239,129,483,227.20432415457492,11.229554291582208
Rutgers University - Newark,8549,7162,New Jersey,Large City,NA,100.0,100.0,100.0,40,22,79,18,10,38,58,32,117,56.34292446285747,1.663232823058591
Sacred Heart University,5605,4982,Connecticut,Suburb,NA,100.0,99.99,100.0,12,7,21,5,3,10,17,10,31,0.7212214388662584,16.195038036267714
SagiNAw Valley State University,7850,6559,Michigan,Suburb,public,100.0,100.0,100.0,17,8,38,8,4,20,25,12,58,25.459827487140775,0.2092367651025464
Saint Ambrose University,2369,2215,Iowa,Midsize City,private,99.27,88.66,100.0,3,2,8,2,1,4,5,3,12,2.2000124126568323,2.712920286192716
Saint Anselm College,1965,1926,New Hampshire,Suburb,NA,99.62,94.58,100.0,4,2,7,2,1,3,6,3,10,0.36416303509744696,5.206145203640077
Saint Augustine's University,972,961,North CaroliNA,Large City,private,95.22,77.43,99.79,2,1,4,1,0,2,3,1,6,0.6768306930616068,2.3537382943440956
St. BoNAventure University,1621,1586,New York,Town,NA,99.36,94.82,99.99,3,2,6,2,1,3,5,3,9,3.6898552968503986,1.3583392582326872
Saint Cloud State University,13133,8373,Minnesota,Small City,NA,99.99,99.16,100.0,7,3,14,3,1,7,10,4,21,6.265100522185723,3.4956218664466427
Saint Edward's University,3941,3528,Texas,Large City,NA,100.0,100.0,100.0,45,20,106,17,7,40,62,27,146,60.92276282005173,1.3038990227826757
Saint Francis University,2119,1526,Pennsylvania,Town,private,99.33,93.61,99.99,3,2,7,2,1,3,5,3,10,3.8202511617893067,1.1762963730222602
St. John Fisher College,2746,2624,New York,Suburb,NA,99.97,99.23,100.0,5,3,9,3,1,4,8,4,13,7.795182489330409,0.24102913136747328
Saint Johns University,1724,1703,Minnesota,Rural,NA,83.48,57.59,98.34,1,1,3,1,0,1,2,1,4,0.7997075935360203,0.9960199499369262
University of Saint Joseph,808,654,Connecticut,Small City,NA,52.84,36.37,73.82,1,0,1,0,0,0,1,0,1,0.3229073536424942,0.42769804904450054
St. Joseph's College - New York,928,798,New York,Large City,NA,94.03,81.66,99.2,2,1,3,1,1,2,3,2,5,2.641006665225994,0.17189331297829089
Saint Joseph's College of Maine,1537,960,Maine,Rural,private,92.96,72.34,99.4,2,1,3,1,0,2,3,1,5,0.6689466402008762,1.9798574422086699
Saint Joseph's University,5143,4481,Pennsylvania,Large City,NA,100.0,100.0,100.0,13,7,26,6,3,13,19,10,39,3.9630449484434034,15.565049540748113
Saint Leo University,9672,6732,Florida,Suburb,private,100.0,100.0,100.0,70,37,140,34,17,70,104,54,210,93.68387005037367,9.832341195109858
Saint Louis University,9900,6625,Missouri,Large City,NA,100.0,100.0,100.0,16,8,36,7,3,16,23,11,52,5.90566205242418,17.323238506504858
Saint Martin's University,1318,1121,Washington,Suburb,NA,98.97,94.41,99.97,3,2,5,2,1,3,5,3,8,4.055712534682113,0.5136793815133955
Saint Mary - of - the - Woods College,662,491,IndiaNA,Rural,private,86.74,66.4,98.12,1,1,3,1,0,1,2,1,4,1.4042804639086348,0.6111516277842195
Saint Mary's College,1533,1486,IndiaNA,Suburb,NA,99.5,93.25,100.0,4,2,7,2,1,4,6,3,11,1.244118129939422,4.037896329534318
Saint Mary's College of California,2776,2614,California,Suburb,NA,100.0,100.0,100.0,13,7,27,6,3,13,19,10,40,17.98848550795095,1.4195480315117501
Saint Mary's University of Minnesota,1501,1129,Minnesota,Town,NA,77.58,52.93,95.58,1,1,2,0,0,1,1,1,3,0.5405632170980572,0.9521874137429396
Saint Michael's College,1790,1766,Vermont,Suburb,private,98.3,88.87,99.95,3,2,5,1,1,2,4,3,7,0.0023831525375921036,4.0650936465773135
Saint Norbert College,2068,2021,Wisconsin,Suburb,private,91.59,72.74,99.38,2,1,3,1,0,2,3,1,5,0.7068141111977652,1.7620015887460923
Saint Peter's University,2633,2387,New Jersey,Large City,NA,100.0,99.98,100.0,11,6,21,5,3,10,16,9,31,13.462224798290963,2.0471552941248534
St. Thomas AquiNAs College,1777,1091,New York,Suburb,NA,99.89,98.06,100.0,5,3,8,2,1,4,7,4,12,3.8293143946841144,2.9674349834897207
St. Thomas University,2907,935,Florida,Suburb,NA,100.0,100.0,100.0,25,13,51,12,6,25,37,19,76,36.014458833835356,1.2141077940634866
Saint Vincent College,1667,1617,Pennsylvania,Suburb,NA,98.89,91.16,99.99,3,2,6,1,1,3,4,3,9,2.781374627001532,1.7082758963458873
Saint Xavier University,2942,2638,Illinois,Large City,NA,99.18,92.52,99.99,3,2,7,1,1,3,4,3,10,4.304286116348504,0.4918606399899236
Salem College,817,673,North CaroliNA,Midsize City,private,93.39,70.38,99.78,2,1,4,1,0,2,3,1,6,0.7224899064824295,1.9814332571193698
Salem InterNAtioNAl University,892,892,West Virginia,Rural,private,98.43,86.56,99.98,3,1,6,1,1,3,4,2,9,0.03386140593418982,4.101152999236202
Salem State University,7110,5792,Massachusetts,Suburb,NA,100.0,100.0,100.0,20,11,37,9,5,18,29,16,55,28.862172848702677,0.757422460601848
Salisbury University,7783,7191,Maryland,Suburb,public,100.0,100.0,100.0,16,9,29,7,4,14,23,13,43,17.737610961339627,5.368039511766354
Salve RegiNA University,2180,2087,Rhode Island,Suburb,NA,99.59,95.22,100.0,4,2,7,2,1,3,6,3,10,0.24355208946964124,5.249268107021151
Sam Houston State University,18416,14808,Texas,Town,public,100.0,100.0,100.0,224,96,526,83,33,196,307,129,722,305.97549836858764,1.0593045926275497
Samford University,3375,3266,Alabama,Suburb,private,100.0,99.97,100.0,13,6,28,6,2,13,19,8,41,5.878912111204669,12.58360400474605
San Diego Christian College,656,504,California,Suburb,private,98.82,89.82,99.99,3,2,6,1,1,3,4,3,9,3.8803000892201887,0.5423481547182809
San Diego State University,30267,27060,California,Large City,NA,100.0,100.0,100.0,149,77,302,68,34,143,217,111,445,202.3905955969866,14.467586281879576
San Francisco State University,26676,22263,California,Large City,public,100.0,100.0,100.0,133,70,267,61,31,127,194,101,394,193.59036784747212,0.5596132292645887
San Jose State University,27777,23097,California,Large City,NA,100.0,100.0,100.0,139,73,280,64,32,133,203,105,413,202.8518388151392,0.21607855671989354
Santa Clara University,5498,5411,California,Midsize City,private,100.0,100.0,100.0,23,12,46,10,5,22,33,17,68,24.672851510701953,8.266454384659108
Sarah Lawrence College,1401,1384,New York,Suburb,NA,99.83,96.28,100.0,4,2,9,2,1,4,6,3,13,0.8018898125438662,5.533821149077242
SavanNAh State University,4237,3687,Georgia,Midsize City,NA,100.0,99.0,100.0,10,3,28,5,1,14,15,4,42,11.700701046920612,2.7689605941438518
Schreiner University,1249,1137,Texas,Town,NA,100.0,99.98,100.0,15,6,35,6,2,13,21,8,48,20.408453108041613,0.14326694405277426
Scripps College,1064,1060,California,Suburb,NA,99.61,94.2,100.0,4,2,8,2,1,4,6,3,12,3.1628106387606065,2.3560392005334494
Seattle Pacific University,2898,2783,Washington,Large City,private,100.0,99.81,100.0,7,4,14,4,2,8,11,6,22,6.175244040148895,4.666265140662769
Seattle University,4563,4325,Washington,Large City,private,100.0,100.0,100.0,13,7,27,6,3,15,19,10,42,7.139667545231531,12.353130990670984
Seton Hall University,5972,5554,New Jersey,Suburb,NA,100.0,100.0,100.0,24,13,47,11,6,23,35,19,70,28.185241376565163,6.299362333973198
Seton Hill University,2091,1551,Pennsylvania,Suburb,NA,99.52,94.45,100.0,4,2,7,2,1,3,6,3,10,3.319438170915519,1.9996071276102634
Sewanee - The University of the South,1700,1687,Tennessee,Rural,NA,99.99,98.74,100.0,7,3,15,3,1,7,10,4,22,1.4106422520933528,8.3468871676523
Shaw University,1545,1466,North CaroliNA,Large City,private,98.63,87.52,99.99,3,1,6,1,1,3,4,2,9,1.3308317794128024,2.944390477933155
Shawnee State University,3408,2832,Ohio,Town,public,99.97,98.55,100.0,6,3,11,3,1,5,9,4,16,7.22903275680982,0.8940566333982799
SheNAndoah University,2060,1991,Virginia,Small City,NA,99.99,98.66,100.0,6,3,12,3,1,6,9,4,18,6.64940959849357,2.7313789307158514
Shepherd University,3419,2614,West Virginia,Town,NA,99.51,92.39,100.0,4,2,7,2,1,3,6,3,10,0.46390126129840054,4.845736935547404
Shippensburg University of Pennsylvania,5573,5160,Pennsylvania,Town,NA,100.0,99.89,100.0,8,5,16,4,2,8,12,7,24,10.69090872253714,1.6492098044649648
Shorter University,1402,1140,Georgia,Small City,NA,99.4,81.98,100.0,4,1,10,2,1,5,6,2,15,3.6197921099608545,1.476895118575821
Shorter University - College of Adult & ProfessioNAl Programs,113,56,Georgia,Small City,NA,28.74,8.88,65.48,0,0,1,0,0,0,0,0,1,0.3383263096985745,0.0
SieNA College,3161,3039,New York,Suburb,NA,99.99,99.65,100.0,7,4,11,3,2,5,10,6,16,7.321602636270082,2.2333886394724636
SieNA Heights University,2301,1290,Michigan,Town,NA,99.95,97.12,100.0,5,2,11,2,1,6,7,3,17,6.942694060766212,0.5890731006454006
Sierra Nevada College,452,410,Nevada,Town,private,95.63,75.17,99.96,2,1,5,1,0,3,3,1,8,1.0350615799168799,2.077229723310628
Silver Lake College of the Holy Family,393,267,Wisconsin,Town,NA,32.87,18.49,56.21,0,0,1,0,0,0,0,0,1,0.17834083775054088,0.21860765101595891
Simmons College,1743,1553,Massachusetts,Large City,NA,99.76,96.17,100.0,4,2,8,2,1,4,6,3,12,4.503861190844754,1.5171940494713365
Simpson College,1433,1280,Iowa,Town,NA,98.6,77.21,100.0,3,1,8,1,0,4,4,1,12,3.751379861255876,0.508063051040692
Simpson University,779,619,California,Small City,NA,99.45,93.16,100.0,4,2,7,2,1,3,6,3,10,4.429399158449461,0.7613866313337037
Skidmore College,2682,2636,New York,Suburb,private,99.99,99.37,100.0,6,4,12,3,2,6,9,6,18,2.489925975906135,6.640802055163385
Slippery Rock University of Pennsylvania,7613,7125,Pennsylvania,Town,NA,100.0,99.99,100.0,12,7,22,5,3,11,17,10,33,13.472283349538671,3.591758255951716
Smith College,2526,2505,Massachusetts,Suburb,private,100.0,99.6,100.0,7,4,15,3,2,7,10,6,22,2.3242988754264986,8.36181843115764
Soka University of America,409,412,California,Suburb,NA,92.96,73.78,99.6,2,1,4,1,0,2,3,1,6,2.049969858455949,0.5931380646473227
Sonoma State University,8670,7887,California,Suburb,NA,100.0,100.0,100.0,43,23,87,20,10,41,63,33,128,63.131750319520165,0.2122178758036426
South CaroliNA State University,2523,2281,South CaroliNA,Town,NA,100.0,100.0,100.0,21,10,42,11,5,22,32,15,64,28.39042092302486,3.1773779442647845
South College,1410,1410,Tennessee,Midsize City,NA,99.22,83.55,100.0,3,1,8,1,1,4,4,2,12,4.839429623969897,0.0
South Dakota State University,10886,8425,South Dakota,Town,NA,100.0,100.0,100.0,18,11,33,9,5,16,27,16,49,20.744027058100475,6.473467798086201
South University - Columbia,806,556,South CaroliNA,Suburb,NA,100.0,99.81,100.0,8,4,16,4,2,9,12,6,25,12.586732268403761,0.0
South University - SavanNAh,499,396,Georgia,Midsize City,NA,95.57,76.01,99.91,2,1,5,1,0,2,3,1,7,0.20958266972478068,2.8896342538119186
South University - Tampa,543,424,Florida,Large City,private,99.94,97.84,100.0,5,3,10,2,1,5,7,4,15,7.390722277691835,0.0
South University - West Palm Beach,699,535,Florida,Suburb,NA,99.99,99.25,100.0,6,3,13,3,2,6,9,5,19,9.391525546238244,0.03088997632321211
Southeast Missouri State University,10462,7779,Missouri,Small City,NA,100.0,99.93,100.0,13,5,31,6,2,15,19,7,46,15.222830524932785,3.1302383307566735
Southeastern LouisiaNA University,13317,8998,LouisiaNA,Small City,NA,100.0,100.0,100.0,66,30,146,30,13,69,96,43,215,93.00029004925061,3.148940956268542
Southeastern Oklahoma State University,3122,2374,Oklahoma,Town,NA,100.0,99.96,100.0,13,6,31,5,2,13,18,8,44,6.594177390410901,12.059042993612069
Southeastern University,6241,4288,Florida,Midsize City,private,100.0,100.0,100.0,44,23,89,21,10,45,65,33,134,55.872771546823174,8.810533782505344
Southern Adventist University,2596,2173,Tennessee,Suburb,NA,100.0,99.84,100.0,10,5,21,4,2,10,14,7,31,2.124543927118699,11.792245946298369
Southern Arkansas University Main Campus,3478,2924,Arkansas,Town,public,100.0,99.88,100.0,11,5,26,5,2,11,16,7,37,4.72714542989062,11.189217531737926
Southern Connecticut State University,7944,6814,Connecticut,Midsize City,NA,99.77,97.53,100.0,4,3,7,2,1,3,6,4,10,3.399779572949412,2.646191885624625
Southern Illinois University Carbondale,10990,9455,Illinois,Small City,NA,100.0,100.0,100.0,14,7,28,6,3,13,20,10,41,15.618723345656726,4.322950869935983
Southern Illinois University Edwardsville,11408,9550,Illinois,Suburb,NA,100.0,99.99,100.0,13,7,26,6,3,12,19,10,38,16.487737379350992,2.0365249313665053
Southern Methodist University,6454,6240,Texas,Suburb,NA,100.0,100.0,100.0,51,23,116,20,8,46,71,31,162,53.374661135117066,17.561017784895107
Southern Nazarene University,1517,1483,Oklahoma,Suburb,NA,99.99,98.2,100.0,7,3,16,3,1,7,10,4,23,2.666513413017787,6.944785102639523
Southern New Hampshire University,70662,19935,New Hampshire,Suburb,NA,100.0,100.0,100.0,124,63,233,57,28,112,181,91,345,19.125941025759833,161.50991804489905
Southern Oregon University,5522,3640,Oregon,Suburb,public,100.0,99.98,100.0,11,6,23,5,3,12,16,9,35,5.262025159559167,10.898242188331261
Southern University and A & M College,5152,4530,LouisiaNA,Midsize City,NA,100.0,100.0,100.0,27,12,61,12,5,28,39,17,89,29.965965863678598,9.53456210403663
Southern University at New Orleans,2108,1520,LouisiaNA,Large City,NA,100.0,99.9,100.0,10,5,23,5,2,11,15,7,34,14.596970966992295,0.6218073873739527
Southern Utah University,8549,6279,Utah,Town,public,100.0,100.0,100.0,40,14,110,21,7,59,61,21,169,39.443868858052724,21.519141061969016
Southern Virginia University,908,853,Virginia,Town,NA,99.38,88.36,100.0,3,1,8,2,1,4,5,2,12,0.7563309495916857,4.30817547305568
Southern Wesleyan University,1360,820,South CaroliNA,Suburb,NA,100.0,99.97,100.0,11,5,22,6,3,12,17,8,34,14.351373392882204,2.077174672779646
Southwest Baptist University,2827,1835,Missouri,Town,private,99.96,95.86,100.0,5,2,13,2,1,6,7,3,19,3.4340074771423135,4.327932226445543
Southwest Minnesota State University,6711,1932,Minnesota,Town,public,99.9,96.77,100.0,5,2,10,2,1,4,7,3,14,2.998360196144902,3.913491526504954
Southwestern Adventist University,802,652,Texas,Town,private,99.99,98.52,100.0,7,3,16,3,1,6,10,4,22,8.758487701227084,1.044652680891541
Southwestern Assemblies of God University,1788,1492,Texas,Suburb,private,100.0,99.98,100.0,15,6,35,6,2,13,21,8,48,18.038113826135625,2.5731396990278976
Southwestern Christian University,620,539,Oklahoma,Suburb,NA,91.64,64.35,99.73,2,1,4,1,0,2,3,1,6,1.5524028247579695,0.9203205883092263
Southwestern College - Winfield,1148,577,Kansas,Town,NA,98.16,82.08,99.99,3,1,6,1,0,3,4,1,9,0.4381678408414594,3.534178364397745
Southwestern Oklahoma State University,4626,3713,Oklahoma,Town,public,100.0,99.9,100.0,12,5,27,5,2,13,17,7,40,11.927204216446475,4.9615727192201975
Southwestern University,1398,1367,Texas,Suburb,NA,100.0,99.99,100.0,16,7,37,6,2,14,22,9,51,21.181755285117326,0.46927030744684856
Spalding University,1250,916,Kentucky,Large City,NA,96.32,76.97,99.96,2,1,5,1,0,3,3,1,8,2.859772503816078,0.4378777929006382
Spelman College,2139,2086,Georgia,Large City,NA,100.0,99.26,100.0,7,3,16,3,1,8,10,4,24,1.6018104043251093,9.215949102247587
Spring Arbor University,1958,1380,Michigan,Suburb,NA,99.82,94.88,100.0,4,2,9,2,1,5,6,3,14,5.5672856392716294,0.736701069955219
Spring Hill College,1376,1363,Alabama,Midsize City,NA,99.99,98.58,100.0,6,3,13,3,1,6,9,4,19,3.105351282726276,5.956955400847998
Springfield College,2230,2188,Massachusetts,Midsize City,private,99.83,97.12,100.0,4,2,8,2,1,4,6,3,12,3.486448313139748,2.8505433680069108
St. Andrews University,641,567,North CaroliNA,Town,NA,94.3,74.28,99.85,2,1,4,1,0,2,3,1,6,0.3317007563218589,2.519416037272173
St Catherine University,3157,2124,Minnesota,Large City,private,94.1,75.25,99.8,2,1,4,1,0,2,3,1,6,1.51357700787456,1.3106802462026264
St. Francis College,2286,2097,New York,Large City,NA,99.9,98.42,100.0,5,3,8,2,1,4,7,4,12,6.252416219544927,0.6456392813407802
St John's College MD,466,458,Maryland,Suburb,NA,88.58,64.95,98.96,1,1,3,1,0,1,2,1,4,0.2484259238282861,1.9112089815068622
St. John's College,319,309,New Mexico,Rural,NA,78.39,51.04,96.72,1,0,2,0,0,1,1,0,3,0.16342860212161292,1.3619891905379828
St John's University - New York,16760,11526,New York,Large City,NA,100.0,100.0,100.0,43,25,81,20,11,38,63,36,119,33.850790601262986,29.24455967201389
St Lawrence University,2411,2372,New York,Town,private,99.84,97.3,100.0,4,2,8,2,1,4,6,3,12,3.0390461736263914,3.38497893203108
St Mary's College of Maryland,1574,1516,Maryland,Suburb,NA,99.04,91.72,99.99,3,2,6,1,1,3,4,3,9,3.7319094335093643,0.9090887183626117
St. Mary's University,2323,2228,Texas,Large City,NA,100.0,100.0,100.0,27,12,63,10,4,24,37,16,87,36.311580488772556,0.7955481349061936
St Olaf College,3039,3003,Minnesota,Town,NA,99.58,92.81,100.0,4,2,8,2,1,4,6,3,12,0.8502325977471954,4.614336085852618
Stanford University,7064,7064,California,Suburb,NA,100.0,100.0,100.0,29,15,61,13,6,29,42,21,90,21.707716536863884,20.54229592672788
SUNY New Paltz,6733,6235,New York,Suburb,NA,100.0,100.0,100.0,14,8,23,6,4,11,20,12,34,18.524816828911923,1.6279144005741564
Stephen F Austin State University,10988,9567,Texas,Town,NA,100.0,100.0,100.0,133,57,313,49,20,116,182,77,429,181.38979327493328,0.9899864573298204
Stephens College,654,542,Missouri,Midsize City,NA,80.33,48.96,98.41,1,0,3,0,0,1,1,0,4,0.7719593421398547,0.8490350730750756
Sterling College Kansas,698,599,Kansas,Rural,private,93.8,71.68,99.8,2,1,4,1,0,2,3,1,6,0.2573704307855174,2.507672102382007
Sterling College Vermont,155,120,Vermont,Rural,private,40.95,23.01,66.4,0,0,1,0,0,0,0,0,1,6.638307904156277e-05,0.5254174089125745
Stetson University,3068,3028,Florida,Suburb,private,100.0,100.0,100.0,25,13,51,12,6,25,37,19,76,35.57890982299532,1.9793341848680346
Stevens Institute of Technology,3125,3113,New Jersey,Suburb,NA,100.0,99.99,100.0,12,7,24,6,3,12,18,10,36,14.288973506476692,3.7190155811459564
Stevenson University,3401,2926,Maryland,Rural,NA,99.99,99.52,100.0,7,4,12,3,2,6,10,6,18,8.04899993203647,1.7786201894532598
Stillman College,675,552,Alabama,Midsize City,NA,96.64,77.08,99.94,2,1,5,1,0,2,3,1,7,2.2188486627827144,1.1637856333595735
Stonehill College,2494,2482,Massachusetts,Suburb,private,99.97,98.87,100.0,6,3,10,3,1,5,9,4,15,5.619184094437689,2.4790180284753025
Stony Brook University,17369,16212,New York,Suburb,NA,100.0,100.0,100.0,36,22,63,17,10,30,53,32,93,44.90292410458497,8.248682786718154
Stratford University,1979,471,Virginia,Suburb,NA,99.99,98.48,100.0,6,3,11,3,1,6,9,4,17,7.363722161996828,1.969789718809564
Strayer University - District of Columbia,691,107,District of Columbia,Large City,NA,86.56,67.94,96.85,1,1,2,1,0,1,2,1,3,1.0677020521823772,0.9359217079189397
Suffolk University,5028,4762,Massachusetts,Large City,private,100.0,100.0,100.0,13,7,24,6,3,12,19,10,36,13.626521429011397,4.992553205993977
Sul Ross State University,2292,1378,Texas,Town,NA,100.0,100.0,100.0,28,12,65,10,4,24,38,16,89,37.47153375438612,0.28187886768859743
Sullivan University,2596,1321,Kentucky,Large City,NA,99.87,94.78,100.0,5,2,11,2,1,5,7,3,16,4.80315381856402,1.8482505691382038
Summit Christian College,32,17,Nebraska,Town,NA,1.35,0.58,3.35,0,0,0,0,0,0,0,0,0,0.0013381115730308273,0.012235273754602104
University at Albany,13510,12740,New York,Small City,public,100.0,100.0,100.0,28,17,47,13,7,23,41,24,70,37.258822304574416,3.1679347721310203
Binghamton University,13739,13345,New York,Suburb,public,100.0,100.0,100.0,30,18,53,14,8,26,44,26,79,34.13261419480195,10.366027560895853
SUNY Fredonia,4393,4281,New York,Town,NA,100.0,99.96,100.0,9,5,15,4,2,7,13,7,22,12.571656590135177,0.21093552608889302
SUNY Geneseo,5558,5452,New York,Town,NA,100.0,99.99,100.0,11,7,19,5,3,9,16,10,28,15.805364421154463,0.4314512236667082
Purchase College,4062,3712,New York,Suburb,public,100.0,99.95,100.0,9,5,16,4,2,7,13,7,23,9.329232565501282,3.620903906880689
The College at Brockport,7182,6419,New York,Town,NA,100.0,100.0,100.0,14,9,24,7,4,12,21,13,36,20.45981181135473,0.6549843810464241
Buffalo State,8527,7665,New York,Large City,NA,100.0,100.0,100.0,17,11,29,8,5,14,25,16,43,24.199058872021237,0.9346016402476516
SUNY Cortland,6345,6196,New York,Town,public,100.0,100.0,100.0,13,8,22,6,3,11,19,11,33,17.632859682350446,1.1878589987309651
SUNY Old Westbury,4634,4056,New York,Suburb,public,100.0,99.97,100.0,9,6,15,4,2,7,13,8,22,13.257330487817613,0.06827370274026762
SUNY Oneonta,5940,5828,New York,Town,NA,100.0,100.0,100.0,12,7,20,5,3,10,17,10,30,17.040158516557156,0.25736844053586916
SUNY Oswego,7123,6836,New York,Town,NA,100.0,100.0,100.0,14,9,24,7,4,12,21,13,36,20.37264987520866,0.4928539393256907
SUNY Plattsburgh,5353,4894,New York,Town,public,100.0,99.99,100.0,10,6,18,5,3,8,15,9,26,14.800096757603095,0.4572162742317345
SUNY Potsdam,3323,3196,New York,Town,public,99.99,99.72,100.0,7,4,11,3,2,5,10,6,16,9.323421769758212,0.38197281876749756
SUNY College of Environmental Science and Forestry,1791,1737,New York,Midsize City,NA,99.68,96.47,100.0,4,2,7,2,1,3,6,3,10,4.390056183890514,1.3356662798719248
SUNY Empire State College,9810,3772,New York,Suburb,NA,100.0,100.0,100.0,20,12,34,9,5,16,29,17,50,26.752903601101156,2.592342729006996
SUNY Polytechnic Institute,2179,1859,New York,Suburb,NA,99.82,97.88,100.0,4,3,7,2,1,3,6,4,10,6.330861962076392,0.0
SUNY Maritime College,1640,1581,New York,Large City,public,99.73,96.54,100.0,4,2,7,2,1,4,6,3,11,3.5039098330721106,2.4047275789846467
SusquehanNA University,2354,2283,Pennsylvania,Town,NA,99.98,98.93,100.0,6,3,11,3,1,5,9,4,16,2.3219511395057433,6.009983265364783
Swarthmore College,1581,1573,Pennsylvania,Suburb,NA,99.89,96.71,100.0,5,2,10,2,1,5,7,3,15,0.4345897854689894,6.309667460872957
Sweet Briar College,320,314,Virginia,Suburb,NA,78.46,49.91,96.28,1,0,2,1,0,1,2,0,3,0.8351154235074862,0.6948996859756413
Syracuse University,15248,14675,New York,Midsize City,NA,100.0,100.0,100.0,41,22,77,19,10,37,60,32,114,18.47251966722428,40.62756368887948
Tabor College,712,554,Kansas,Town,private,95.69,76.69,99.9,2,1,5,1,0,2,3,1,7,0.22333797712792833,2.901741012626267
Talladega College,782,762,Alabama,Town,NA,98.38,84.75,99.99,3,1,6,1,1,3,4,2,9,2.3121647280399316,1.7930454332543835
Tarleton State University,11290,8429,Texas,Town,NA,100.0,100.0,100.0,137,59,322,51,20,120,188,79,442,187.17274868610818,0.6854205197004992
Taylor University,2111,1840,IndiaNA,Town,NA,99.78,95.91,100.0,4,2,8,2,1,4,6,3,12,2.1707716336184397,3.9275681170804684
Temple University,29583,26643,Pennsylvania,Large City,NA,100.0,100.0,100.0,54,30,105,25,13,50,79,43,155,46.51559337136416,32.84572645085457
Tennessee State University,6504,5431,Tennessee,Large City,NA,100.0,99.99,100.0,16,7,39,7,3,18,23,10,57,16.172618714997274,7.034094015048017
Tennessee Technological University,9365,8259,Tennessee,Town,NA,100.0,100.0,100.0,23,9,56,10,3,25,33,12,81,31.370487066017628,1.1431428190698105
Tennessee Wesleyan University,931,863,Tennessee,Town,NA,97.21,75.42,99.98,2,1,6,1,0,3,3,1,9,2.886496676424598,0.6817567449457829
Texas A&M InterNAtioNAl University,6800,5191,Texas,Large City,public,100.0,100.0,100.0,83,36,195,31,12,72,114,48,267,113.50731086120014,0.15867517127873318
Texas A&M University - College Station,53069,46724,Texas,Midsize City,public,100.0,100.0,100.0,635,273,1490,234,94,555,869,367,2045,861.458625262343,8.272322084622912
Texas A&M University - Commerce,8490,6068,Texas,Town,NA,100.0,100.0,100.0,102,44,240,38,15,90,140,59,330,139.14395912294927,1.0277211107380344
Texas A&M University - Corpus Christi,10174,8355,Texas,Large City,NA,100.0,100.0,100.0,123,53,289,45,18,107,168,71,396,168.31089993221798,0.49989923091142624
Texas A&M University - Kingsville,6782,5020,Texas,Town,NA,100.0,100.0,100.0,83,36,194,30,12,72,113,48,266,112.88530693616097,0.39021917851355337
Texas A&M University - TexarkaNA,1611,1166,Texas,Rural,NA,100.0,99.99,100.0,16,7,38,6,2,14,22,9,52,21.702893708798783,0.5852539907213501
Texas Christian University,9009,8738,Texas,Large City,NA,100.0,100.0,100.0,82,36,190,31,13,73,113,49,263,98.59602757715327,14.207044849395189
Texas College,993,940,Texas,Midsize City,NA,100.0,99.76,100.0,10,4,23,4,2,9,14,6,32,12.154292913603037,1.7778304421513396
Texas Lutheran University,1359,1305,Texas,Town,private,100.0,99.99,100.0,17,7,39,6,2,14,23,9,53,22.442574052088595,0.17640689431061118
Texas Southern University,7971,6695,Texas,Large City,NA,100.0,100.0,100.0,85,37,198,32,13,75,117,50,273,108.53127946088686,8.55540850849559
Texas State University,34177,28019,Texas,Suburb,NA,100.0,100.0,100.0,416,179,976,153,61,362,569,240,1338,567.7214743918231,1.4496465121134583
Texas Tech University,30737,27318,Texas,Large City,public,100.0,100.0,100.0,363,156,852,134,54,318,497,210,1170,489.75244184231985,7.240126896102901
Texas Wesleyan University,1675,1497,Texas,Large City,NA,100.0,100.0,100.0,20,9,47,7,3,18,27,12,65,27.21687444968647,0.34785888616463106
Texas Woman's University,10311,6968,Texas,Midsize City,NA,100.0,100.0,100.0,125,54,294,46,18,109,171,72,403,170.79891563237462,0.4659530136144602
The College of Idaho,938,896,Idaho,Suburb,NA,97.68,72.71,100.0,2,1,7,1,0,4,3,1,11,2.911700202733137,0.8437912580557514
The College of New Jersey,6956,6728,New Jersey,Suburb,NA,100.0,100.0,100.0,32,17,63,15,8,31,47,25,94,45.21626476519119,1.0594058916482287
The College of Saint Rose,2504,2426,New York,Small City,NA,99.93,98.75,100.0,5,3,8,2,1,4,7,4,12,6.673698910917611,0.5779961824163287
The College of Saint Scholastica,2678,2179,Minnesota,Small City,NA,86.68,62.92,98.86,1,1,3,1,0,1,2,1,4,1.2071673049164653,0.8060520265129761
The College of Wooster,1979,1962,Ohio,Town,NA,99.84,96.05,100.0,4,2,9,2,1,4,6,3,13,1.690906076730346,4.721857058425416
The Evergreen State College,3615,3330,Washington,Suburb,NA,100.0,99.98,100.0,10,6,18,5,3,10,15,9,28,7.6273798120603935,6.838164117259407
The King's College,555,542,New York,Large City,NA,97.02,81.4,99.96,2,1,5,1,0,2,3,1,7,0.18304006590675206,3.310921986947794
The Master's College and SemiNAry,1353,975,California,Suburb,NA,99.98,98.63,100.0,6,3,12,3,1,6,9,4,18,6.625795435366549,1.8626822074406617
The New School,7124,6224,New York,Large City,private,100.0,100.0,100.0,25,13,51,11,6,24,36,19,75,4.892690015666198,31.561427436819883
Stockton University,8276,7809,New Jersey,Suburb,NA,100.0,100.0,100.0,39,21,77,18,9,37,57,30,114,55.75042122199103,0.5559198186493717
The University of Alabama,33303,29923,Alabama,Midsize City,NA,100.0,100.0,100.0,132,60,280,60,26,132,192,86,412,98.78542352645941,92.70114745209997
The University of Findlay,3563,2499,Ohio,Town,private,99.99,99.11,100.0,6,3,12,3,1,6,9,4,18,6.578864168523463,2.4303794781426022
The University of MontaNA,9322,7444,MontaNA,Small City,NA,100.0,99.54,100.0,31,4,280,25,2,260,56,6,540,45.91901982486037,10.294183987726802
The University of MontaNA - Western,1540,1230,MontaNA,Town,public,99.99,57.52,100.0,5,1,47,4,0,43,9,1,90,7.58110184532552,1.9140393201120418
The University of Tampa,7970,7728,Florida,Large City,NA,100.0,100.0,100.0,36,19,72,17,9,35,53,28,107,35.07530627921153,18.458201455738806
The University of Tennessee - Knoxville,22315,20965,Tennessee,Midsize City,NA,100.0,100.0,100.0,55,22,134,24,9,62,79,31,196,68.62379851181143,11.01409213658146
The University of Tennessee - Chattanooga,10172,8962,Tennessee,Midsize City,NA,100.0,100.0,100.0,25,9,61,11,4,28,36,13,89,33.73871858413056,1.525843408912475
The University of Tennessee - Martin,6327,4950,Tennessee,Town,NA,100.0,99.97,100.0,15,6,38,7,2,17,22,8,55,21.02920943692451,0.9225723622289025
The University of Texas at Arlington,33305,17819,Texas,Large City,public,100.0,100.0,100.0,404,174,947,149,60,352,553,234,1299,549.532062313651,3.2540705533051244
The University of Texas at Austin,40489,37740,Texas,Large City,NA,100.0,100.0,100.0,468,202,1095,173,70,409,641,272,1504,626.1057887610394,15.190096997591356
The University of Texas at Dallas,18474,15294,Texas,Midsize City,NA,100.0,100.0,100.0,221,95,518,81,33,193,302,128,711,298.46101851743884,3.588113834748639
The University of Texas at El Paso,21335,14025,Texas,Large City,NA,100.0,100.0,100.0,259,111,607,95,38,226,354,149,833,352.07103248905725,2.179705910201087
The University of Texas at San Antonio,26437,21510,Texas,Large City,NA,100.0,100.0,100.0,321,138,753,118,47,280,439,185,1033,437.60497764038814,1.7588165480977078
The University of Texas at Tyler,7440,4842,Texas,Midsize City,NA,100.0,100.0,100.0,90,39,211,33,13,78,123,52,289,122.23217672864132,0.6204266410466693
The University of Texas of the Permian Basin,6066,2192,Texas,Midsize City,public,100.0,100.0,100.0,73,31,171,27,11,64,100,42,235,99.55424984005143,0.48985725235477867
The University of Texas Rio Grande Valley,24216,18647,Texas,Small City,public,100.0,100.0,100.0,296,127,695,109,44,258,405,171,953,404.18487485720306,1.0893845368480295
The University of Virginia's College at Wise,2093,1210,Virginia,Town,NA,100.0,99.07,100.0,7,3,13,4,2,7,11,5,20,10.620147083849918,0.31285981223513826
The University of West Florida,10000,6906,Florida,Small City,public,100.0,100.0,100.0,87,46,175,42,21,87,129,67,262,125.6422787207612,3.595853806228978
Thiel College,764,751,Pennsylvania,Town,NA,85.62,64.99,97.71,1,1,3,1,0,1,2,1,4,0.9478196273561769,0.9876097478402701
Thomas AquiNAs College,364,369,California,Rural,private,85.85,60.31,99.35,1,1,3,1,0,2,2,1,5,1.1567687058429996,0.7916890218438757
Thomas College,1660,774,Maine,Rural,NA,92.42,71.03,99.34,2,1,3,1,0,2,3,1,5,0.9474076818155951,1.6276401599000372
Thomas More College,1878,1356,Kentucky,Suburb,NA,99.22,89.84,100.0,3,2,7,2,1,4,5,3,11,2.651741170665553,2.200019467021264
Thomas More College of Liberal Arts,90,90,New Hampshire,Suburb,private,22.3,10.42,43.55,0,0,0,0,0,0,0,0,0,0.0,0.25172640790062334
Thomas University,1118,438,Georgia,Town,NA,99.91,95.4,100.0,5,2,11,2,1,6,7,3,17,2.311397443250438,4.709373679707873
Tiffin University,2243,1772,Ohio,Town,private,100.0,99.31,100.0,7,3,15,3,1,7,10,4,22,2.0042966912280864,8.383313963245678
Toccoa Falls College,1420,872,Georgia,Town,NA,99.75,91.21,100.0,4,2,10,2,1,5,6,3,15,2.541938379947697,3.442599086500296
Tougaloo College,794,766,Mississippi,Midsize City,private,100.0,99.3,100.0,7,3,13,3,2,6,10,5,19,9.234068214726948,0.618080940816649
Touro College,6428,4232,New York,Large City,NA,100.0,100.0,100.0,15,9,28,7,4,14,22,13,42,16.833875267678117,5.356087042944501
Towson University,19592,17106,Maryland,Small City,NA,100.0,100.0,100.0,44,24,82,20,11,40,64,35,122,38.743402965042485,24.95867157841655
Transylvania University,962,963,Kentucky,Large City,private,92.89,68.83,99.81,2,1,4,1,0,2,3,1,6,2.025013863199414,0.613570226926055
Trevecca Nazarene University,2216,1317,Tennessee,Large City,NA,100.0,98.71,100.0,7,3,15,3,1,7,10,4,22,4.623199789707412,5.3559413216367275
Trident University InterNAtioNAl,4368,1862,California,Suburb,private,100.0,99.99,100.0,14,6,32,6,3,15,20,9,47,1.0835554966124301,19.816525282012638
Trine University,4099,1938,IndiaNA,Town,NA,100.0,99.88,100.0,9,5,17,4,2,8,13,7,25,6.832639568793744,5.678299980227875
Trine University - RegioNAl/Non - TraditioNAl Campuses,368,210,IndiaNA,Large City,NA,57.75,36.68,80.25,1,0,1,0,0,1,1,0,2,0.0,0.8606548219042426
Trinity Christian College,1109,907,Illinois,Suburb,private,90.53,69.65,99.36,2,1,3,1,0,2,3,1,5,1.1105811116526023,1.2421564781926138
Trinity College,2218,2117,Connecticut,Midsize City,NA,99.95,98.45,100.0,5,3,10,2,1,5,7,4,15,0.16607985667285874,7.4890519621809455
Trinity InterNAtioNAl University - Florida,156,64,Florida,Suburb,NA,88.21,66.79,98.74,1,1,3,1,0,1,2,1,4,2.1233014278451683,0.0
Trinity InterNAtioNAl University - Illinois,936,592,Illinois,Suburb,NA,92.39,73.11,99.54,2,1,4,1,0,2,3,1,6,0.7011719730349057,1.865903048282227
Trinity University,2389,2353,Texas,Large City,NA,100.0,100.0,100.0,22,10,52,8,3,20,30,13,72,27.87250020851153,3.0974911474335456
Trinity Washington University,1530,1075,District of Columbia,Large City,NA,98.88,92.24,99.95,3,2,5,1,1,3,4,3,8,2.5618884436443077,1.91939216177951
Troy University,14006,9491,Alabama,Town,public,100.0,100.0,100.0,52,23,109,24,10,54,76,33,163,50.40622791644003,25.215727306712036
Truett McConnell University,2574,780,Georgia,Town,NA,99.96,88.77,100.0,5,2,16,2,1,8,7,3,24,7.404256317562608,0.29680428189682406
Truman State University,5895,5134,Missouri,Town,NA,100.0,98.5,100.0,7,3,18,3,1,9,10,4,27,8.325391111418613,2.3632675689630616
Tufts University,5543,5483,Massachusetts,Suburb,NA,100.0,100.0,100.0,16,8,32,7,4,15,23,12,47,5.070036557935825,18.229606395225996
Tulane University of LouisiaNA,7872,6716,LouisiaNA,Large City,private,100.0,100.0,100.0,31,15,66,14,6,31,45,21,97,7.584420272271706,36.914034016195735
Tusculum College,1485,1376,Tennessee,Town,NA,99.89,94.28,100.0,5,2,11,2,1,5,7,3,16,3.3395496624983756,3.4878691706206677
Tuskegee University,2830,2722,Alabama,Town,NA,100.0,99.85,100.0,10,5,21,4,2,10,14,7,31,4.007406580212707,10.208004529522663
Union College Kentucky,1096,918,Kentucky,Town,private,96.25,75.75,99.96,2,1,5,1,0,3,3,1,8,2.227778580320812,1.048630254803108
Union College Nebraska,779,707,Nebraska,Large City,private,94.02,71.33,99.85,2,1,4,1,0,2,3,1,6,0.011875740210648593,2.7914544407405484
Union College New York,2265,2176,New York,Small City,NA,99.94,98.46,100.0,5,3,9,2,1,4,7,4,13,2.6816822354274943,4.717311193684816
Union Institute & University,814,434,Ohio,Large City,NA,99.88,96.85,100.0,5,2,9,2,1,4,7,3,13,0.6010551337755172,6.090875193516114
Union University,2179,1599,Tennessee,Small City,NA,99.98,96.62,100.0,6,2,14,3,1,6,9,3,20,5.124303850061742,3.1484533024751884
United States Air Force Academy,4279,4276,Colorado,Town,NA,100.0,100.0,100.0,18,8,39,8,3,18,26,11,57,0.33102454508317436,24.954315419855398
United States Coast Guard Academy,1047,1044,Connecticut,Small City,NA,99.69,93.78,100.0,4,2,8,2,1,4,6,3,12,0.01665424746580199,5.743855225851193
United States Merchant Marine Academy,952,954,New York,Suburb,public,99.46,91.5,100.0,4,2,8,2,1,4,6,3,12,0.4387150786018978,4.753768079592689
United States Military Academy,4487,4491,New York,Town,public,100.0,100.0,100.0,18,8,38,8,4,17,26,12,55,0.9152003295337603,24.395645200926342
United States Naval Academy,4495,4495,Maryland,Suburb,NA,100.0,100.0,100.0,17,8,36,8,4,17,25,12,53,1.104115217014605,23.426299427693888
Unity College,706,694,Maine,Rural,private,86.1,62.78,98.27,1,1,3,1,0,1,2,1,4,0.19204209766532332,1.7740949821576533
Polytechnic University of Puerto Rico - Orlando,124,53,Florida,Suburb,NA,81.72,58.36,96.91,1,1,2,1,0,1,2,1,3,1.6877524170051337,0.0
University at Buffalo,21016,19401,New York,Suburb,NA,100.0,100.0,100.0,44,27,75,20,12,36,64,39,111,57.3409323926295,6.727041343706343
University of Advancing Technology,775,508,ArizoNA,Midsize City,NA,98.88,87.72,100.0,3,1,7,1,1,3,4,2,10,0.7113525173136163,3.756185725905743
University of Akron Main Campus,16874,13563,Ohio,Midsize City,public,100.0,100.0,100.0,27,15,51,12,6,24,39,21,75,38.19623519385894,1.5724410495161243
University of Alabama at Birmingham,13130,9677,Alabama,Midsize City,NA,100.0,100.0,100.0,47,22,96,22,9,47,69,31,143,61.56786616637271,7.2852589189750985
University of Alabama in Huntsville,7089,5903,Alabama,Midsize City,NA,100.0,100.0,100.0,24,11,50,11,5,25,35,16,75,30.509169113262327,4.765566375950575
University of Alaska Anchorage,14954,6974,Alaska,Large City,NA,96.42,78.61,99.98,2,1,6,1,0,3,3,1,9,0.22301124490536814,3.092409849954851
University of Alaska Fairbanks,6633,3022,Alaska,Suburb,public,93.4,72.67,99.75,2,1,4,1,0,2,3,1,6,0.09503302385974388,2.6114677485396296
University of Alaska Southeast,2060,629,Alaska,Town,NA,67.43,43.38,90.38,1,0,2,0,0,1,1,0,3,0.02894003366801318,1.0882505650792762
University of ArizoNA,34099,29325,ArizoNA,Large City,NA,100.0,100.0,100.0,156,84,300,68,36,136,224,120,436,155.6955387159459,68.28955715508147
University of Arkansas,23037,20464,Arkansas,Small City,NA,100.0,100.0,100.0,81,34,188,32,13,75,113,47,263,25.209069227775128,87.4385276642196
University of Arkansas at Little Rock,8794,4603,Arkansas,Midsize City,NA,100.0,99.92,100.0,12,5,27,5,2,12,17,7,39,15.2243983461161,2.1439352678678816
University of Arkansas at Pine Bluff,2517,2341,Arkansas,Small City,public,99.98,97.31,100.0,6,3,13,2,1,6,8,4,19,2.477479833737855,5.844087020564785
University of Baltimore,2950,1716,Maryland,Large City,NA,99.97,98.76,100.0,6,3,10,3,1,5,9,4,15,7.673600758251504,0.40831551229989815
University of Bridgeport,3124,2300,Connecticut,Midsize City,private,99.97,99.08,100.0,6,3,10,3,1,5,9,4,15,0.48158532255277425,7.613064251599937
University of California - Berkeley,30577,29351,California,Midsize City,public,100.0,100.0,100.0,149,77,303,68,34,144,217,111,447,187.87973752748772,29.02052773364214
University of California - Davis,30067,29284,California,Suburb,NA,100.0,100.0,100.0,150,79,302,69,35,144,219,114,446,216.82824045725494,2.292189222303008
University of California - Irvine,29310,28855,California,Large City,public,100.0,100.0,100.0,147,77,295,67,34,140,214,111,435,212.20848695480598,1.7640489626008153
University of California - Los Angeles,31001,30458,California,Large City,NA,100.0,100.0,100.0,153,80,309,70,35,146,223,115,455,210.8247573003482,12.322959788194614
University of California - Riverside,20077,19719,California,Large City,public,100.0,100.0,100.0,101,53,202,46,23,96,147,76,298,146.56552355867728,0.3172889085020595
University of California - San Diego,28582,27880,California,Large City,NA,100.0,100.0,100.0,143,75,288,65,33,137,208,108,425,202.44916616437106,5.683842652946456
University of California - Santa Barbara,22182,21777,California,Suburb,NA,100.0,100.0,100.0,110,58,222,50,25,105,160,83,327,156.5151986931117,4.014592342333792
University of California - Santa Cruz,17573,17082,California,Small City,NA,100.0,100.0,100.0,88,46,177,40,20,84,128,66,261,127.2372363218069,1.1178284288521303
University of Central Arkansas,9549,8070,Arkansas,Small City,NA,100.0,100.0,100.0,17,7,39,7,3,17,24,10,56,15.635531853007944,8.863383203526649
University of Central Florida,56854,39962,Florida,Suburb,NA,100.0,100.0,100.0,500,262,1008,243,122,503,743,384,1511,728.768771481499,14.444723978047746
University of Central Missouri,9800,7701,Missouri,Town,NA,100.0,99.85,100.0,12,5,29,5,2,14,17,7,43,15.754201641607528,1.2821146803124652
University of Central Oklahoma,14340,10448,Oklahoma,Suburb,public,100.0,100.0,100.0,29,12,69,14,5,36,43,17,105,39.32188284350514,3.760379363312308
University of Charleston,1833,1220,West Virginia,Small City,NA,98.06,85.49,99.96,3,1,5,1,1,3,4,2,8,0.22280805104696902,3.7057914746184477
University of Chicago,6305,6288,Illinois,Large City,private,100.0,100.0,100.0,19,10,40,8,4,19,27,14,59,1.9293993888879957,25.61704508116879
University of CincinNAti - Main Campus,26558,22622,Ohio,Large City,NA,100.0,100.0,100.0,46,25,88,21,11,43,67,36,131,55.27134621212762,12.380243396684653
University of Colorado at Colorado Springs,10804,8171,Colorado,Large City,public,100.0,99.77,100.0,11,4,28,5,2,13,16,6,41,9.53389980586733,5.72122994375636
University of Colorado Boulder,29057,26977,Colorado,Midsize City,NA,100.0,100.0,100.0,59,28,134,26,12,62,85,40,196,16.810546185618534,68.10025806381047
University of Colorado Denver/Anschutz Medical Campus,15589,8671,Colorado,Large City,NA,100.0,99.97,100.0,15,6,39,6,2,18,21,8,57,14.202622840823791,6.946959192265281
University of Connecticut,19243,18555,Connecticut,Suburb,NA,100.0,100.0,100.0,21,12,38,9,5,18,30,17,56,5.9807253121635595,23.862724848605534
University of Dallas,1456,1421,Texas,Midsize City,private,100.0,99.78,100.0,10,4,25,4,2,11,14,6,36,10.792608645274065,3.458898952894228
University of Dayton,8498,8079,Ohio,Midsize City,NA,100.0,100.0,100.0,15,8,29,7,3,14,22,11,43,10.842379767250186,10.506679527141483
University of Delaware,19752,18195,Delaware,Suburb,NA,100.0,100.0,100.0,34,19,64,16,8,31,50,27,95,5.287356485538997,44.15555112391313
University of Denver,5768,5494,Colorado,Large City,NA,100.0,99.96,100.0,12,6,29,5,2,14,17,8,43,2.628550987069954,14.793421557622562
University of Detroit Mercy,2839,2338,Michigan,Large City,private,99.99,98.76,100.0,6,3,14,3,1,7,9,4,21,8.761253166990553,0.5955227512483144
University of Dubuque,1953,1709,Iowa,Small City,NA,99.55,90.73,100.0,4,2,9,2,1,4,6,3,13,1.9250108610747283,3.468697331730153
University of Evansville,2346,2024,IndiaNA,Midsize City,NA,99.97,98.3,100.0,6,3,11,2,1,5,8,4,16,3.6837336812918973,4.35569672734422
University of Florida,35251,31384,Florida,Midsize City,NA,100.0,100.0,100.0,313,165,632,153,76,316,466,241,948,459.3408755571714,6.78631223351578
University of Georgia,28844,27142,Georgia,Midsize City,NA,100.0,100.0,100.0,69,23,194,31,9,96,100,32,290,76.34497850445975,23.806187475936763
University of Providence,930,469,MontaNA,Small City,private,99.63,53.0,100.0,3,1,26,2,0,23,5,1,49,4.045114140100093,1.5213978488874143
University of Hartford,5073,4460,Connecticut,Midsize City,NA,100.0,99.95,100.0,9,5,17,4,2,8,13,7,25,0.8165207438094587,12.6284702194921
University of Hawaii at Hilo,2972,2340,Hawaii,Town,public,95.24,76.09,99.97,2,1,5,1,0,3,3,1,8,0.005223467869733002,3.0280275192940276
University of Hawaii at Manoa,12877,10702,Hawaii,Large City,NA,100.0,100.0,100.0,14,7,30,7,3,15,21,10,45,0.0203297104002442,20.66458002776595
University of Hawaii - West Oahu,3083,1611,Hawaii,Suburb,NA,14.12,8.68,24.16,0,0,0,0,0,0,0,0,0,0.006692499070708314,0.1452878994377202
University of Houston,37217,27159,Texas,Large City,public,100.0,100.0,100.0,449,193,1052,165,66,391,614,259,1443,610.3035268816661,3.9694966981553
University of Houston - Downtown,12402,6320,Texas,Large City,public,100.0,100.0,100.0,151,65,354,56,22,132,207,87,486,205.8832991879618,0.8095218343370607
University of Houston - Victoria,3273,1722,Texas,Small City,public,100.0,100.0,100.0,40,17,94,15,6,35,55,23,129,55.022130990626195,0.0
University of Idaho,9889,7166,Idaho,Town,NA,100.0,100.0,100.0,24,10,63,13,5,39,37,15,102,23.810908764482658,13.678616961082385
University of Illinois at Chicago,19446,17961,Illinois,Large City,public,100.0,100.0,100.0,22,12,44,10,5,20,32,17,64,29.993533101566964,1.4651967472577334
University of Illinois at Springfield,2932,1903,Illinois,Midsize City,public,99.16,92.47,99.99,3,2,7,1,1,3,4,3,10,4.505069142184003,0.2686066520609379
University of Illinois at UrbaNA - Champaign,33955,32613,Illinois,Small City,NA,100.0,100.0,100.0,43,23,86,19,10,39,62,33,125,48.91576466917338,12.838130394345933
University of IndiaNApolis,4486,3828,IndiaNA,Large City,NA,100.0,99.93,100.0,9,5,16,4,2,8,13,7,24,11.626069421158046,1.1016537118435998
University of Iowa,24506,21222,Iowa,Small City,public,100.0,100.0,100.0,41,17,101,19,7,50,60,24,151,36.85020791200194,22.690113947032906
University of Kansas,19344,17151,Kansas,Small City,public,100.0,100.0,100.0,23,11,47,10,4,21,33,15,68,9.954492694844806,22.765076646107698
University of Kentucky,22420,20657,Kentucky,Large City,NA,100.0,100.0,100.0,43,19,100,20,9,48,63,28,148,45.2244318421154,17.643332293168285
University of La Verne,5169,3759,California,Suburb,NA,100.0,100.0,100.0,25,13,51,12,6,24,37,19,75,35.940364411286616,1.0734890143911016
University of LouisiaNA at Lafayette,15665,12767,LouisiaNA,Midsize City,NA,100.0,100.0,100.0,79,36,174,35,15,82,114,51,256,108.34069146705936,5.9755755926648195
University of LouisiaNA at Monroe,7946,5212,LouisiaNA,Small City,NA,100.0,100.0,100.0,41,19,90,18,8,42,59,27,132,53.083793536182554,5.752392033480777
University of Louisville,15543,12025,Kentucky,Large City,NA,100.0,100.0,100.0,29,13,69,14,6,34,43,19,103,34.272503809545356,8.960473618241528
University of Maine,9277,8204,Maine,Suburb,NA,100.0,99.36,100.0,7,4,14,4,2,7,11,6,21,6.046125374829929,4.912274338952088
University of Maine at Augusta,4013,1317,Maine,Town,public,96.08,73.71,99.83,2,1,4,1,0,2,3,1,6,3.194300224499878,0.043070727587988064
University of Maine at Farmington,1810,1673,Maine,Town,public,86.9,58.86,98.3,1,1,3,1,0,1,2,1,4,1.2186671447678643,0.8105219807097208
University of Maine at Fort Kent,1762,582,Maine,Rural,NA,80.84,51.41,96.13,1,1,2,1,0,1,2,1,3,1.3330922279601194,0.31774650167989366
University of Maine at Machias,698,367,Maine,Rural,public,64.86,39.44,87.14,1,0,1,0,0,1,1,0,2,0.42809384271228323,0.6150298632738732
University of Maine at Presque Isle,1413,716,Maine,Rural,NA,71.71,41.5,91.75,1,0,2,0,0,1,1,0,3,1.068234168263361,0.19355124052885483
University of Mary,2234,1794,North Dakota,Rural,NA,100.0,99.57,100.0,10,4,30,6,2,21,16,6,51,12.143361911755736,3.549823265496146
University of Mary Hardin - Baylor,3329,3045,Texas,Suburb,NA,100.0,100.0,100.0,40,17,95,15,6,35,55,23,130,54.83721090480374,0.3833165413291607
University of Mary Washington,4399,3905,Virginia,Suburb,NA,100.0,99.99,100.0,14,6,27,7,3,14,21,9,41,18.97130131892478,2.8253184224506924
University of Maryland - Baltimore County,11238,9543,Maryland,Suburb,public,100.0,100.0,100.0,22,12,41,10,5,20,32,17,61,28.613145848933485,3.583642840980395
University of Maryland - College Park,29870,27708,Maryland,Suburb,public,100.0,100.0,100.0,68,37,129,31,16,63,99,53,192,55.42106331804809,44.03301948950703
University of Maryland Eastern Shore,2860,2573,Maryland,Town,public,99.98,99.0,100.0,6,3,11,3,1,5,9,4,16,6.006386780559451,2.5242448304192067
University of Maryland - University College,45609,9714,Maryland,Suburb,NA,100.0,100.0,100.0,109,57,214,51,25,105,160,82,319,84.6635548406799,75.6920017051852
University of Massachusetts Amherst,23386,21577,Massachusetts,Suburb,NA,100.0,100.0,100.0,64,36,119,30,16,57,94,52,176,73.56448510301341,20.383715479158404
University of Massachusetts - Boston,12658,9574,Massachusetts,Large City,NA,100.0,100.0,100.0,36,21,67,17,9,32,53,30,99,50.28318372992272,3.12148933770198
University of Massachusetts - Dartmouth,6764,5790,Massachusetts,Suburb,NA,100.0,100.0,100.0,19,11,35,9,5,17,28,16,52,27.585085554512293,0.514277735014893
University of Massachusetts - Lowell,14015,10495,Massachusetts,Suburb,NA,100.0,100.0,100.0,38,22,71,18,10,34,56,32,105,53.45461717716217,2.8514295578240856
University of Memphis,17392,12400,Tennessee,Large City,NA,100.0,100.0,100.0,47,19,111,21,8,51,68,27,162,54.41784162272533,12.684220020636364
University of Miami,10834,10216,Florida,Suburb,NA,100.0,100.0,100.0,58,31,118,28,14,58,86,45,176,60.67742157265231,25.590539337967844
University of Michigan - Ann Arbor,29819,28702,Michigan,Midsize City,NA,100.0,100.0,100.0,75,37,159,35,16,79,110,53,238,62.56631148851253,47.36195521799106
University of Michigan - Dearborn,7132,5137,Michigan,Small City,NA,100.0,100.0,100.0,16,8,35,8,3,18,24,11,53,23.332704200437934,0.07482045038046369
University of Michigan - Flint,6432,3809,Michigan,Small City,public,100.0,99.99,100.0,14,7,31,7,3,16,21,10,47,20.847777768286626,0.32347535240304154
University of Minnesota - Crookston,2832,1195,Minnesota,Town,public,99.26,89.05,100.0,3,2,7,2,1,4,5,3,11,1.1381707937893766,3.7464307526686937
University of Minnesota - Duluth,10124,8906,Minnesota,Small City,NA,99.81,95.71,100.0,4,2,9,2,1,4,6,3,13,4.919940195015081,1.327080838270383
University of Minnesota - Morris,1627,1526,Minnesota,Town,NA,75.64,50.51,94.43,1,0,2,0,0,1,1,0,3,0.7828659254656285,0.6265654739646472
University of Minnesota - Twin Cities,35429,29991,Minnesota,Large City,NA,100.0,100.0,100.0,22,11,46,10,5,22,32,16,68,13.171814269891856,19.239918218855216
University of Mississippi,18734,17511,Mississippi,Town,NA,100.0,100.0,100.0,136,67,275,63,30,131,199,97,406,141.69164671708793,57.95661591750606
University of Missouri - Columbia,23800,22197,Missouri,Midsize City,NA,100.0,100.0,100.0,38,16,90,16,6,40,54,22,130,29.576774077322504,24.33338514475055
University of Missouri - Kansas City,11369,6760,Missouri,Large City,public,100.0,99.98,100.0,15,6,35,6,2,16,21,8,51,15.700545274777179,5.386979514870364
University of Missouri - St Louis,13791,5492,Missouri,Suburb,public,100.0,99.99,100.0,18,7,44,8,3,21,26,10,65,22.1254624900757,3.4533185055656035
University of Mobile,1442,1152,Alabama,Rural,NA,99.99,98.71,100.0,6,3,13,3,1,6,9,4,19,5.422700236613831,3.9075261672317914
University of Montevallo,2352,2101,Alabama,Suburb,NA,100.0,99.7,100.0,9,4,18,4,2,9,13,6,27,11.332717702904239,1.4238413211357903
University of Mount Union,2093,2046,Ohio,Town,NA,99.63,94.8,100.0,4,2,7,2,1,3,6,3,10,4.0951266118324146,1.48218636780856
University of Nebraska at Kearney,4846,4063,Nebraska,Town,NA,88.44,63.67,99.38,1,1,3,1,0,2,2,1,5,0.7324488222877491,1.4181566647304962
University of Nebraska at Omaha,12620,9820,Nebraska,Large City,NA,98.78,86.63,100.0,3,1,7,1,1,3,4,2,10,1.9611697742233063,2.4440669533781474
University of Nebraska - Lincoln,20955,19534,Nebraska,Large City,public,100.0,99.97,100.0,12,6,27,5,2,13,17,8,40,2.874430922816846,14.76772732771264
University of Nevada - Las Vegas,25281,18958,Nevada,Midsize City,NA,100.0,100.0,100.0,296,106,830,155,50,458,451,156,1288,436.63975101474716,14.511180161641152
University of Nevada - Reno,18354,15572,Nevada,Midsize City,NA,100.0,100.0,100.0,202,74,560,106,35,308,308,109,868,284.3685219843337,23.699373959091506
University of New England,4427,2361,Maine,Suburb,NA,99.98,98.7,100.0,6,3,11,3,1,5,9,4,16,1.3266908247046085,7.407161233778643
University of New Hampshire at Manchester,737,575,New Hampshire,Midsize City,NA,46.17,1.23,75.78,0,0,1,0,0,0,0,0,1,0.5987365216692259,0.020337785100750228
University of New Hampshire - Main Campus,13010,12677,New Hampshire,Suburb,NA,100.0,100.0,100.0,17,7,33,8,3,16,25,10,49,5.891403335821986,18.860384080361783
University of New Haven,5214,4831,Connecticut,Suburb,NA,100.0,99.98,100.0,10,6,20,5,3,9,15,9,29,0.8882265315094395,14.230496463965066
University of New Mexico - Main Campus,20359,15093,New Mexico,Large City,public,100.0,100.0,100.0,77,26,207,34,10,101,111,36,308,92.2656601852831,18.66702475858956
University of New Orleans,6468,4737,LouisiaNA,Large City,NA,100.0,100.0,100.0,32,15,70,14,6,33,46,21,103,44.1697764961045,1.8349593570763247
University of North Alabama,6061,5141,Alabama,Small City,public,100.0,100.0,100.0,22,10,45,10,4,22,32,14,67,27.95852999623173,4.351676246988884
University of North CaroliNA at Asheville,3820,3285,North CaroliNA,Small City,NA,99.93,96.77,100.0,5,2,11,2,1,5,7,3,16,4.3282248486856325,2.9403888569499093
University of North CaroliNA at Chapel Hill,18863,18303,North CaroliNA,Small City,public,100.0,100.0,100.0,28,14,61,13,6,28,41,20,89,20.95086436994867,19.747693023377384
University of North CaroliNA at Charlotte,23915,20597,North CaroliNA,Large City,public,100.0,100.0,100.0,27,13,59,12,6,28,39,19,87,29.098348129481938,10.399547302948177
University of North CaroliNA at Greensboro,16441,14136,North CaroliNA,Large City,NA,100.0,100.0,100.0,19,9,41,8,4,19,27,13,60,20.37340961197944,6.788637390361597
University of North CaroliNA at Pembroke,5478,4483,North CaroliNA,Town,NA,99.98,98.02,100.0,6,3,13,3,1,6,9,4,19,7.043605129182794,1.3277021643196485
University of North CaroliNA at Wilmington,14499,12346,North CaroliNA,Midsize City,NA,100.0,100.0,100.0,18,9,39,8,4,18,26,13,57,16.08950105867284,10.570915964534635
University of North Dakota,10999,8525,North Dakota,Small City,public,100.0,100.0,100.0,27,11,68,15,5,43,42,16,111,33.26118414399987,8.904683070999697
University of North Florida,14251,10223,Florida,Large City,NA,100.0,100.0,100.0,128,67,258,62,31,129,190,98,387,189.3277106495275,1.3249765648734937
University of North Texas,31444,25592,Texas,Midsize City,NA,100.0,100.0,100.0,377,162,883,139,56,328,516,218,1211,511.4721464680116,3.8882010805572884
University of Northern Colorado,10103,8328,Colorado,Midsize City,NA,100.0,99.43,100.0,9,4,25,4,2,12,13,6,37,9.005439256149977,4.136474085181363
University of Northern Iowa,9959,9100,Iowa,Small City,NA,100.0,99.99,100.0,20,7,54,9,3,28,29,10,82,28.089017176272083,0.8738264306895525
University of Notre Dame,8577,8557,IndiaNA,Suburb,private,100.0,100.0,100.0,26,13,55,12,5,25,38,18,80,1.613063506404216,35.871509827936755
University of Oklahoma Norman Campus,22028,19065,Oklahoma,Suburb,NA,100.0,100.0,100.0,102,43,239,42,16,101,144,59,340,39.918525823512304,103.19262530514592
University of Oregon,19336,17801,Oregon,Midsize City,NA,100.0,100.0,100.0,49,27,100,23,12,50,72,39,150,15.167621469741936,57.67410186967399
University of Pennsylvania,11719,10496,Pennsylvania,Large City,NA,100.0,100.0,100.0,38,20,77,17,9,37,55,29,114,4.3934957835745925,51.27105307724391
University of Phoenix - New Mexico,216,217,New Mexico,Large City,private,95.47,71.89,99.94,2,1,5,1,0,2,3,1,7,0.24003575936611898,2.8294863362766964
University of Phoenix - Hawaii,661,661,Hawaii,Large City,NA,7.58,4.19,13.71,0,0,0,0,0,0,0,0,0,0.0014004469129779713,0.07728806519102234
University of Phoenix - New Jersey,111,111,New Jersey,Large City,NA,48.07,30.23,72.9,0,0,1,0,0,0,0,0,1,0.5718345231617963,0.08135114040300091
University of Phoenix - Kentucky,18,18,Kentucky,Suburb,NA,4.7,2.16,10.73,0,0,0,0,0,0,0,0,0,0.039499620218454115,0.008580125034064977
University of Phoenix - Utah,122,122,Utah,Suburb,NA,50.74,20.64,86.22,0,0,1,0,0,1,0,0,2,0.7060082160625635,0.0
University of Pittsburgh - Bradford,1337,1229,Pennsylvania,Town,NA,96.28,83.97,99.82,2,1,4,1,1,2,3,2,6,2.1563931259937474,1.1295236331110512
University of Pittsburgh - Greensburg,1524,1436,Pennsylvania,Suburb,NA,95.9,83.07,99.8,2,1,4,1,1,2,3,2,6,3.073170625816425,0.11809950625020062
University of Pittsburgh - Johnstown,2785,2713,Pennsylvania,Suburb,NA,99.73,96.32,100.0,4,2,8,2,1,4,6,3,12,5.651736686265762,0.2688335536118584
University of Pittsburgh - Pittsburgh Campus,19329,18390,Pennsylvania,Large City,public,100.0,100.0,100.0,36,20,71,17,9,34,53,29,105,27.592312426943025,25.31781571001172
University of Portland,3888,3792,Oregon,Large City,private,100.0,99.95,100.0,9,5,19,5,2,11,14,7,30,1.7490883068941412,12.269729683453804
University of Puget Sound,2415,2390,Washington,Midsize City,NA,100.0,99.47,100.0,7,4,15,3,2,8,10,6,23,1.6281522291128916,8.499846982855068
University of Redlands,3133,2518,California,Small City,private,100.0,100.0,100.0,14,7,28,6,3,13,20,10,41,15.887266403033603,4.055839452751255
University of Rhode Island,15100,12629,Rhode Island,Suburb,NA,100.0,100.0,100.0,21,12,39,9,5,18,30,17,57,6.790991377809347,23.52531210904891
University of Richmond,3265,3035,Virginia,Midsize City,NA,100.0,99.89,100.0,9,5,18,4,2,9,13,7,27,3.345713992290998,10.354067952968414
University of Rio Grande,1755,1269,Ohio,Rural,NA,98.33,88.52,99.96,3,2,5,1,1,3,4,3,8,3.94310877644172,0.14568730341201053
University of Rochester,6542,6250,New York,Midsize City,private,100.0,100.0,100.0,16,9,31,7,4,15,23,13,46,8.568018323158917,14.585093501851066
University of Saint Francis - Fort Wayne,1906,1523,IndiaNA,Large City,NA,99.51,95.12,99.99,4,2,7,2,1,3,6,3,10,4.676168143565413,0.6443562712296644
University of Saint Mary,750,641,Kansas,Town,NA,94.61,71.89,99.91,2,1,5,1,0,2,3,1,7,0.2531163740783188,2.6507782187536257
University of San Diego,5776,5605,California,Large City,NA,100.0,100.0,100.0,26,13,54,12,6,26,38,19,80,24.746064719932523,12.940329603685063
University of San Francisco,6847,6586,California,Large City,NA,100.0,100.0,100.0,31,16,63,14,7,30,45,23,93,37.28016614020604,7.5468208064196745
University of Science and Arts of Oklahoma,881,727,Oklahoma,Town,public,93.56,66.75,99.88,2,1,4,1,0,2,3,1,6,2.397882687422146,0.3391661177734363
University of Scranton,3809,3630,Pennsylvania,Small City,private,100.0,99.97,100.0,10,6,19,5,3,9,15,9,28,3.0421284982829255,11.714821218829972
University of Sioux Falls,1214,1036,South Dakota,Midsize City,private,97.17,82.99,99.96,2,1,5,1,1,3,3,2,8,1.7705016573280943,1.7831296392136085
University of South Alabama,10986,9090,Alabama,Midsize City,public,100.0,100.0,100.0,48,23,96,23,10,47,71,33,143,45.927056784093615,25.08593412162672
University of South CaroliNA - Aiken,3352,2716,South CaroliNA,Suburb,public,100.0,100.0,100.0,32,16,64,17,8,34,49,24,98,47.25490303249352,1.4694447780369668
University of South CaroliNA - Beaufort,2078,1797,South CaroliNA,Town,NA,100.0,100.0,100.0,19,10,38,10,5,21,29,15,59,28.249874284792064,0.8894360619814249
University of South CaroliNA - Columbia,26363,25243,South CaroliNA,Midsize City,NA,100.0,100.0,100.0,183,91,364,94,45,193,277,136,557,237.63313266538464,38.712393449850296
University of South CaroliNA - Upstate,5776,4583,South CaroliNA,Suburb,public,100.0,100.0,100.0,57,28,112,29,14,60,86,42,172,84.34359923281478,1.8781853460723847
University of South Dakota,7652,4908,South Dakota,Town,public,100.0,100.0,100.0,14,8,26,7,4,13,21,12,39,15.832312782932211,5.348324671156799
University of South Florida - Main Campus,31773,24672,Florida,Large City,NA,100.0,100.0,100.0,279,147,563,136,68,281,415,215,844,407.360823294731,7.598630314869647
University of South Florida - St. Petersburg,4251,2845,Florida,Large City,NA,100.0,100.0,100.0,38,20,76,18,9,38,56,29,114,55.27389165691813,0.6041394223045495
University of Southern California,19174,18631,California,Large City,private,100.0,100.0,100.0,86,43,178,39,19,83,125,62,261,84.1512626896167,40.013740317118106
University of Southern IndiaNA,9689,6588,IndiaNA,Suburb,NA,100.0,100.0,100.0,19,11,34,9,5,17,28,16,51,25.746095185550978,1.7421069302128278
University of Southern Maine,6110,3901,Maine,Small City,NA,99.82,93.96,100.0,4,2,8,2,1,4,6,3,12,4.120903345735063,2.2106007838801864
University of Southern Mississippi,11809,10384,Mississippi,Small City,NA,100.0,100.0,100.0,104,52,201,50,24,98,154,76,299,136.63489507568985,16.726478280089825
University of St Francis,1600,1291,Illinois,Suburb,NA,96.43,82.36,99.91,2,1,5,1,1,2,3,2,7,2.227436692862564,1.0972748514014257
University of St Thomas Minnesota,6197,5945,Minnesota,Large City,NA,99.51,92.36,100.0,4,2,8,2,1,4,6,3,12,2.6158913470624574,2.683434475432798
University of St. Thomas - Houston,1815,1434,Texas,Large City,NA,100.0,100.0,100.0,21,9,50,8,3,19,29,12,69,28.830722471409693,0.43420240177615843
University of the Cumberlands,3317,1828,Kentucky,Town,NA,100.0,98.62,100.0,7,3,16,3,1,8,10,4,24,5.253449489054398,4.7879073448144895
University of the District of Columbia,3858,1830,District of Columbia,Large City,public,100.0,99.94,100.0,9,5,16,4,2,8,13,7,24,7.882504256754255,5.427876562494832
University of the IncarNAte Word,5996,4461,Texas,Large City,NA,100.0,100.0,100.0,72,31,168,26,11,63,98,42,231,97.04942322300184,1.1024121126195878
University of the Ozarks,756,747,Arkansas,Town,NA,97.97,80.29,99.99,3,1,6,1,0,3,4,1,9,0.8916791642978917,2.9831108532666453
University of the Pacific,3552,3452,California,Large City,private,100.0,100.0,100.0,17,9,35,8,4,17,25,13,52,23.538046767628128,1.602633558875611
University of the Southwest,509,417,New Mexico,Rural,NA,97.35,76.34,99.99,3,1,6,1,0,3,4,1,9,1.4759645629108167,2.1367736454774904
University of the West,185,148,California,Suburb,NA,74.32,50.47,93.75,1,0,2,0,0,1,1,0,3,1.3544443707655376,0.0
University of Toledo,16191,13056,Ohio,Large City,public,100.0,100.0,100.0,27,15,52,13,6,25,40,21,77,33.73860451301794,6.1052061785535345
University of Tulsa,3347,3203,Oklahoma,Large City,private,100.0,99.91,100.0,12,5,27,5,2,12,17,7,39,4.939977659111426,11.699664492000514
University of Utah,24637,18066,Utah,Midsize City,NA,100.0,100.0,100.0,95,34,253,47,15,136,142,49,389,113.34325344099481,29.07939344169174
University of Vermont,11341,10395,Vermont,Small City,NA,100.0,100.0,100.0,19,10,35,9,5,17,28,15,52,0.018627091979062513,27.17725368699633
University of Virginia - Main Campus,16658,15766,Virginia,Suburb,public,100.0,100.0,100.0,57,26,110,29,12,58,86,38,168,63.43200609874158,23.196839856668134
University of Washington - Bothell Campus,5365,4641,Washington,Suburb,NA,100.0,100.0,100.0,13,9,22,7,4,12,20,13,34,19.361810292153304,0.7043988433773065
University of Washington - Seattle Campus,31328,28759,Washington,Large City,public,100.0,100.0,100.0,83,51,148,43,25,80,126,76,228,95.37158372695515,30.12410116411522
University of Washington - Tacoma Campus,4436,3945,Washington,Midsize City,NA,100.0,100.0,100.0,11,7,18,6,4,10,17,11,28,16.04683368152706,0.3051647626075479
University of West Alabama,2111,1843,Alabama,Rural,NA,100.0,99.67,100.0,8,4,17,4,2,8,12,6,25,10.083319273627056,2.2780480251429225
University of West Georgia,11230,8938,Georgia,Town,public,100.0,99.99,100.0,24,7,70,11,3,35,35,10,105,32.904479146790564,1.393605482033798
University of Wisconsin - Eau Claire,10184,9476,Wisconsin,Small City,public,99.54,95.21,100.0,4,2,7,2,1,3,6,3,10,3.7648053121745537,1.6090413584903207
University of Wisconsin - Green Bay,6812,4095,Wisconsin,Midsize City,public,98.15,89.83,99.94,3,2,5,1,1,2,4,3,7,3.2353244633728067,0.7533987114186614
University of Wisconsin - La Crosse,9701,9094,Wisconsin,Small City,NA,99.65,95.79,100.0,4,2,7,2,1,4,6,3,11,4.070100644594971,1.568565472516527
University of Wisconsin - Madison,31358,28977,Wisconsin,Large City,NA,100.0,100.0,100.0,26,14,50,12,6,23,38,20,73,9.82688243266116,27.358690683958372
University of Wisconsin - Milwaukee,20356,17076,Wisconsin,Large City,NA,100.0,99.85,100.0,8,5,14,3,2,7,11,7,21,9.693882485864146,1.512824407888667
University of Wisconsin - Oshkosh,12410,7994,Wisconsin,Small City,NA,99.87,97.91,100.0,5,3,8,2,1,4,7,4,12,6.093311956476813,0.5182100041412291
University of Wisconsin - Parkside,4135,3275,Wisconsin,Suburb,NA,92.82,77.96,99.28,2,1,3,1,0,2,3,1,5,1.880639399216862,0.7511754202527103
University of Wisconsin - Platteville,7614,6723,Wisconsin,Town,NA,99.86,96.62,100.0,5,2,9,2,1,5,7,3,14,2.9703321451333022,3.5687600603953133
University of Wisconsin - River Falls,5680,5014,Wisconsin,Town,NA,95.81,82.1,99.78,2,1,4,1,1,2,3,2,6,1.3496471873833307,1.822395018922139
University of Wisconsin - Stevens Point,7896,7224,Wisconsin,Town,NA,99.14,93.18,99.99,3,2,6,1,1,3,4,3,9,3.654979598531565,1.0918991273387382
University of Wisconsin - Stout,8129,6605,Wisconsin,Town,public,99.05,92.34,99.99,3,2,6,1,1,3,4,3,9,2.616673195695789,2.032317233306751
University of Wisconsin - Superior,2373,1829,Wisconsin,Suburb,NA,80.63,57.37,96.42,1,1,2,1,0,1,2,1,3,0.6695338230804204,0.9697684566637321
University of Wisconsin - Whitewater,11128,9830,Wisconsin,Town,NA,99.94,98.55,100.0,5,3,10,2,1,4,7,4,14,4.888251832467509,2.5593159231658187
University of Wyoming,9796,8281,Wyoming,Town,NA,99.99,98.15,100.0,7,3,19,3,1,10,10,4,29,0.02230069921486946,9.739063497826264
Upper Iowa University,4275,2107,Iowa,Rural,private,100.0,99.54,100.0,9,4,21,4,2,11,13,6,32,6.384818632384503,6.50029472183453
Ursinus College,1507,1489,Pennsylvania,Suburb,private,99.51,94.29,100.0,4,2,7,2,1,3,6,3,10,1.6721359364711592,3.628019854843865
Ursuline College,620,455,Ohio,Suburb,private,77.13,54.03,93.88,1,1,2,0,0,1,1,1,3,1.3307407436508534,0.14298619328016815
Utah State University,24621,17188,Utah,Small City,public,100.0,100.0,100.0,90,32,244,46,14,133,136,46,377,109.9115905547235,26.3275678928766
Utah Valley University,36870,18404,Utah,Small City,NA,100.0,100.0,100.0,142,50,380,71,23,204,213,73,584,190.51226623766928,23.049521333516513
Utica College,3686,2901,New York,Small City,NA,100.0,99.85,100.0,8,4,13,3,2,6,11,6,19,8.73653139970799,2.261039207190206
Valdosta State University,8774,7166,Georgia,Small City,NA,100.0,99.97,100.0,19,6,56,9,2,28,28,8,84,25.691841270119184,1.9272684595703902
Valley City State University,1373,834,North Dakota,Town,NA,99.99,96.58,100.0,6,2,14,3,1,9,9,3,23,7.754392265969442,1.1836286479741955
University of Valley Forge,700,589,Pennsylvania,Suburb,NA,90.81,70.57,99.1,2,1,3,1,0,2,3,1,5,0.5939393734742855,1.7867927439918585
Valparaiso University,3228,3153,IndiaNA,Suburb,NA,99.98,98.81,100.0,6,3,12,3,1,6,9,4,18,3.5121311806105977,4.927086881979174
Vanderbilt University,6888,6805,Tennessee,Large City,NA,100.0,100.0,100.0,24,11,52,11,5,24,35,16,76,3.2537441727116754,31.222033386544666
Vanguard University of Southern California,1842,1524,California,Midsize City,NA,100.0,99.89,100.0,9,5,20,4,2,10,13,7,30,11.047873272892952,2.7696691505683066
Vassar College,2352,2334,New York,Suburb,private,99.99,99.44,100.0,7,4,13,3,2,7,10,6,20,1.7577657122791268,8.103496925090226
Villanova University,6948,6525,Pennsylvania,Suburb,NA,100.0,100.0,100.0,19,11,38,9,5,18,28,16,56,2.251588983763145,26.147791430416426
Virginia Commonwealth University,23666,20036,Virginia,Midsize City,NA,100.0,100.0,100.0,80,35,148,42,17,80,122,52,228,113.20278442048334,8.26079609970381
Virginia Military Institute,1724,1722,Virginia,Town,public,99.98,97.92,100.0,6,3,11,3,1,6,9,4,17,5.441380998451294,3.16450220452223
Virginia Tech,27189,26603,Virginia,Small City,public,100.0,100.0,100.0,87,40,164,44,19,87,131,59,251,100.09830025915517,31.07887180936461
Virginia State University,4299,3976,Virginia,Suburb,public,100.0,99.99,100.0,14,6,25,7,3,13,21,9,38,14.023636357012505,6.4558345311920515
Virginia Union University,1298,1201,Virginia,Midsize City,NA,99.68,93.66,100.0,4,2,7,2,1,4,6,3,11,3.1356220618488635,2.591521791747416
Virginia Wesleyan University,1438,1354,Virginia,Large City,NA,99.89,95.04,100.0,4,2,8,2,1,4,6,3,12,5.478147086278668,1.2828355113217353
Viterbo University,1770,1394,Wisconsin,Small City,NA,82.83,57.1,98.03,1,1,3,1,0,1,2,1,4,0.5954770345229924,1.1611640777322203
Voorhees College,475,464,South CaroliNA,Town,private,99.55,92.59,100.0,4,2,7,2,1,4,6,3,11,4.762969406778098,0.5906919084101664
Wabash College,865,864,IndiaNA,Town,NA,94.8,79.13,99.72,2,1,4,1,0,2,3,1,6,1.696004715066844,1.251128703236608
Wagner College,1797,1736,New York,Large City,NA,99.95,98.4,100.0,5,3,10,2,1,5,7,4,15,2.446345007833099,5.049954886502413
Wake Forest University,5099,5046,North CaroliNA,Midsize City,NA,100.0,100.0,100.0,16,8,33,7,3,16,23,11,49,1.5483845021826046,21.3375799155223
Walden University,7443,453,Minnesota,Large City,NA,100.0,100.0,100.0,42,21,87,20,9,42,62,30,129,0.029880378834565974,62.13336061504294
Waldorf University,2124,1482,Iowa,Town,private,100.0,99.83,100.0,9,4,20,4,2,10,13,6,30,1.1837023307229695,12.353542843778587
Walla Walla University,1650,1556,Washington,Suburb,NA,99.85,97.46,100.0,4,2,9,2,1,5,6,3,14,2.603576762770615,3.891891682445819
Walsh University,2012,1744,Ohio,Suburb,private,99.3,92.73,99.99,3,2,6,2,1,3,5,3,9,4.525454022784536,0.426073704969522
Warner Pacific College,404,396,Oregon,Large City,NA,62.38,42.62,88.13,1,0,1,0,0,1,1,0,2,0.3690059719185952,0.6063936270056539
Warner University,1003,869,Florida,Rural,NA,100.0,99.86,100.0,9,4,17,4,2,9,13,6,26,12.440368622118486,0.29179928785896186
Warren Wilson College,589,579,North CaroliNA,Suburb,private,90.12,66.72,99.39,2,1,3,1,0,2,3,1,5,0.14234931242962365,2.1630905830892986
Wartburg College,1525,1474,Iowa,Town,NA,98.31,77.27,100.0,3,1,7,1,0,4,4,1,11,3.21333334729089,0.8606513854568714
Washburn University,5877,3944,Kansas,Midsize City,NA,99.22,92.42,99.98,3,2,6,2,1,3,5,3,9,3.9385475014147358,0.912280501279854
Washington Adventist University,875,655,Maryland,Suburb,NA,97.26,84.54,99.92,2,1,5,1,1,2,3,2,7,1.266972211524259,2.3176671009362066
Washington & Jefferson College,1411,1398,Pennsylvania,Suburb,NA,97.44,85.98,99.93,3,1,5,1,1,2,4,2,7,2.0549888427176497,1.6031535130698191
Washington and Lee University,1824,1823,Virginia,Town,private,99.99,98.81,100.0,6,3,13,3,1,6,9,4,19,1.439129723528624,7.787142264340719
Washington College,1489,1456,Maryland,Town,NA,99.22,92.52,99.99,3,2,6,2,1,3,5,3,9,2.2303127383695016,2.6162583513424034
Washington State University,25279,22166,Washington,Town,NA,100.0,100.0,100.0,62,39,108,33,20,59,95,59,167,84.04785831366549,10.756854401747969
Washington University in St Louis,7673,7074,Missouri,Suburb,NA,100.0,100.0,100.0,25,12,53,11,5,24,36,17,77,1.1112060485510913,34.48028838196373
Wayland Baptist University,3563,990,Texas,Town,NA,100.0,100.0,100.0,40,17,95,15,6,36,55,23,131,53.727690389869025,1.6140073749432162
Wayne State College,2756,2404,Nebraska,Town,public,78.29,47.59,97.59,1,0,2,0,0,1,1,0,3,0.40461148689519644,1.1195943280235452
Wayne State University,17300,12389,Michigan,Large City,public,100.0,100.0,100.0,38,18,85,19,8,43,57,26,128,56.086463698464065,0.8554872116623871
Waynesburg University,1374,1330,Pennsylvania,Town,private,95.23,81.34,99.72,2,1,4,1,1,2,3,2,6,2.371618543559342,0.6679148281630666
Webber InterNAtioNAl University,626,584,Florida,Town,NA,99.97,98.61,100.0,6,3,11,3,1,6,9,4,17,8.139322140073144,0.0936595423217881
Weber State University,27106,11311,Utah,Small City,NA,100.0,100.0,100.0,103,36,279,52,16,150,155,52,429,142.48634668764294,12.935456053867295
Webster University,3080,2297,Missouri,Suburb,private,99.99,97.88,100.0,6,3,15,3,1,7,9,4,22,3.5257425559167803,5.612223248991962
Wellesley College,2513,2374,Massachusetts,Suburb,private,100.0,99.61,100.0,7,4,15,3,2,7,10,6,22,1.2983720824268903,9.503737166329172
Wells College,486,481,New York,Rural,NA,79.69,58.79,94.91,1,1,2,0,0,1,1,1,3,0.9849298784506182,0.6049086592140145
Wentworth Institute of Technology,4263,3904,Massachusetts,Large City,private,100.0,99.96,100.0,10,5,18,5,2,9,15,7,27,11.885425751265174,2.5303599666352943
Wesley College,1447,1303,Delaware,Small City,private,99.33,93.37,99.99,3,2,7,2,1,3,5,3,10,0.26224401709624084,4.729769326606706
Wesleyan College,565,431,Georgia,Midsize City,NA,90.57,58.21,99.82,2,1,4,1,0,2,3,1,6,1.2724662090433112,1.0811135370282794
Wesleyan University,2975,2896,Connecticut,Small City,private,100.0,99.84,100.0,9,5,17,4,2,8,13,7,25,0.09900024882448961,12.350678757691652
West Chester University of Pennsylvania,14450,13020,Pennsylvania,Suburb,NA,100.0,100.0,100.0,27,15,52,12,7,25,39,22,77,24.97442633828459,14.203520336797402
West Liberty University,2174,1869,West Virginia,Rural,NA,86.76,64.21,97.85,1,1,3,1,0,1,2,1,4,0.34674079676610375,1.6718653392796947
West Texas A&M University,7393,5615,Texas,Town,public,100.0,100.0,100.0,85,36,199,31,13,74,116,49,273,113.77628553148735,2.252797395609799
West Virginia State University,3754,1786,West Virginia,Suburb,NA,97.11,82.39,99.91,2,1,5,1,1,2,3,2,7,0.7058974423747438,2.827082397920704
West Virginia University,22507,20712,West Virginia,Small City,public,100.0,100.0,100.0,32,17,62,15,7,31,47,24,93,2.319280563785775,44.94026136967592
West Virginia University Institute of Technology,1621,1111,West Virginia,Small City,public,68.65,42.38,89.88,1,0,2,0,0,1,1,0,3,0.3307130646239206,0.8255244246279261
West Virginia Wesleyan College,1322,1289,West Virginia,Town,private,84.75,61.71,97.36,1,1,2,1,0,1,2,1,3,0.18984961593769092,1.6857837710017476
Western CaroliNA University,9408,8040,North CaroliNA,Town,NA,100.0,99.97,100.0,12,6,26,5,2,12,17,8,38,11.683386963563452,5.405518198320202
Western Connecticut State University,5082,4089,Connecticut,Small City,NA,97.48,89.99,99.83,3,2,4,1,1,2,4,3,6,2.146084833162651,1.530942279356456
Western Governors University,72383,72385,Utah,Suburb,NA,100.0,100.0,100.0,298,137,666,132,57,307,430,194,973,38.240182719191964,392.2962918866256
Western Illinois University,7596,6668,Illinois,Town,NA,100.0,99.87,100.0,9,5,17,4,2,8,13,7,25,11.496396846471642,0.8313027926092037
Western InterNAtioNAl University,593,597,ArizoNA,Midsize City,NA,98.06,85.14,99.98,3,1,6,1,1,3,4,2,9,1.150717307419085,2.770519160307315
Western Kentucky University,17655,12919,Kentucky,Small City,NA,100.0,100.0,100.0,34,15,82,16,7,40,50,22,122,38.24616560352184,12.16590421311814
Western Michigan University,17938,15063,Michigan,Small City,NA,100.0,100.0,100.0,39,19,85,19,8,43,58,27,128,52.370563142063425,4.962312903988046
Western New England University,2737,2613,Massachusetts,Midsize City,private,99.95,98.6,100.0,5,3,9,2,1,5,7,4,14,4.806105183803145,2.7532010332870795
Western New Mexico University,2170,1266,New Mexico,Town,public,100.0,98.72,100.0,9,3,22,4,1,11,13,4,33,9.146894574994024,3.3224585039439285
Western Oregon University,4758,4065,Oregon,Town,public,99.98,99.47,100.0,6,4,10,3,2,5,9,6,15,6.19634828045705,2.1045386754216735
Western Colorado University,2427,1832,Colorado,Town,NA,99.6,89.74,100.0,4,2,10,2,1,4,6,3,14,1.7101297714831054,3.7868809215684784
Western Washington University,14961,13728,Washington,Small City,NA,100.0,100.0,100.0,36,23,64,19,11,36,55,34,100,49.55229971171735,5.070518382121183
Westfield State University,5585,4800,Massachusetts,Suburb,NA,100.0,100.0,100.0,15,9,28,7,4,14,22,13,42,22.229832834207283,0.3677726997874503
Westminster College Missouri,765,760,Missouri,Town,NA,86.78,56.79,99.22,1,1,3,1,0,1,2,1,4,1.0021624643474796,1.0143622010711597
Westminster College Pennsylvania,1193,1170,Pennsylvania,Town,private,93.84,77.8,99.56,2,1,4,1,0,2,3,1,6,1.7093864895113582,1.0729335895771879
Westminster College Utah,2033,1906,Utah,Midsize City,NA,100.0,98.45,100.0,7,3,19,4,1,10,11,4,29,6.666569384459615,4.482957173861608
Westmont College,1295,1294,California,Suburb,private,99.98,98.54,100.0,6,3,12,3,1,6,9,4,18,6.655080719058777,1.8139552009408704
Wheaton College Illinois,2386,2310,Illinois,Suburb,private,99.99,98.68,100.0,6,3,13,3,1,6,9,4,19,0.8203868946247331,8.000189659649592
Wheaton College Massachusetts,1686,1675,Massachusetts,Suburb,private,99.39,93.48,100.0,3,2,7,2,1,3,5,3,10,2.588230249559178,2.501554275862669
Wheeling Jesuit University,721,670,West Virginia,Small City,NA,75.58,52.09,93.48,1,1,2,0,0,1,1,1,3,0.05124359431374059,1.3556067597440302
Boston University Wheelock College of Education and Human Development,613,593,Massachusetts,Large City,NA,86.91,67.36,97.79,1,1,3,1,0,1,2,1,4,1.583588244796076,0.44496842700489136
Whitman College,1512,1455,Washington,Small City,NA,99.81,96.65,100.0,4,2,8,2,1,4,6,3,12,2.068193372116376,4.162078593412017
Whittier College,1684,1640,California,Suburb,NA,100.0,99.66,100.0,8,4,16,4,2,8,12,6,24,9.22486436305177,1.993323698077939
Whitworth University,2252,2211,Washington,Suburb,private,99.99,99.26,100.0,6,3,13,3,2,7,9,5,20,4.833118553988268,4.057587962101199
Wichita State University,12403,8749,Kansas,Large City,NA,100.0,99.69,100.0,8,4,14,3,2,7,11,6,21,8.346459259523721,2.7289697299394233
Widener University,3438,2919,Pennsylvania,Suburb,private,100.0,99.9,100.0,9,5,17,4,2,8,13,7,25,3.9133775443898045,8.640752327549217
Wilberforce University,613,489,Ohio,Rural,private,86.71,63.18,98.61,1,1,3,1,0,1,2,1,4,0.44435982652664696,1.5688493612758436
Wiley College,1325,1188,Texas,Town,NA,100.0,99.93,100.0,12,5,28,5,2,11,17,7,39,14.121170190078216,2.7788466086932138
Wilkes University,2489,2233,Pennsylvania,Small City,NA,99.92,98.06,100.0,5,3,9,2,1,5,7,4,14,3.925794395403204,3.1972187413684914
Willamette University,1950,1901,Oregon,Midsize City,private,99.96,98.52,100.0,5,3,11,3,1,6,8,4,17,0.8014809710071887,7.07289764200872
William Carey University,3099,1676,Mississippi,Small City,private,100.0,100.0,100.0,28,14,55,14,7,27,42,21,82,38.76842925071869,3.130014327240399
William Jewell College,922,909,Missouri,Suburb,NA,86.74,55.46,99.29,1,1,3,1,0,2,2,1,5,0.9502369480600453,1.0636171454789483
William Paterson University of New Jersey,8839,7285,New Jersey,Suburb,NA,100.0,100.0,100.0,41,23,82,19,10,40,60,33,122,59.76704202926003,0.623767929045611
William Penn University,1284,1068,Iowa,Town,NA,99.55,88.84,100.0,4,2,9,2,1,4,6,3,13,1.7934883798832872,3.596608277030533
William Woods University,959,794,Missouri,Town,NA,88.56,61.1,99.38,1,1,3,1,0,2,2,1,5,1.0869741409502887,1.0774705267845335
Williams Baptist College,492,447,Arkansas,Rural,NA,68.71,37.87,93.22,1,0,2,0,0,1,1,0,3,0.7332770772270089,0.4250979192524319
Williams College,2073,2047,Massachusetts,Town,private,99.99,99.08,100.0,6,3,12,3,1,6,9,4,18,1.200462056538961,7.772664747689016
Wilmington College,1168,1098,Ohio,Town,NA,94.55,78.59,99.61,2,1,4,1,0,2,3,1,6,2.4790600848328728,0.42653982870950174
Wilmington University,8441,3035,Delaware,Suburb,private,100.0,99.58,100.0,7,4,13,3,2,6,10,6,19,4.411978569316334,5.69234172407329
Wilson College,827,565,Pennsylvania,Small City,NA,86.24,65.76,97.85,1,1,3,1,0,1,2,1,4,1.2023650731308706,0.7783294897890299
Wingate University,2588,2537,North CaroliNA,Suburb,NA,99.73,94.1,100.0,4,2,9,2,1,4,6,3,13,2.9275613310998074,2.956375062902984
WinoNA State University,7463,6522,Minnesota,Town,public,99.15,91.73,99.99,3,2,7,1,1,3,4,3,10,2.4974563909545413,2.2712801344049023
Winston - Salem State University,4688,4072,North CaroliNA,Midsize City,NA,99.99,98.48,100.0,6,3,13,3,1,6,9,4,19,5.569081119298579,3.2339875573210057
Winthrop University,5014,4488,South CaroliNA,Small City,public,100.0,100.0,100.0,48,24,96,25,12,51,73,36,147,72.00672765460266,1.4234741454053403
Wisconsin Lutheran College,992,921,Wisconsin,Large City,NA,79.02,56.61,95.55,1,1,2,0,0,1,1,1,3,0.38287863471867534,1.172819729821112
Wittenberg University,1860,1775,Ohio,Small City,NA,99.21,91.85,99.99,3,2,7,2,1,3,5,3,10,3.1479385605519306,1.681965072956712
Wofford College,1679,1663,South CaroliNA,Small City,private,100.0,99.99,100.0,12,6,24,6,3,13,18,9,37,15.631909430114348,2.4619966742547192
Woodbury University,1023,923,California,Large City,private,99.92,97.52,100.0,5,3,10,2,1,5,7,4,15,6.874720346750485,0.2570673018033342
Worcester Polytechnic Institute,4435,4301,Massachusetts,Midsize City,NA,100.0,99.97,100.0,11,6,20,5,3,10,16,9,30,8.858728864033964,6.54452081974337
Worcester State University,5496,4153,Massachusetts,Midsize City,NA,100.0,100.0,100.0,16,9,29,7,4,14,23,13,43,22.493764208339964,0.4037010569903239
Wright State University - Main Campus,12120,9423,Ohio,Suburb,public,100.0,100.0,100.0,20,11,37,9,5,18,29,16,55,27.508211997928534,1.3763399970121426
Xavier University,4629,4370,Ohio,Large City,private,100.0,99.89,100.0,9,5,18,4,2,9,13,7,27,5.743935441839184,7.435176485277897
Xavier University of LouisiaNA,2289,2155,LouisiaNA,Large City,NA,100.0,99.95,100.0,12,5,25,5,2,12,17,7,37,7.620162120868652,8.987034110806333
Yale University,5751,5743,Connecticut,Midsize City,NA,100.0,100.0,100.0,19,10,39,9,4,18,28,14,57,0.18967337391607825,27.470874459870974
Yeshiva University,2755,2646,New York,Large City,NA,100.0,99.89,100.0,9,5,17,4,2,8,13,7,25,3.3121535735507512,9.277918042332702
York College,431,398,Nebraska,Town,NA,66.89,37.09,95.17,1,0,2,0,0,1,1,0,3,0.023082424634781773,1.0764160353635062
York College of Pennsylvania,4169,3814,Pennsylvania,Suburb,NA,100.0,99.9,100.0,9,5,16,4,2,8,13,7,24,4.134811387462099,8.37998654010171
Youngstown State University,11272,8834,Ohio,Small City,NA,100.0,100.0,100.0,18,10,34,8,4,16,26,14,50,23.63058782750127,3.027480853431151
