school,real_size,size,state,setting,status,meanprob,lowprob,highprob,meaNActive,lowactive,highactive,meanincub,lowincub,highincub,meantot,lowtot,hightot,instate,outstate
Abilene Christian University,3669,3508,Texas,Midsize City,private,100.0,100.0,100.0,15,7,33,7,3,15,22,10,48,21.527510451284794,0.7503731525498005
Adams State University,1956,1514,Colorado,Town,NA,80.25,52.17,97.71,1,1,3,0,0,1,1,1,4,0.6589700195080896,0.9612506957398074
Adelphi University,5269,4874,New York,Suburb,private,99.89,98.59,100.0,5,3,8,2,1,3,7,4,11,5.724579760302761,1.079209676853222
Adrian College,1673,1606,Michigan,Town,private,82.48,62.2,96.82,1,1,2,1,0,1,2,1,3,1.422484822335828,0.3183206841038128
Agnes Scott College,923,913,Georgia,Suburb,private,72.48,42.91,95.52,1,0,2,0,0,1,1,0,3,0.4972634609435075,0.7908849398971985
Alabama A & M University,5032,4714,Alabama,Midsize City,public,99.92,96.47,100.0,5,2,11,2,1,4,7,3,15,4.825093821368715,2.261463011327927
Alabama State University,4212,3866,Alabama,Midsize City,NA,99.88,96.16,100.0,5,2,10,2,1,4,7,3,14,3.969221184327416,2.7664875701968534
Alaska Pacific University,298,203,Alaska,Large City,private,26.39,15.34,45.25,0,0,0,0,0,0,0,0,0,0.0016431527649826139,0.30398975573208104
Albany State University,6266,3927,Georgia,Small City,NA,99.65,86.32,100.0,4,1,11,2,1,5,6,2,16,4.767503454599631,0.8899751172827585
Albertus Magnus College,1130,1012,Connecticut,Midsize City,NA,43.89,31.84,61.28,0,0,1,0,0,0,0,0,1,0.30631537437022566,0.27115574312168106
Albion College,1565,1554,Michigan,Town,NA,80.71,60.18,96.21,1,1,2,0,0,1,1,1,3,1.462297181206044,0.18256137000538056
Albright College,2019,1993,Pennsylvania,Small City,NA,94.29,80.83,99.44,2,1,4,1,0,2,3,1,6,1.2422205934350028,1.6177524232813851
Alcorn State University,3169,2893,Mississippi,Rural,NA,100.0,99.66,100.0,8,4,16,3,2,6,11,6,22,10.032907545618091,1.3253618126275812
Alderson Broaddus University,950,903,West Virginia,Town,private,30.07,17.18,48.06,0,0,0,0,0,0,0,0,0,0.04990131338027161,0.3075655125734311
Alfred University,1704,1600,New York,Town,NA,88.58,73.97,97.35,2,1,3,1,0,1,3,1,4,1.6322605667115144,0.5360598420013966
Alice Lloyd College,598,584,Kentucky,Rural,private,44.44,23.19,73.8,0,0,1,0,0,0,0,0,1,0.4951825865482924,0.09224862643921665
Allegheny College,1800,1752,Pennsylvania,Town,NA,89.34,73.23,98.2,2,1,3,1,0,1,3,1,4,0.9459204354927194,1.290272144525207
Allen University,590,563,South CaroliNA,Midsize City,private,81.33,53.32,96.71,1,1,2,0,0,1,1,1,3,1.5631284602246944,0.11253478867399398
Alma College,1427,1386,Michigan,Town,NA,79.11,58.12,95.67,1,1,2,0,0,1,1,1,3,1.462297181206044,0.10277589025362276
Alvernia University,2252,1670,Pennsylvania,Small City,NA,94.54,81.77,99.46,2,1,4,1,0,2,3,1,6,1.5935042858408028,1.3126391897885734
Alverno College,1312,1036,Wisconsin,Large City,NA,25.65,17.76,38.4,0,0,0,0,0,0,0,0,0,0.227264221789813,0.06893737376462203
American InterContinental University - Atlanta,1905,932,Georgia,Midsize City,private,81.6,45.12,99.1,1,0,3,0,0,1,1,0,4,1.352109635374481,0.33981400830394254
American InterNAtioNAl College,1374,1254,Massachusetts,Midsize City,private,88.94,72.15,98.1,2,1,3,1,0,1,3,1,4,1.5178960608810306,0.6812259054749631
American Jewish University,68,63,California,Large City,NA,19.56,11.44,33.89,0,0,0,0,0,0,0,0,0,0.18354059017932456,0.03368797043247061
American Public University System,37910,2914,West Virginia,Town,NA,100.0,100.0,100.0,56,28,116,24,12,51,80,40,167,0.04817063199136046,80.1360941623529
American University,8124,7764,District of Columbia,Large City,NA,100.0,99.97,100.0,10,6,19,4,2,8,14,8,27,0.18777645369985455,14.377876910399658
Amherst College,1832,1836,Massachusetts,Suburb,private,97.72,87.97,99.92,3,1,5,1,1,2,4,2,7,0.4362224050126239,3.3388838469364894
Amridge University,321,147,Alabama,Midsize City,NA,55.7,34.23,81.07,1,0,1,0,0,0,1,0,1,0.24006183721890084,0.5723632403138194
Anderson University IndiaNA,1565,1431,IndiaNA,Small City,NA,72.95,54.75,89.99,1,1,2,0,0,1,1,1,3,0.8063658835061187,0.4999634169834768
Anderson University South CaroliNA,2984,2550,South CaroliNA,Small City,private,99.98,98.17,100.0,6,3,12,2,1,5,8,4,17,7.796264675583497,0.9271551158159088
Andrews University,1704,1344,Michigan,Town,NA,95.54,81.92,99.78,2,1,4,1,1,2,3,2,6,0.48205234523937285,2.62319067229112
Angelo State University,8721,5332,Texas,Midsize City,NA,100.0,100.0,100.0,41,20,87,18,8,40,59,28,127,58.412355944533275,0.217135840726031
AnNA Maria College,1121,866,Massachusetts,Rural,NA,85.37,67.09,96.89,1,1,2,1,0,1,2,1,3,1.750811191159264,0.16960767130147328
Antioch University - Seattle,90,17,Washington,Large City,NA,16.22,9.31,28.55,0,0,0,0,0,0,0,0,0,0.003919495017147744,0.1727168392507849
Appalachian State University,17014,16071,North CaroliNA,Town,public,100.0,99.69,100.0,8,4,17,3,2,7,11,6,24,7.838098544474572,3.8520174735609563
AquiNAs College Michigan,1553,1317,Michigan,Midsize City,NA,80.7,60.08,96.28,1,1,2,0,0,1,1,1,3,1.5333138213529158,0.1108760377776849
Arcadia University,2387,2177,Pennsylvania,Suburb,NA,95.6,83.45,99.67,2,1,4,1,1,2,3,2,6,1.423462614444372,1.6985371103720897
ArizoNA Christian University,784,646,ArizoNA,Large City,NA,89.99,73.84,98.24,2,1,3,1,0,1,3,1,4,1.896724050683364,0.40088496922864836
ArizoNA State University - Tempe,42429,38814,ArizoNA,Midsize City,NA,100.0,100.0,100.0,83,48,146,33,20,59,116,68,205,83.0064805319061,33.4929462197666
Arkansas Baptist College,597,496,Arkansas,Midsize City,NA,63.9,38.92,88.44,1,0,2,0,0,1,1,0,3,0.18293237834701875,0.8339381870575798
Arkansas State University - Main Campus,9608,6894,Arkansas,Small City,public,99.8,91.61,100.0,5,2,10,2,1,4,7,3,14,4.546267281006779,1.6553222229812286
Arkansas Tech University,10780,6729,Arkansas,Town,public,99.87,92.64,100.0,5,2,11,2,1,4,7,3,15,5.483729440188023,1.1443005851615113
Armstrong State University,6283,4513,Georgia,Midsize City,public,99.59,84.55,100.0,4,1,11,1,0,4,5,1,15,4.807412239587071,0.6792058658397848
Asbury University,1731,1325,Kentucky,Town,NA,90.17,68.32,99.29,2,1,3,1,0,1,3,1,4,0.8720826929089359,1.4443839257247797
Ashford University,31543,31545,California,Large City,private,100.0,100.0,100.0,48,24,98,20,10,43,68,34,141,5.480522022754632,62.603319064585826
Ashland University,4812,3380,Ohio,Town,NA,97.11,85.89,99.86,3,1,5,1,1,2,4,2,7,3.0684844165914718,0.47333783747782804
Assumption College,2085,1937,Massachusetts,Midsize City,private,96.26,84.67,99.75,2,1,4,1,1,2,3,2,6,2.4377134397764277,0.8441868053171427
Point University,1925,1119,Georgia,Town,NA,85.82,51.61,99.48,1,1,4,1,0,2,2,1,6,1.385633014763931,0.5659375192824507
Auburn University,23968,21762,Alabama,Small City,public,100.0,100.0,100.0,33,16,68,13,6,28,46,22,96,20.005650124012377,25.57877439894415
Auburn University at Montgomery,4312,3239,Alabama,Midsize City,NA,99.86,95.31,100.0,5,2,10,2,1,4,7,3,14,6.020929805527463,0.5281114932305382
Augsburg University,2428,2033,Minnesota,Large City,NA,56.27,37.82,78.51,1,0,1,0,0,0,1,0,1,0.40664761221251805,0.41965431383506213
AugustaNA College,2650,2637,Illinois,Small City,NA,78.58,61.76,93.95,1,1,2,0,0,1,1,1,3,1.239881597014362,0.3002737717611554
AugustaNA University,1746,1679,South Dakota,Midsize City,NA,61.72,41.55,82.64,1,0,1,0,0,1,1,0,2,0.5536246535153361,0.406076678557026
Aurora University,3935,3461,Illinois,Suburb,private,93.15,80.98,99.24,2,1,3,1,0,1,3,1,4,1.8373762631618002,0.8418851917356858
Austin College,1218,1204,Texas,Small City,NA,99.95,97.31,100.0,5,3,11,2,1,5,7,4,16,7.450520858495908,0.18421543557802061
Austin Peay State University,9591,7065,Tennessee,Midsize City,NA,99.99,97.17,100.0,7,3,17,3,1,7,10,4,24,8.904375408390637,0.7443799292182992
Ave Maria University,1071,1035,Florida,Rural,NA,97.84,87.95,99.96,3,1,5,1,1,2,4,2,7,2.9754987778120436,0.8497834034059164
Averett University,929,890,Virginia,Town,NA,83.69,59.52,96.8,1,1,2,1,0,1,2,1,3,0.931799180617711,0.8786215138331152
Averett University - Non - TraditioNAl Programs,344,87,Virginia,Town,NA,47.29,25.24,68.96,0,0,1,0,0,0,0,0,1,0.6397982397854144,0.0
Avila University,1274,1077,Missouri,Large City,NA,74.07,47.46,94.78,1,0,2,0,0,1,1,0,3,0.477676130522299,0.8697794428163074
Azusa Pacific University,5674,5075,California,Suburb,private,100.0,100.0,100.0,12,7,23,5,3,10,17,10,33,15.578925294421069,2.0702863192258394
Bacone College,936,864,Oklahoma,Town,private,88.53,64.99,99.01,2,1,3,1,0,1,3,1,4,0.46157123987186105,1.6987084460946262
Baker University,1774,1062,Kansas,Town,NA,78.38,52.27,96.28,1,1,2,0,0,1,1,1,3,0.2003226230592177,1.3283547299342209
Baldwin Wallace University,3191,2958,Ohio,Suburb,NA,93.01,77.17,99.3,2,1,4,1,0,1,3,1,5,1.8386116230474034,0.8206788635973643
Ball State University,17000,15203,IndiaNA,Small City,NA,100.0,99.96,100.0,9,6,15,4,2,6,13,8,21,10.472311331648118,1.8647692204276602
Bard College,1941,1862,New York,Town,NA,96.32,84.91,99.78,2,1,4,1,1,2,3,2,6,0.697610234681821,2.600976399403995
BarNArd College,2549,2514,New York,Large City,NA,99.26,93.84,99.99,3,2,6,1,1,3,4,3,9,1.1090528907001487,3.7839339073428975
Barry University,3504,2991,Florida,Suburb,NA,100.0,99.98,100.0,11,6,21,5,3,9,16,9,30,13.649020327266449,1.9081895799753477
Barton College,888,830,North CaroliNA,Town,private,47.4,27.19,72.75,0,0,1,0,0,0,0,0,1,0.37324278783212245,0.26867251294040767
Bates College,1788,1787,Maine,Small City,NA,91.46,74.6,98.96,2,1,3,1,0,1,3,1,4,0.06222299135289635,2.395237109110383
Bay Path University,1946,1367,Massachusetts,Suburb,NA,94.06,80.54,99.37,2,1,4,1,0,2,3,1,6,2.423896440522634,0.3972252846000241
Baylor University,14311,14100,Texas,Midsize City,private,100.0,100.0,100.0,57,28,121,25,12,56,82,40,177,77.85589986684207,4.284566931193248
Beacon College,349,344,Florida,Suburb,private,61.28,41.07,84.03,1,0,1,0,0,1,1,0,2,0.6111501639074529,0.33553342358089916
Becker College,1885,1530,Massachusetts,Midsize City,private,94.61,81.04,99.51,2,1,4,1,0,2,3,1,6,2.433765725703915,0.4841324687562637
Belhaven University,2479,1248,Mississippi,Midsize City,private,99.95,97.89,100.0,5,3,11,2,1,5,7,4,16,2.9350726288234448,4.654458713732376
Bellarmine University,2539,2410,Kentucky,Large City,NA,91.1,68.6,99.52,2,1,4,1,0,2,3,1,6,1.6870289335238382,0.730572941280988
Bellevue University,5743,4919,Nebraska,Suburb,NA,96.56,82.76,99.89,2,1,5,1,1,2,3,2,7,0.4022166165445516,2.961113265528312
Belmont Abbey College,1552,1381,North CaroliNA,Suburb,private,84.19,61.17,97.5,1,1,3,1,0,1,2,1,4,0.46079356522484255,1.381054112882948
Belmont University,6496,6161,Tennessee,Large City,NA,100.0,99.6,100.0,8,4,17,3,2,7,11,6,24,1.9155103369163018,9.57339019996788
Beloit College,1407,1346,Wisconsin,Small City,NA,70.83,50.26,90.37,1,0,2,0,0,1,1,0,3,0.05361386230629244,1.1767528234508675
Bemidji State University,4819,3333,Minnesota,Town,NA,73.03,52.35,91.96,1,1,2,0,0,1,1,1,3,0.8609188692587201,0.44865009600778494
Benedict College,2089,2077,South CaroliNA,Midsize City,NA,99.17,89.72,99.99,3,2,7,1,1,3,4,3,10,3.316803571592482,1.4715768634791369
Benedictine College,2080,1821,Kansas,Town,NA,87.19,64.96,98.6,1,1,3,1,0,1,2,1,4,0.1047061528904637,1.9463389500442903
Benedictine University,2883,2473,Illinois,Suburb,private,82.47,67.22,95.34,1,1,2,1,0,1,2,1,3,1.4392246296377917,0.30118035493069056
Bennett College,490,400,North CaroliNA,Large City,private,42.27,26.11,63.94,0,0,1,0,0,0,0,0,1,0.0901107416439692,0.45883813447579885
Bennington College,775,724,Vermont,Town,NA,75.55,54.74,92.81,1,1,2,0,0,1,1,1,3,4.019443306424634e-05,1.4061800340148334
Bentley University,4270,4171,Massachusetts,Small City,private,99.9,98.08,100.0,5,3,9,2,1,4,7,4,13,3.7009819429804063,3.2455272842089298
Berea College,1668,1615,Kentucky,Town,NA,84.78,58.55,98.34,1,1,3,1,0,1,2,1,4,0.7848744236180424,1.0957022555389029
Berry College,1976,1945,Georgia,Suburb,private,92.32,66.42,99.82,2,1,4,1,0,2,3,1,6,1.1421894263405445,1.4207290906085335
Bethany College Kansas,777,710,Kansas,Town,NA,56.29,32.33,83.15,1,0,1,0,0,1,1,0,2,0.09142123198950337,0.7339998294515601
Bethany College West Virginia,598,594,West Virginia,Rural,private,46.88,30.08,69.07,0,0,1,0,0,0,0,0,1,0.0100235297107771,0.6216700002731264
Bethany Lutheran College,651,522,Minnesota,Small City,NA,23.06,13.25,40.46,0,0,0,0,0,0,0,0,0,0.09408099632450226,0.1677852951460584
Bethel College - Mishawaka,1330,1044,IndiaNA,Small City,NA,66.31,48.33,86.09,1,0,1,0,0,1,1,0,2,0.6775423183518597,0.40981685459191
Bethel College - North Newton,502,489,Kansas,Town,NA,28.83,14.88,51.28,0,0,0,0,0,0,0,0,0,0.0632781758703637,0.27617401877946657
Bethel University Minnesota,2898,2407,Minnesota,Suburb,NA,62.34,42.31,85.71,1,0,1,0,0,1,1,0,2,0.4251139234745588,0.55065870459539
Bethel University Tennessee,4830,3454,Tennessee,Town,NA,99.85,93.75,100.0,5,2,11,2,1,4,7,3,15,4.089104289923274,2.3938535131923553
Bethune - Cookman University,3988,3755,Florida,Small City,private,100.0,100.0,100.0,13,7,26,6,3,12,19,10,38,16.655385274972808,2.164349729289756
Biola University,4047,3882,California,Suburb,private,100.0,99.93,100.0,9,5,17,4,2,7,13,7,24,11.269392237010528,1.5129231894218336
Birmingham Southern College,1287,1272,Alabama,Midsize City,NA,90.63,67.3,99.34,2,1,4,1,0,1,3,1,5,1.076550599205257,1.2873208038110655
Black Hills State University,3951,2195,South Dakota,Town,NA,94.03,79.19,99.66,2,1,4,1,0,2,3,1,6,2.345085220187137,0.47235503128757345
Blackburn College,557,546,Illinois,Town,private,29.73,19.35,48.19,0,0,0,0,0,0,0,0,0,0.2725601786540192,0.08002894550915203
Bloomfield College,1839,1700,New Jersey,Suburb,NA,98.84,91.2,99.98,3,2,6,1,1,2,4,3,8,4.443224644948144,0.008597309230233711
Bloomsburg University of Pennsylvania,8578,7863,Pennsylvania,Small City,public,100.0,99.76,100.0,7,4,13,3,2,5,10,6,18,7.542926357513526,2.5859725958725037
Blue Mountain College,590,531,Mississippi,Rural,NA,84.1,59.28,97.33,1,1,3,1,0,1,2,1,4,1.5854270432702817,0.2498860364255762
Bluefield College,949,829,Virginia,Town,NA,80.57,53.7,95.43,1,1,2,0,0,1,1,1,3,1.2647174507386099,0.3715108546032241
Bluefield State College,1380,1099,West Virginia,Town,NA,27.01,13.46,44.07,0,0,0,0,0,0,0,0,0,0.0914376667141393,0.2231337517563564
Bluffton University,735,660,Ohio,Town,NA,42.6,26.65,64.42,0,0,1,0,0,0,0,0,1,0.40972805831955245,0.14507096234832464
Boise State University,20744,12477,Idaho,Midsize City,public,100.0,100.0,100.0,21,9,50,9,4,24,30,13,74,15.979128379177842,14.058587346954994
Boston College,9924,9681,Massachusetts,Small City,private,100.0,100.0,100.0,13,7,23,5,3,10,18,10,33,5.10242043872232,12.719242948547999
Boston University,18086,16840,Massachusetts,Large City,private,100.0,100.0,100.0,24,14,45,10,6,19,34,20,64,7.958591570185066,26.54594006847429
Bowdoin College,1819,1813,Maine,Town,private,94.85,80.51,99.67,2,1,4,1,0,2,3,1,6,0.06791003894966645,2.8929916617305227
Bowie State University,5185,4389,Maryland,Suburb,NA,99.63,96.43,99.99,4,2,7,2,1,3,6,3,10,4.779593544655693,0.8249104191972878
Bowling Green State University - Main Campus,14679,13104,Ohio,Town,public,100.0,99.79,100.0,8,4,15,3,2,6,11,6,21,8.757162550671847,2.4180910001585123
Bradley University,4645,4512,Illinois,Midsize City,NA,94.22,83.2,99.41,2,1,4,1,1,1,3,2,5,2.1190217811042866,0.7300310371910856
Brandeis University,3630,3620,Massachusetts,Small City,NA,99.87,97.71,100.0,5,3,9,2,1,4,7,4,13,1.6975170511803463,4.906498124437189
BreNAu University,1737,1080,Georgia,Small City,NA,79.05,41.77,98.75,1,0,3,0,0,1,1,0,4,1.2842647008958323,0.2777276857858675
Brescia University,1177,715,Kentucky,Small City,NA,67.94,40.82,92.47,1,0,2,0,0,1,1,0,3,0.9382406903020276,0.19879915384385355
Brevard College,673,656,North CaroliNA,Town,NA,65.65,41.12,89.08,1,0,2,0,0,1,1,0,3,0.18482941894018684,0.8817925781203848
Brewton - Parker College,782,438,Georgia,Rural,NA,72.63,45.4,95.36,1,0,2,0,0,1,1,0,3,0.5012543394422515,0.7918294824910552
Briar Cliff University,943,720,Iowa,Small City,NA,68.32,42.9,91.74,1,0,2,0,0,1,1,0,3,0.29704903966732027,0.8503883794338233
Bridgewater College,1880,1876,Virginia,Suburb,private,95.86,77.67,99.7,2,1,4,1,0,2,3,1,6,2.7879580274370235,0.394420707936116
Bridgewater State University,9562,7858,Massachusetts,Suburb,NA,100.0,100.0,100.0,13,8,24,5,3,10,18,11,34,18.242386729079954,0.3437185086292125
Brigham Young University - Hawaii,3138,2702,Hawaii,Town,private,99.85,95.98,100.0,5,2,10,2,1,4,7,3,14,0.0006992375010685712,6.496915263017763
Brigham Young University - Idaho,51883,17230,Idaho,Town,NA,100.0,100.0,100.0,73,36,158,31,15,72,104,51,230,11.263199933363595,92.55520616912617
Brigham Young University - Provo,31232,28156,Utah,Midsize City,NA,100.0,100.0,100.0,48,22,105,20,9,47,68,31,152,18.528262307685395,49.3353841851022
Brown University,6986,6666,Rhode Island,Midsize City,NA,100.0,99.96,100.0,10,6,18,4,2,8,14,8,26,0.14573316478160112,13.763296149476842
Bryan College - Dayton,1238,833,Tennessee,Town,NA,82.25,53.17,97.99,1,1,3,0,0,1,1,1,4,0.7330359742195068,0.9932759905821712
Bryant University,3476,3418,Rhode Island,Suburb,private,99.18,93.81,99.98,3,2,6,1,1,3,4,3,9,0.12614280492571375,4.677289002383853
Bryn Athyn College of the New Church,329,313,Pennsylvania,Suburb,private,32.12,20.4,50.18,0,0,0,0,0,0,0,0,0,0.23215270106818087,0.1549787634320624
Bryn Mawr College,1340,1325,Pennsylvania,Suburb,NA,93.37,77.81,99.41,2,1,4,1,0,2,3,1,6,0.19142415702113158,2.516918865671858
Bucknell University,3608,3585,Pennsylvania,Town,private,99.65,96.05,100.0,4,2,7,2,1,3,6,3,10,0.8838094058209692,4.7644049707717615
BueNA Vista University,1805,1522,Iowa,Town,private,76.04,46.74,96.66,1,0,2,0,0,1,1,0,3,1.001588428621862,0.4259797635357381
Butler University,4288,4182,IndiaNA,Large City,NA,97.04,87.76,99.82,3,1,4,1,1,2,4,2,6,1.5820926488133866,1.9353069373190805
Cabrini University,1687,1479,Pennsylvania,Suburb,private,90.78,74.68,98.67,2,1,3,1,0,1,3,1,4,0.9214833090644898,1.4597071773793426
Caldwell University,1605,1440,New Jersey,Suburb,NA,97.45,86.71,99.89,3,1,5,1,1,2,4,2,7,3.424581440320294,0.24031845206973634
California Baptist University,7421,6367,California,Large City,NA,100.0,100.0,100.0,18,11,35,8,4,15,26,15,50,25.156073289978224,1.124158842820292
California Institute of Technology,962,961,California,Midsize City,NA,91.62,74.12,99.21,2,1,3,1,0,1,3,1,4,1.18200140075485,1.292284122228649
California Lutheran University,2968,2858,California,Midsize City,private,100.0,99.69,100.0,7,4,14,3,2,6,10,6,20,9.033867848626354,1.1781173594964705
California State University Maritime Academy,1050,1007,California,Midsize City,NA,96.42,85.22,99.8,2,1,4,1,1,2,3,2,6,3.222972763548939,0.10073882260481509
California Polytechnic State University - San Luis Obispo,21348,20584,California,Suburb,NA,100.0,100.0,100.0,52,30,98,22,12,42,74,42,140,70.09048057768047,3.9982977844252248
California State Polytechnic University - PomoNA,24318,21668,California,Suburb,NA,100.0,100.0,100.0,63,36,117,26,15,50,89,51,167,88.64643424481018,0.5469606228846706
California State University - Bakersfield,8816,7502,California,Large City,NA,100.0,100.0,100.0,23,13,42,10,5,18,33,18,60,32.005808115470614,0.33371621790160344
California State University - Channel Islands,7054,5858,California,Suburb,NA,100.0,100.0,100.0,18,10,34,8,4,14,26,14,48,25.893906462499107,0.0
California State University - Chico,16709,15446,California,Small City,NA,100.0,100.0,100.0,43,25,80,18,10,34,61,35,114,60.171947084389764,0.5125098102748554
California State University - Dominguez Hills,13279,10084,California,Small City,NA,100.0,100.0,100.0,34,20,64,14,8,27,48,28,91,48.506107172591896,0.12709888328979818
California State University - East Bay,13473,11539,California,Midsize City,NA,100.0,100.0,100.0,34,20,64,14,8,27,48,28,91,48.66395208014611,0.23562560007419697
California State University - Fresno,22260,19432,California,Large City,NA,100.0,100.0,100.0,57,33,107,24,14,46,81,47,153,81.07722030581483,0.44792737817973893
California State University - Fullerton,35161,28475,California,Suburb,public,100.0,100.0,100.0,91,52,169,38,22,72,129,74,241,128.54081692618817,0.34776455310757215
California State University - Long Beach,31564,27507,California,Large City,public,100.0,100.0,100.0,81,47,151,34,19,64,115,66,215,114.57337801354156,0.5832480341813265
California State University - Los Angeles,24820,21004,California,Large City,public,100.0,100.0,100.0,64,37,119,27,15,51,91,52,170,90.5956353125146,0.4160346806968092
California State University - Monterey Bay,6762,6109,California,Suburb,NA,100.0,100.0,100.0,17,10,32,7,4,14,24,14,46,24.348494693189195,0.26572046187958176
California State University - Northridge,35836,29739,California,Large City,NA,100.0,100.0,100.0,92,53,172,39,22,73,131,75,245,130.699254266697,0.3689054803562001
California State University - Sacramento,28449,23491,California,Large City,public,100.0,100.0,100.0,73,42,136,31,18,58,104,60,194,103.56461341458568,0.46684064934701475
California State University - San BerNArdino,18324,16381,California,Midsize City,public,100.0,100.0,100.0,47,27,88,20,11,38,67,38,126,66.97029054463195,0.12333369409960278
California State University - San Marcos,14616,11634,California,Suburb,NA,100.0,100.0,100.0,38,22,70,16,9,30,54,31,100,53.43233661300496,0.19997125602738156
California State University - Stanislaus,9058,7621,California,Suburb,NA,100.0,100.0,100.0,23,13,43,10,6,19,33,19,62,33.11806409195732,0.07915891092843663
California University of Pennsylvania,5553,4534,Pennsylvania,Suburb,public,99.7,97.01,100.0,4,2,7,2,1,3,6,3,10,5.276382881295233,0.5304374325899063
Calumet College of Saint Joseph,624,427,IndiaNA,Suburb,private,33.45,23.18,48.73,0,0,0,0,0,0,0,0,0,0.32588880266050396,0.08117650215386417
Calvin College,3737,3524,Michigan,Midsize City,NA,98.83,91.83,99.98,3,2,6,1,1,3,4,3,9,2.289748639887021,2.1550581630170798
Cambridge College,750,221,Massachusetts,Large City,private,77.13,57.34,93.08,1,1,2,0,0,1,1,1,3,1.4724973490471376,0.0012883927418306021
Cameron University,4149,2814,Oklahoma,Small City,NA,98.89,86.67,100.0,3,1,7,1,1,3,4,2,10,3.2614877885257556,1.2346616050142456
Campbell University,4382,3634,North CaroliNA,Town,NA,97.16,82.91,99.93,3,1,5,1,0,2,4,1,7,1.893349560223853,1.6627247687726208
Campbellsville University,3704,2128,Kentucky,Town,private,98.24,84.62,99.99,3,1,6,1,1,3,4,2,9,3.1755838748684013,0.8593388498472566
Canisius College,2397,2303,New York,Large City,private,95.06,85.06,99.27,2,1,3,1,1,1,3,2,4,2.769561759168145,0.23691775106216015
Capella University,9208,1382,Minnesota,Large City,NA,100.0,99.93,100.0,10,5,22,4,2,9,14,7,31,0.05870343159090844,14.718994428309177
Capital University,2703,2493,Ohio,Suburb,NA,86.89,67.12,97.76,1,1,3,1,0,1,2,1,4,1.6740317811341714,0.35697841291753224
CardiNAl Stritch University,1542,901,Wisconsin,Suburb,NA,32.87,22.43,49.18,0,0,0,0,0,0,0,0,0,0.2444645735194768,0.15376274175979726
Carleton College,2068,2055,Minnesota,Town,NA,93.93,78.64,99.6,2,1,4,1,0,2,3,1,6,0.08747200071492979,2.709983156591421
Carlos Albizu University - Miami,376,291,Florida,Suburb,NA,90.25,73.12,99.01,2,1,3,1,0,1,3,1,4,2.3211359760525485,0.0
Carlow University,1365,1075,Pennsylvania,Large City,NA,75.3,57.09,91.59,1,1,2,0,0,1,1,1,3,1.2819309238808758,0.11557957702560027
Carnegie Mellon University,6530,6298,Pennsylvania,Large City,NA,100.0,99.91,100.0,9,5,17,4,2,7,13,7,24,1.309422691112634,11.315233822923696
Carroll College,1360,1287,MontaNA,Town,NA,82.82,40.93,100.0,1,0,7,1,0,5,2,0,12,0.7886580853065283,0.9711311383202471
Carroll University,2983,2737,Wisconsin,Small City,NA,57.83,43.53,76.14,1,0,1,0,0,0,1,0,1,0.39963370401686926,0.46360761385247756
Carson - Newman University,1688,1608,Tennessee,Suburb,NA,89.42,61.57,99.4,2,1,4,1,0,1,3,1,5,1.1736426039712586,1.0701795978230397
Carthage College,2740,2596,Wisconsin,Suburb,NA,71.34,55.04,88.86,1,1,2,0,0,1,1,1,3,0.1579138674755303,1.091266544188287
Case Western Reserve University,5147,4978,Ohio,Large City,private,99.85,97.24,100.0,5,3,9,2,1,4,7,4,13,1.4337038948257281,5.065456577860159
Castleton University,1857,1590,Vermont,Town,NA,59.81,40.84,80.02,1,0,1,0,0,0,1,0,1,0.002690514863237989,0.9079856055543036
Catawba College,1322,1268,North CaroliNA,Suburb,NA,66.79,42.35,89.44,1,0,2,0,0,1,1,0,3,0.5759919565310532,0.5252210250074899
Catholic University of America,3308,3194,District of Columbia,Large City,NA,99.55,95.19,100.0,4,2,7,2,1,3,6,3,10,0.030216900595378893,5.375424265389699
Cazenovia College,897,713,New York,Town,NA,69.71,51.65,87.35,1,1,1,0,0,1,1,1,2,0.8449926786286847,0.34832543559171086
Cedar Crest College,1432,931,Pennsylvania,Midsize City,NA,80.62,62.46,94.57,1,1,2,0,0,1,1,1,3,1.010067892366822,0.6296856388583507
Cedarville University,3536,3109,Ohio,Town,private,97.11,85.43,99.89,3,1,5,1,1,2,4,2,7,0.8428691485430794,2.698517010135108
CenteNAry University,1366,1125,New Jersey,Suburb,private,95.61,81.98,99.71,2,1,4,1,0,2,3,1,6,2.7503366524951933,0.37127265417114885
CenteNAry College of LouisiaNA,536,524,LouisiaNA,Midsize City,NA,83.38,57.03,97.95,1,1,3,1,0,1,2,1,4,0.7909376927709637,0.9994264258750729
Central Baptist College,745,599,Arkansas,Small City,private,53.76,28.58,81.52,1,0,1,0,0,0,1,0,1,0.33617138513626055,0.43383187674583823
Central Christian College of Kansas,869,730,Kansas,Town,NA,83.48,58.32,97.82,1,1,3,1,0,1,2,1,4,0.05348928678544557,1.7415657871796746
Central College,1232,1198,Iowa,Town,NA,67.94,39.76,93.19,1,0,2,0,0,1,1,0,3,0.7593792116623546,0.3771419090519793
Central Connecticut State University,9550,7605,Connecticut,Suburb,NA,97.48,92.46,99.69,3,2,4,1,1,2,4,3,6,2.9333481749628234,0.7444754913191398
Central Methodist University - College of Liberal Arts & Sciences,1058,1034,Missouri,Town,NA,55.53,31.01,84.01,1,0,1,0,0,1,1,0,2,0.551778632870627,0.25773572384324495
Central Michigan University,17801,15585,Michigan,Town,NA,100.0,100.0,100.0,13,8,27,6,3,11,19,11,38,18.353497439169605,0.6864553626322459
Central Penn College,1197,316,Pennsylvania,Suburb,NA,73.3,54.84,90.27,1,1,2,0,0,1,1,1,3,0.9937764747480023,0.3259263259414808
Central State University,1788,1710,Ohio,Rural,public,77.63,56.85,94.24,1,1,2,0,0,1,1,1,3,0.6300860056510764,0.8662993989700747
Central Washington University,12080,10446,Washington,Town,NA,100.0,100.0,100.0,11,7,18,5,3,8,16,10,26,15.2089471648723,0.513359502843584
Centre College,1447,1449,Kentucky,Town,NA,82.33,55.69,97.9,1,1,3,0,0,1,1,1,4,0.792893574817205,0.938722885219342
Chadron State College,2151,1616,Nebraska,Town,NA,49.87,32.25,74.27,0,0,1,0,0,0,0,0,1,0.1207971067989268,0.5692057953803805
ChamiNAde University of Honolulu,1813,1524,Hawaii,Large City,NA,86.39,66.44,97.96,1,1,3,1,0,1,2,1,4,0.0018416281196974838,1.9886288760292734
Champlain College,3933,2603,Vermont,Small City,NA,98.61,91.01,99.96,3,2,5,1,1,2,4,3,7,0.0016781175804322845,4.272333668000433
Chapman University,7023,6515,California,Midsize City,NA,100.0,100.0,100.0,15,9,29,6,4,12,21,13,41,17.34825658374976,4.354250199240582
Charleston Southern University,3062,2804,South CaroliNA,Midsize City,private,99.99,98.54,100.0,6,3,13,3,1,5,9,4,18,7.628325254237042,1.455681266209932
Chatham University,1207,951,Pennsylvania,Large City,NA,78.38,58.59,93.9,1,1,2,0,0,1,1,1,3,0.8104980265362806,0.7195681896695698
Chestnut Hill College,1363,1118,Pennsylvania,Large City,NA,85.82,67.63,97.16,1,1,3,1,0,1,2,1,4,0.7707876960904075,1.1804276793656034
Cheyney University of Pennsylvania,718,671,Pennsylvania,Suburb,public,56.94,39.42,77.58,1,0,1,0,0,0,1,0,1,0.5233617910045831,0.31853271752530804
Chicago State University,2032,1297,Illinois,Large City,NA,68.63,52.84,86.8,1,1,1,0,0,1,1,1,2,1.0442795864508894,0.11458885435093412
Chowan University,1500,1440,North CaroliNA,Town,private,87.29,63.64,98.04,1,1,3,1,0,1,2,1,4,0.33893926686538417,1.7210449782865784
Christian Brothers University,1789,1426,Tennessee,Large City,NA,90.58,61.84,99.57,2,1,4,1,0,2,3,1,6,1.4739224006394904,0.8855523162859552
Christopher Newport University,4951,4867,Virginia,Midsize City,NA,99.99,98.41,100.0,6,3,11,3,1,5,9,4,16,8.756308467760846,0.2816123992551522
Citadel Military College of South CaroliNA,2837,2559,South CaroliNA,Midsize City,NA,99.96,97.5,100.0,5,3,11,2,1,5,7,4,16,4.8540951977638755,2.8609071550957665
City University of Seattle,929,235,Washington,Large City,NA,71.76,55.33,87.27,1,1,1,0,0,1,1,1,2,1.1118300865309103,0.15177714433385045
Claflin University,2040,1955,South CaroliNA,Town,private,99.62,92.41,100.0,4,2,8,2,1,3,6,3,11,4.7378294445240225,0.8267223860600041
Claremont McKenNA College,1341,1337,California,Suburb,NA,96.86,85.67,99.87,2,1,5,1,1,2,3,2,7,2.294257377241557,1.16185795949457
Clarion University of Pennsylvania,4319,3483,Pennsylvania,Town,public,98.9,93.45,99.97,3,2,6,1,1,2,4,3,8,4.133947220775501,0.3730812981401814
Clark Atlanta University,3305,3187,Georgia,Large City,NA,99.85,96.33,100.0,5,2,9,2,1,4,7,3,13,0.686431101783975,5.819597057616754
Clark University,2240,2199,Massachusetts,Midsize City,private,96.41,84.78,99.78,2,1,4,1,1,2,3,2,6,1.6896216230353214,1.6344014433575762
Clarke University,765,708,Iowa,Small City,NA,47.4,27.44,76.3,0,0,1,0,0,0,0,0,1,0.27724577035616554,0.3646132008417299
Clarkson University,3086,3021,New York,Town,private,97.38,89.12,99.79,3,2,4,1,1,2,4,3,6,2.6749913576355744,0.9629712720623486
Clayton State University,6553,3743,Georgia,Suburb,NA,99.62,84.79,100.0,4,1,11,1,0,5,5,1,16,5.069213869104681,0.4976131671309544
Clemson University,19409,18642,South CaroliNA,Suburb,public,100.0,100.0,100.0,36,17,71,14,6,30,50,23,101,37.87356911788221,12.116925634354482
Cleveland State University,12077,9268,Ohio,Large City,NA,99.98,99.16,100.0,6,4,11,2,1,5,8,5,16,8.006568292573842,0.6489988802503606
Coastal CaroliNA University,9899,9021,South CaroliNA,Small City,NA,100.0,100.0,100.0,16,8,31,6,3,13,22,11,44,15.082251878614304,7.256501988190521
Coe College,1393,1369,Iowa,Midsize City,private,69.5,43.07,93.17,1,0,2,0,0,1,1,0,3,0.558299861733707,0.6276947147510272
Cogswell College,606,436,California,Large City,NA,86.8,68.65,97.73,1,1,3,1,0,1,2,1,4,1.9602135031151862,0.06072806019978671
Coker College,1025,909,South CaroliNA,Town,private,96.49,79.23,99.89,2,1,5,1,0,2,3,1,7,2.6547346989766507,0.6892841417857947
Colby College,1923,1917,Maine,Town,NA,92.39,76.63,99.09,2,1,3,1,0,1,3,1,4,0.07058629664226414,2.5017192884463952
Colby - Sawyer College,983,920,New Hampshire,Rural,NA,61.98,38.24,83.42,1,0,1,0,0,1,1,0,2,0.13497103436244243,0.83111640454437
Colgate University,2882,2854,New York,Town,private,98.94,92.7,99.97,3,2,6,1,1,2,4,3,8,0.9923751225755483,3.5445257905481578
College of Charleston,9901,9083,South CaroliNA,Midsize City,public,100.0,100.0,100.0,17,8,33,7,3,14,24,11,47,16.05113315561308,7.652861537786049
College of Mount Saint Vincent,1693,1613,New York,Large City,NA,88.56,74.38,97.2,2,1,3,1,0,1,3,1,4,1.8557906066975909,0.3108330735167333
Mount St. Joseph University,1315,1000,Ohio,Suburb,NA,66.08,44.73,87.22,1,0,1,0,0,1,1,0,2,0.7299357005356732,0.3503195023130149
Notre Dame of Maryland University,817,528,Maryland,Large City,NA,61.46,42.72,81.43,1,0,1,0,0,0,1,0,1,0.7065032379327303,0.2460732676335373
College of Our Lady of the Elms,1174,973,Massachusetts,Suburb,private,85.05,66.89,96.75,1,1,2,1,0,1,2,1,3,1.7468634770867517,0.1519459899954302
College of Saint Benedict,1940,1916,Minnesota,Suburb,NA,48.58,31.16,71.62,0,0,1,0,0,0,0,0,1,0.3127609981118267,0.3518299436474842
College of Saint Elizabeth,757,587,New Jersey,Suburb,NA,83.93,63.11,96.76,1,1,2,1,0,1,2,1,3,1.8190057225497311,0.007305055635936649
College of Saint Mary,833,761,Nebraska,Large City,NA,24.77,13.66,45.62,0,0,0,0,0,0,0,0,0,0.06030418065977674,0.2239746301433326
Northeast Catholic College,69,70,New Hampshire,Rural,NA,5.95,2.66,11.26,0,0,0,0,0,0,0,0,0,0.011736611683690647,0.04950894870308862
College of the Atlantic,352,330,Maine,Town,private,35.05,21.05,55.26,0,0,1,0,0,0,0,0,1,0.027431641349126346,0.4035428973058085
College of the Holy Cross,2852,2827,Massachusetts,Midsize City,private,98.89,92.36,99.97,3,2,6,1,1,2,4,3,8,2.139661027301739,2.3525931720841253
College of the Ozarks,1510,1477,Missouri,Town,private,58.41,32.06,86.67,1,0,1,0,0,1,1,0,2,0.7085339262997824,0.16853741563957764
College of William and Mary,6287,6199,Virginia,Suburb,NA,100.0,99.65,100.0,8,4,15,3,2,7,11,6,22,7.500890410042373,4.0708877707702396
Colorado Christian University,6541,1840,Colorado,Midsize City,NA,99.99,98.85,100.0,6,3,14,3,1,6,9,4,20,1.3086765627036057,7.885618525482707
Colorado College,2106,2091,Colorado,Large City,private,95.17,79.86,99.77,2,1,4,1,0,2,3,1,6,0.18316419072589074,2.8427193259527845
Colorado School of Mines,4790,4584,Colorado,Suburb,public,99.86,95.6,100.0,5,2,10,2,1,5,7,3,15,1.334361656115742,5.2196887802921905
Colorado State University - Fort Collins,25523,22154,Colorado,Midsize City,public,100.0,99.99,100.0,13,6,31,5,3,13,18,9,44,8.780512343004597,10.045122941706348
Colorado State University - Pueblo,4627,3292,Colorado,Midsize City,NA,95.92,77.5,99.94,2,1,5,1,0,2,3,1,7,1.7091113796698634,1.4858408218096777
Colorado Technical University - Colorado Springs,22305,14445,Colorado,Large City,NA,99.99,98.62,100.0,7,3,18,3,1,7,10,4,25,9.139261516564272,0.7476059036518414
Columbia College Chicago,7029,6436,Illinois,Large City,NA,99.86,97.65,100.0,5,3,9,2,1,4,7,4,13,2.0287028199424646,4.503937859414643
Columbia College Missouri,12747,5163,Missouri,Midsize City,private,100.0,99.99,100.0,14,7,28,6,3,12,20,10,40,4.045996628218709,15.077163341107953
Columbia College South CaroliNA,1383,804,South CaroliNA,Midsize City,NA,98.47,85.2,99.98,3,1,6,1,1,3,4,2,9,3.8238514398885086,0.3499531460638356
Columbia InterNAtioNAl University,497,454,South CaroliNA,Midsize City,NA,74.41,47.55,93.63,1,0,2,0,0,1,1,0,3,0.9333556301754891,0.4271951873142811
Columbia Southern University,15049,8567,Alabama,Town,private,100.0,100.0,100.0,25,13,52,11,5,23,36,18,75,1.3509069845982866,34.04770308557643
Columbia University in the City of New York,8157,7592,New York,Large City,NA,100.0,99.99,100.0,12,7,23,5,3,10,17,10,33,2.458830439846841,15.041007189370076
Columbus State University,6798,4693,Georgia,Midsize City,NA,99.73,88.0,100.0,4,2,12,2,1,5,6,3,17,4.905587850656175,1.0179514670090954
Concord University,1853,1696,West Virginia,Town,public,58.77,34.66,80.54,1,0,1,0,0,1,1,0,2,0.10254287229298588,0.7824197957376592
Concordia College at Moorhead,2032,1997,Minnesota,Suburb,NA,70.31,40.65,97.84,1,0,2,0,0,1,1,0,3,0.2742733177972576,0.9390523635334688
Concordia College - New York,1131,1024,New York,Suburb,NA,78.47,61.21,92.55,1,1,2,0,0,1,1,1,3,1.1188783869632728,0.4153825110445061
Concordia University - Ann Arbor,906,780,Michigan,Midsize City,NA,65.29,44.32,87.95,1,0,1,0,0,1,1,0,2,0.8080832840954665,0.24911353701141725
Concordia University - Chicago,1458,1299,Illinois,Suburb,private,73.1,54.01,92.05,1,1,2,0,0,1,1,1,3,0.532293995959614,0.7787210113709379
Concordia University - Irvine,1851,1645,California,Large City,private,99.8,96.91,100.0,4,2,8,2,1,4,6,3,12,5.451155528325939,0.7559901917640417
Concordia University - Portland,1378,1124,Oregon,Large City,NA,78.86,60.04,94.74,1,1,2,0,0,1,1,1,3,0.4992365142641811,1.0530436921657005
Concordia University - Saint Paul,2867,1417,Minnesota,Large City,NA,66.48,45.99,87.28,1,0,1,0,0,1,1,0,2,0.3907082698600197,0.7013186018284463
Concordia University - Nebraska,1682,1231,Nebraska,Town,NA,74.77,49.95,94.48,1,0,2,0,0,1,1,0,3,0.07540381900964259,1.2987545142717571
Concordia University - Texas,1725,1347,Texas,Large City,NA,100.0,99.48,100.0,8,4,16,3,2,8,11,6,24,10.889746666119704,0.19687817865276125
Concordia University - Wisconsin,3713,2616,Wisconsin,Suburb,NA,88.68,71.54,98.44,2,1,3,1,0,1,3,1,4,0.47136283037887144,1.7038132522693912
Connecticut College,1815,1766,Connecticut,Small City,private,93.46,78.69,99.33,2,1,3,1,0,1,3,1,4,0.10081673204824462,2.622188529489924
Converse College,920,860,South CaroliNA,Small City,NA,92.98,70.56,99.57,2,1,4,1,0,2,3,1,6,2.1412276221672983,0.5103389619569747
Cooper Union for the Advancement of Science and Art,864,859,New York,Large City,NA,83.15,63.8,96.31,1,1,2,1,0,1,2,1,3,0.530576798208709,1.2475719508747845
Coppin State University,2509,1854,Maryland,Large City,NA,94.45,81.74,99.38,2,1,4,1,0,1,3,1,5,2.1591657301075613,0.7299322956929882
Corban University,1021,936,Oregon,Midsize City,private,75.17,54.47,94.22,1,1,2,0,0,1,1,1,3,0.2946422398508761,1.0969048993838233
Cornell College,1006,1002,Iowa,Town,private,76.4,51.91,95.32,1,1,2,0,0,1,1,1,3,0.10587132439425004,1.3349490975720935
Cornell University,14907,14898,New York,Small City,NA,100.0,100.0,100.0,20,11,37,8,5,16,28,16,53,6.578169748161679,21.528449930855217
Cornerstone University,1757,1260,Michigan,Midsize City,NA,83.61,63.47,97.31,1,1,3,1,0,1,2,1,4,1.464449200604434,0.3425564048157819
CoveNAnt College,1033,983,Georgia,Rural,private,83.28,58.96,97.82,1,1,3,1,0,1,2,1,4,0.2035348034359461,1.5820361093299484
Creighton University,4256,4011,Nebraska,Large City,NA,95.69,80.13,99.86,2,1,5,1,0,2,3,1,7,0.11117108735088733,3.0285662578404695
Crown College,1055,698,Minnesota,Rural,NA,38.92,22.2,76.66,0,0,1,0,0,1,0,0,2,0.13295744108669327,0.3595969089932548
Culver - Stockton College,1092,969,Missouri,Rural,NA,58.41,36.35,84.2,1,0,1,0,0,1,1,0,2,0.3209208370931436,0.5553702260576008
Cumberland University,1974,1578,Tennessee,Town,NA,86.54,53.02,99.24,1,1,4,1,0,1,2,1,5,1.6613519469258704,0.3425465246424206
CUNY BerNArd M Baruch College,15253,11598,New York,Large City,NA,100.0,100.0,100.0,13,9,21,5,3,9,18,12,30,18.5591342540088,0.3443984168027491
CUNY Brooklyn College,14691,10786,New York,Large City,NA,100.0,100.0,100.0,13,8,21,5,3,9,18,11,30,17.549564512972783,0.755398664045503
CUNY City College,13211,10225,New York,Large City,public,100.0,100.0,100.0,12,7,18,5,3,8,17,10,26,16.10276018822774,0.19790669154298884
College of Staten Island CUNY,12509,9710,New York,Large City,public,100.0,99.99,100.0,11,7,17,4,3,7,15,10,24,15.357250659263189,0.012126704816998207
CUNY Graduate School and University Center,2066,418,New York,Large City,NA,92.11,80.23,98.34,2,1,3,1,0,1,3,1,4,2.5374344099518353,0.0
CUNY Hunter College,16846,12612,New York,Large City,NA,100.0,100.0,100.0,15,10,24,6,4,10,21,14,34,20.094368045121964,1.03725238530285
CUNY John Jay College of CrimiNAl Justice,12916,10276,New York,Large City,public,100.0,100.0,100.0,11,7,18,5,3,8,16,10,26,15.838699976156276,0.04850681926799283
CUNY Lehman College,11978,7216,New York,Large City,NA,100.0,99.99,100.0,10,7,17,4,3,7,14,10,24,14.68788872633785,0.046081478304593186
CUNY Queens College,16680,12149,New York,Large City,NA,100.0,100.0,100.0,15,9,23,6,4,10,21,13,33,20.486159708614043,0.0
CUNY York College,8393,5056,New York,Large City,NA,100.0,99.86,100.0,7,5,12,3,2,5,10,7,17,10.308173767050219,0.0
Curry College,2561,2059,Massachusetts,Suburb,private,98.36,90.58,99.94,3,2,5,1,1,2,4,3,7,3.2627856809315263,0.8436420630124841
Daemen College,1799,1560,New York,Suburb,NA,89.86,76.4,97.76,2,1,3,1,0,1,3,1,4,2.0965152651441348,0.19078623233783956
Dakota State University,2963,1397,South Dakota,Town,public,92.09,76.57,98.89,2,1,3,1,0,1,3,1,4,1.7875507880452801,0.7473784993484527
Dakota Wesleyan University,793,668,South Dakota,Town,NA,56.48,37.16,78.07,1,0,1,0,0,0,1,0,1,0.45978996647883846,0.3711513459787067
Dallas Baptist University,3159,2423,Texas,Large City,NA,100.0,99.99,100.0,14,7,30,6,3,14,20,10,44,19.641044018192137,0.35706751383517504
Dartmouth College,4415,4360,New Hampshire,Town,NA,99.98,99.03,100.0,6,3,11,2,1,5,8,4,16,0.05191193629324709,8.378127560590874
Davenport University,5597,2621,Michigan,Suburb,NA,99.74,96.39,100.0,4,2,8,2,1,4,6,3,12,5.8728609382064665,0.08449296480543904
Davidson College,1812,1810,North CaroliNA,Suburb,private,95.51,80.3,99.79,2,1,4,1,0,2,3,1,6,0.20274916869893073,2.894003928404994
Davis & Elkins College,839,785,West Virginia,Town,NA,42.53,24.14,66.17,0,0,1,0,0,0,0,0,1,0.04103157126210195,0.5121672677234577
Defiance College,583,525,Ohio,Town,NA,46.67,29.56,70.03,0,0,1,0,0,0,0,0,1,0.28371085718933714,0.3441127672423181
Delaware State University,4054,3571,Delaware,Small City,NA,98.66,92.26,99.94,3,2,5,1,1,2,4,3,7,0.4899214668389114,3.817607577428614
Delaware Valley University,1991,1756,Pennsylvania,Suburb,private,94.33,80.74,99.46,2,1,4,1,0,2,3,1,6,1.0925431940620969,1.7740232559352205
Delta State University,3034,2198,Mississippi,Town,NA,100.0,99.57,100.0,8,4,15,3,2,6,11,6,21,9.549149037543312,1.403341397211501
Denison University,2344,2319,Ohio,Suburb,NA,92.98,77.3,99.36,2,1,4,1,0,2,3,1,6,0.44760208051715816,2.2062802463627165
DePaul University,14822,12886,Illinois,Large City,NA,100.0,99.9,100.0,8,5,15,3,2,6,11,7,21,5.561830939710545,6.08441145337643
DePauw University,2156,2140,IndiaNA,Town,NA,87.1,69.61,97.76,1,1,3,1,0,1,2,1,4,0.6232275179084424,1.4225979294746243
DeSales University,2350,1811,Pennsylvania,Suburb,private,95.77,84.23,99.67,2,1,4,1,1,2,3,2,6,1.5354661105737577,1.6245710375819753
Dickinson College,2386,2346,Pennsylvania,Small City,private,97.14,86.66,99.85,3,1,5,1,1,2,4,2,7,0.5029975189810585,3.04554046689041
Dickinson State University,1426,922,North Dakota,Town,public,91.7,60.41,99.97,2,1,5,1,0,3,3,1,8,1.540757410144823,0.9453670344715136
DigiPen Institute of Technology,1024,964,Washington,Small City,NA,79.12,59.13,94.55,1,1,2,0,0,1,1,1,3,0.6297321994217376,0.9342717682062417
Dillard University,1292,1200,LouisiaNA,Large City,NA,96.62,80.58,99.93,2,1,5,1,0,2,3,1,7,1.8937308186916217,1.4879845841002195
Doane University,1066,1062,Nebraska,Town,NA,32.57,19.02,54.84,0,0,1,0,0,0,0,0,1,0.08474672023862209,0.308644120733936
Dominican College of Blauvelt,1420,1271,New York,Suburb,private,87.9,71.96,97.42,1,1,3,1,0,1,2,1,4,1.3313547436533346,0.7782094730736424
Dominican University,2171,2014,Illinois,Suburb,NA,70.37,54.52,88.06,1,1,2,0,0,1,1,1,3,1.065122423642079,0.15084207299507027
Dominican University of California,1304,1135,California,Small City,private,98.87,92.22,99.98,3,2,6,1,1,3,4,3,9,4.25814169216033,0.21711792807211097
Dordt College,1445,1341,Iowa,Town,NA,84.98,61.77,98.76,1,1,3,1,0,1,2,1,4,0.4067286850829462,1.4865041710961056
Drake University,3100,2955,Iowa,Midsize City,NA,85.6,62.47,98.44,1,1,3,1,0,1,2,1,4,0.7182493446314948,1.2181439802834026
Drew University,1534,1507,New Jersey,Suburb,private,96.36,83.78,99.8,2,1,4,1,1,2,3,2,6,2.3453047116074535,0.9636599391418974
Drexel University,15528,13572,Pennsylvania,Large City,private,100.0,100.0,100.0,18,10,32,7,4,14,25,14,46,7.0022549352889465,17.983306249438872
Drury University,3277,2478,Missouri,Midsize City,NA,88.89,62.71,99.35,2,1,4,1,0,1,3,1,5,1.688397015044212,0.5073387506989775
Duke University,6699,6669,North CaroliNA,Large City,NA,100.0,99.96,100.0,10,6,20,4,2,9,14,8,29,0.4602815723745927,14.362394220794378
Duquesne University,5941,5826,Pennsylvania,Large City,NA,99.86,97.91,100.0,5,3,8,2,1,3,7,4,11,4.4190470291048465,2.122443270685274
D'Youville College,1734,1295,New York,Large City,private,88.03,73.98,96.82,2,1,2,1,0,1,3,1,3,2.027736791302265,0.09363399713068027
Earlham College,1061,1051,IndiaNA,Town,private,72.23,51.3,91.42,1,1,2,0,0,1,1,1,3,0.17826396042967738,1.1014230297438758
East CaroliNA University,23267,19999,North CaroliNA,Small City,public,100.0,99.95,100.0,11,6,22,4,2,9,15,8,31,10.289008318620484,5.097166832560891
East Central University,3082,2551,Oklahoma,Town,NA,96.83,78.7,99.96,2,1,5,1,0,2,3,1,7,2.461148666179134,0.9860248597903489
East Stroudsburg University of Pennsylvania,6051,5552,Pennsylvania,Small City,public,99.97,99.19,100.0,6,3,10,2,1,4,8,4,14,4.233732153690772,4.00501895986788
East Tennessee State University,11319,9641,Tennessee,Small City,NA,100.0,98.83,100.0,9,3,20,3,1,8,12,4,28,9.710028065464552,2.001904206110487
East Texas Baptist University,1421,1216,Texas,Town,NA,99.99,98.69,100.0,6,3,14,3,1,6,9,4,20,8.921556055420146,0.21549567398936975
Eastern Connecticut State University,5069,4210,Connecticut,Town,public,87.51,76.47,96.21,1,1,2,1,0,1,2,1,3,1.5138614716509575,0.5654497428853377
Eastern Illinois University,5569,4319,Illinois,Town,NA,95.72,87.13,99.6,2,1,4,1,1,2,3,2,6,2.911584026092347,0.23909701489206356
Eastern Kentucky University,14138,10744,Kentucky,Town,NA,100.0,99.85,100.0,10,5,22,4,2,9,14,7,31,12.163047581329918,1.8143120700786202
Eastern Mennonite University,1102,942,Virginia,Small City,NA,81.74,57.23,95.6,1,1,2,1,0,1,2,1,3,1.0843092261479552,0.6144253586453537
Eastern Michigan University,17218,12410,Michigan,Suburb,NA,100.0,100.0,100.0,13,7,26,5,3,11,18,10,37,16.089573032063264,2.2338269763167706
Eastern Nazarene College,694,571,Massachusetts,Suburb,private,68.07,47.5,87.64,1,0,1,0,0,1,1,0,2,0.7145362471247504,0.425795594200748
Eastern New Mexico University - Main Campus,4600,2590,New Mexico,Town,NA,100.0,98.86,100.0,8,3,19,3,1,8,11,4,27,6.353803352933533,4.830631069369817
Eastern Oregon University,2736,1668,Oregon,Town,public,91.99,75.34,99.52,2,1,4,1,0,2,3,1,6,1.3103303205952446,1.2119334528046912
Eastern University,1882,1462,Pennsylvania,Suburb,NA,92.26,76.75,99.07,2,1,3,1,0,1,3,1,4,0.9581389987068342,1.5976197864142905
Eastern Washington University,11474,10060,Washington,Town,NA,100.0,99.99,100.0,11,7,17,5,3,8,16,10,25,14.014807682981285,1.2103987837833783
Eckerd College,2036,1915,Florida,Large City,private,98.88,91.58,99.99,3,2,6,1,1,3,4,3,9,2.2840965721793696,2.201181818746983
Edgewood College,1566,1361,Wisconsin,Large City,NA,29.96,21.16,43.76,0,0,0,0,0,0,0,0,0,0.26422667976206926,0.09185806605599733
Edinboro University of Pennsylvania,4294,3888,Pennsylvania,Town,public,98.9,93.44,99.96,3,2,6,1,1,2,4,3,8,3.759244615542648,0.7485401647139392
Edward Waters College,3443,853,Florida,Large City,private,100.0,100.0,100.0,13,7,25,5,3,11,18,10,36,16.95170050595824,1.131675991511653
Elizabeth City State University,1365,1179,North CaroliNA,Town,NA,57.27,34.6,81.97,1,0,1,0,0,0,1,0,1,0.6266792487057858,0.2233129382460221
Elizabethtown College,1674,1636,Pennsylvania,Suburb,private,87.83,70.92,97.69,1,1,3,1,0,1,2,1,4,1.0385778731997566,1.0657673354302475
Elmhurst College,2874,2732,Illinois,Suburb,private,87.59,72.45,97.79,1,1,3,1,0,1,2,1,4,1.3163053333820576,0.7682806550377065
Elmira College,936,833,New York,Small City,NA,67.93,49.13,86.07,1,0,1,0,0,1,1,0,2,0.5674224091954249,0.5687623729581603
Elon University,6049,5885,North CaroliNA,Suburb,NA,99.98,98.95,100.0,6,3,11,2,1,5,8,4,16,0.784373046582732,7.666246990228763
Embry Riddle AeroNAutical University - DaytoNA Beach,5733,5378,Florida,Small City,NA,100.0,99.99,100.0,12,6,23,5,3,10,17,9,33,10.1549698952299,6.438891873940068
Embry Riddle AeroNAutical University - Prescott,2607,2471,ArizoNA,Rural,NA,99.83,96.94,100.0,4,2,9,2,1,4,6,3,13,1.3160346874741495,5.023630957616904
Emerson College,3814,3748,Massachusetts,Large City,NA,99.94,98.32,100.0,5,3,10,2,1,4,7,4,14,1.3816999253793516,5.9568149567019555
Emmanuel College Georgia,954,822,Georgia,Town,NA,73.41,43.3,95.85,1,0,2,0,0,1,1,0,3,0.54914488142718,0.773596858855081
Emmanuel College Massachusetts,1947,1804,Massachusetts,Large City,NA,95.6,83.11,99.66,2,1,4,1,1,2,3,2,6,2.4831121516103205,0.6373242634617384
Emory and Henry College,999,966,Virginia,Rural,NA,79.41,51.53,95.4,1,1,2,0,0,1,1,1,3,1.0452517754633803,0.5333395973188514
Emory University,6938,6794,Georgia,Large City,NA,100.0,99.95,100.0,10,5,21,4,2,9,14,7,30,1.4718359903368023,13.311985010534917
Emporia State University,3605,3340,Kansas,Town,NA,78.05,51.88,95.33,1,1,2,0,0,1,1,1,3,0.5742232257849303,0.9394248901515247
Endicott College,3348,2946,Massachusetts,Suburb,NA,98.72,91.44,99.96,3,2,6,1,1,2,4,3,8,3.1088248321035414,1.2437039587772192
Erskine College,573,568,South CaroliNA,Rural,NA,80.57,52.76,96.42,1,1,2,0,0,1,1,1,3,1.4177962686748777,0.2177438482896047
Eureka College,615,593,Illinois,Town,private,28.16,19.54,43.51,0,0,0,0,0,0,0,0,0,0.3206590337106109,0.00993985654504587
Evangel University,1632,1461,Missouri,Midsize City,NA,89.56,67.48,99.19,2,1,3,1,0,1,3,1,4,0.31864076009781045,1.9362650730877213
Everglades University,2101,2099,Florida,Small City,NA,100.0,99.75,100.0,7,4,14,3,2,7,10,6,21,9.66728441089971,0.9619644028830575
Fairfield University,4118,3879,Connecticut,Suburb,private,99.61,96.14,100.0,4,2,7,2,1,3,6,3,10,0.3691245205344675,5.183265496478762
Fairleigh Dickinson University - Florham Campus,2747,2640,New Jersey,Suburb,NA,99.8,96.69,100.0,4,2,8,2,1,3,6,3,11,5.420637053198199,0.766035387002483
Fairleigh Dickinson University - Metropolitan Campus,5471,2374,New Jersey,Suburb,NA,100.0,99.9,100.0,9,5,17,4,2,7,13,7,24,11.399102527978314,1.1857219250099562
Fairmont State University,3661,3108,West Virginia,Town,public,52.47,31.17,75.61,1,0,1,0,0,0,1,0,1,0.24424241101008662,0.49866054123489467
Farmingdale State College,9552,7407,New York,Suburb,NA,100.0,99.94,100.0,8,5,13,3,2,6,11,7,19,11.67760230872316,0.046056094205865525
Faulkner University,2673,1744,Alabama,Midsize City,NA,99.29,90.32,100.0,4,2,7,1,1,3,5,3,10,3.125277085781467,1.8150446326423828
Fayetteville State University,5394,3905,North CaroliNA,Midsize City,NA,95.58,78.69,99.84,2,1,5,1,0,2,3,1,7,2.608091579172609,0.5089149732827666
Felician University,1626,1430,New Jersey,Suburb,NA,97.93,88.05,99.93,3,2,5,1,1,2,4,3,7,3.6986449691844534,0.17480351859753934
Ferris State University,12513,8469,Michigan,Town,public,100.0,99.94,100.0,9,5,19,4,2,8,13,7,27,12.708750557192483,0.6184436384688863
Ferrum College,1137,1118,Virginia,Rural,NA,85.86,59.79,97.27,1,1,2,1,0,1,2,1,3,1.690629651060877,0.26373693224164657
Finlandia University,399,336,Michigan,Town,NA,40.52,24.53,65.63,0,0,1,0,0,0,0,0,1,0.3410950746448241,0.1778691541461067
Fisk University,663,639,Tennessee,Large City,NA,65.92,40.27,90.21,1,0,2,0,0,1,1,0,3,0.2355135660142994,0.838918969579457
Fitchburg State University,4119,3386,Massachusetts,Suburb,public,99.95,98.77,100.0,5,3,10,2,1,4,7,4,14,7.480918167411061,0.16997588394319543
Five Towns College,626,591,New York,Suburb,NA,55.36,39.58,73.61,1,0,1,0,0,0,1,0,1,0.6755028680897915,0.13046736571961295
Flagler College - St Augustine,2681,2591,Florida,Suburb,NA,100.0,99.81,100.0,8,4,15,3,2,7,11,6,22,9.51295356142813,1.6424559327506827
Florida Agricultural and Mechanical University,8027,6875,Florida,Midsize City,NA,100.0,100.0,100.0,30,17,58,13,7,26,43,24,84,40.11367439465282,2.265061728365889
Florida Atlantic University,25033,16325,Florida,Small City,public,100.0,100.0,100.0,101,57,196,44,25,89,145,82,285,141.8177041964234,2.868315007830413
Florida Gulf Coast University,13857,10973,Florida,Suburb,NA,100.0,100.0,100.0,56,32,109,24,14,49,80,46,158,78.45563063737191,1.5079153068695916
Florida Institute of Technology,3634,3269,Florida,Small City,private,100.0,99.94,100.0,9,5,18,4,2,8,13,7,26,10.395726020405563,2.9789883839416818
Florida InterNAtioNAl University,47621,26655,Florida,Suburb,public,100.0,100.0,100.0,199,113,388,87,49,176,286,162,564,282.50570657471485,3.016825169089871
Florida Memorial University,1173,1129,Florida,Suburb,private,99.83,97.22,100.0,4,2,9,2,1,4,6,3,13,6.111501639074529,0.2268490713355053
Florida Southern College,2615,2356,Florida,Midsize City,NA,100.0,99.8,100.0,8,4,15,3,2,7,11,6,22,9.86482789822333,1.1635757115240395
Florida State University,33009,29286,Florida,Midsize City,NA,100.0,100.0,100.0,133,75,260,58,32,118,191,107,378,186.9625642838497,3.9703682527653643
Fontbonne University,892,765,Missouri,Suburb,NA,48.63,26.88,77.54,0,0,1,0,0,0,0,0,1,0.4258043788784694,0.23972093688420124
Fordham University,9595,9132,New York,Large City,NA,100.0,99.99,100.0,11,7,20,5,3,9,16,10,29,5.057674201443203,10.955122243287109
Fort Hays State University,12499,5889,Kansas,Town,NA,99.36,91.9,100.0,4,2,7,1,1,3,5,3,10,1.7107831691802475,3.3371713024728478
Fort Lewis College,3303,2921,Colorado,Town,public,96.2,79.01,99.93,2,1,5,1,0,2,3,1,7,0.8989782694247741,2.367252436654943
Fort Valley State University,2345,2115,Georgia,Town,NA,88.78,54.77,99.77,2,1,4,1,0,2,3,1,6,1.7256558628569234,0.46050370492543113
Framingham State University,4128,3558,Massachusetts,Small City,public,99.96,98.98,100.0,6,3,10,2,1,4,8,4,14,7.828317005792155,0.10565311751993026
Francis Marion University,3462,3006,South CaroliNA,Suburb,public,100.0,99.29,100.0,8,4,15,3,1,7,11,5,22,10.696449298066504,0.21943260660978156
Franciscan University of Steubenville,2201,2011,Ohio,Small City,NA,96.65,83.81,99.87,2,1,5,1,1,2,3,2,7,0.2651181553832398,3.1242312540692545
Franklin and Marshall College,2281,2263,Pennsylvania,Small City,NA,96.34,85.28,99.75,2,1,4,1,1,2,3,2,6,0.6486020639492597,2.65602281033939
Franklin College,1017,962,IndiaNA,Suburb,private,54.29,38.63,73.5,1,0,1,0,0,0,1,0,1,0.6587410412752922,0.12352305263414587
Franklin Pierce University,1712,1563,New Hampshire,Rural,NA,88.08,68.33,97.93,2,1,3,1,0,1,3,1,4,0.15438158445470004,1.9710389673141275
Welch College,344,222,Tennessee,Rural,private,30.05,14.55,55.18,0,0,1,0,0,0,0,0,1,0.14915859180905627,0.20792125530008795
Freed - Hardeman University,1469,1261,Tennessee,Town,NA,87.34,59.45,98.99,1,1,3,1,0,1,2,1,4,0.8596245159521928,1.2046813869052397
Fresno Pacific University,2803,2342,California,Large City,private,100.0,99.7,100.0,7,4,13,3,2,6,10,6,19,10.069036777237745,0.11132964898134595
Friends University,1149,906,Kansas,Large City,NA,61.91,37.82,86.4,1,0,1,0,0,1,1,0,2,0.15714663013109662,0.8056862018514103
Frostburg State University,4726,3849,Maryland,Suburb,public,99.3,94.85,99.98,4,2,6,1,1,3,5,3,9,4.594879995004153,0.3702961373628436
Full Sail University,16908,16908,Florida,Suburb,NA,100.0,100.0,100.0,34,18,68,15,8,30,49,26,98,25.865850371436643,22.918691354958003
Furman University,2732,2658,South CaroliNA,Suburb,NA,99.79,95.0,100.0,4,2,9,2,1,4,6,3,13,2.470647256346883,3.705432206076587
Gallaudet University,1125,1074,District of Columbia,Large City,NA,90.44,71.44,99.03,2,1,3,1,0,1,3,1,4,0.025900200510324767,2.3171612712894896
Gannon University,3074,2530,Pennsylvania,Small City,private,96.03,85.78,99.66,2,1,4,1,1,2,3,2,6,2.2818166802359356,0.9418000966410323
Gardner - Webb University,2218,1781,North CaroliNA,Town,NA,93.05,73.56,99.58,2,1,4,1,0,2,3,1,6,0.7736211967274856,1.8892202732267211
Geneva College,1412,1247,Pennsylvania,Suburb,NA,81.02,62.71,94.96,1,1,2,0,0,1,1,1,3,1.004976824360941,0.6554675693058749
George Fox University,2700,2494,Oregon,Town,private,95.48,84.74,99.63,2,1,4,1,1,2,3,2,6,1.0401864242825312,2.054236433184872
George Mason University,25006,20221,Virginia,Suburb,NA,100.0,100.0,100.0,32,16,58,14,6,26,46,22,84,36.65262764956733,9.047381826297913
George Washington University,11996,10893,District of Columbia,Large City,NA,100.0,100.0,100.0,16,9,29,7,4,13,23,13,42,0.14784697791310386,22.089573244638665
Georgetown College,1059,976,Kentucky,Town,private,66.23,39.52,91.51,1,0,2,0,0,1,1,0,3,0.8971425404063191,0.18781018072927788
Georgetown University,7465,6987,District of Columbia,Large City,private,100.0,99.96,100.0,10,6,19,4,2,8,14,8,27,0.11978842736025204,14.04535643257105
Georgia College & State University,5987,5442,Georgia,Town,NA,99.17,78.22,100.0,4,1,10,1,0,4,5,1,14,4.766705278899883,0.020531396190470647
Georgia Gwinnett College,12290,8289,Georgia,Suburb,public,100.0,96.09,100.0,7,2,21,3,1,8,10,3,29,9.706614684645256,0.30256189299744435
Georgia Institute of Technology - Main Campus,15576,13974,Georgia,Large City,NA,100.0,99.99,100.0,16,7,37,6,3,15,22,10,52,8.60593039469165,13.303952260177486
Georgia Southern University,17763,15755,Georgia,Town,NA,100.0,99.55,100.0,11,4,32,4,1,13,15,5,45,13.634437303109141,2.014010193256334
Georgia Southwestern State University,2604,1779,Georgia,Town,public,88.22,50.32,99.81,2,1,4,1,0,2,3,1,6,2.0409352642577026,0.09679495568249621
Georgia State University,25771,19882,Georgia,Large City,NA,100.0,99.93,100.0,16,5,45,6,2,18,22,7,63,19.832271611658637,1.7860252155399803
Georgian Court University,1612,1343,New Jersey,Small City,private,97.49,86.8,99.9,3,1,5,1,1,2,4,2,7,3.482789623441885,0.19781623756956895
Gettysburg College,2411,2404,Pennsylvania,Small City,NA,95.86,84.08,99.68,2,1,4,1,1,2,3,2,6,0.676093831181018,2.5055911004318645
Glenville State College,1655,1037,West Virginia,Town,NA,31.97,17.36,50.71,0,0,0,0,0,0,0,0,0,0.10607634679534615,0.27877518808470836
Goddard College,189,173,Vermont,Rural,NA,24.63,14.59,40.2,0,0,0,0,0,0,0,0,0,0.0,0.28243809354835514
Gonzaga University,5194,5106,Washington,Midsize City,private,99.98,99.32,100.0,6,4,12,3,1,6,9,5,18,3.210066419044003,5.429020859046457
Gordon College,1593,1528,Massachusetts,Suburb,NA,90.35,72.51,98.68,2,1,3,1,0,1,3,1,4,1.0145625166356953,1.3204508714751535
Goshen College,888,816,IndiaNA,Small City,private,54.8,37.39,76.0,1,0,1,0,0,0,1,0,1,0.36488404400449587,0.42850906642822567
Goucher College,1534,1447,Maryland,Small City,NA,91.62,75.2,98.99,2,1,3,1,0,1,3,1,4,0.29742012232027787,2.1779156876631114
Grace Bible College,873,822,Michigan,Small City,NA,65.2,44.26,87.73,1,0,1,0,0,1,1,0,2,0.7564348185341051,0.2980352104447844
Grace College and Theological SemiNAry,1761,1439,IndiaNA,Town,private,78.09,59.86,93.25,1,1,2,0,0,1,1,1,3,0.6545629797027216,0.8623745346364395
Graceland University - Lamoni,1405,1061,Iowa,Rural,private,97.44,84.0,99.94,3,1,5,1,1,2,4,2,7,0.27419911353906484,3.3842684236007643
Grambling State University,4075,3734,LouisiaNA,Town,NA,100.0,99.61,100.0,8,4,17,3,2,7,11,6,24,5.021324438105947,6.4396641546172235
Grand Canyon University,49564,15998,ArizoNA,Large City,NA,100.0,100.0,100.0,91,49,177,37,20,75,128,69,252,44.59052341306536,83.74509909082832
Grand Valley State University,21935,19373,Michigan,Suburb,NA,100.0,100.0,100.0,16,9,33,7,4,14,23,13,47,22.530567091444706,0.7961584254984476
Grand View University,1787,1574,Iowa,Midsize City,NA,91.69,66.92,99.69,2,1,4,1,0,2,3,1,6,1.1074597530161119,1.3759028615715743
Granite State College,1758,807,New Hampshire,Town,NA,54.19,0.0,81.97,1,0,1,0,0,0,1,0,1,0.780484676965428,7.285240992894649e-05
Grantham University,7817,3296,Kansas,Suburb,NA,100.0,99.99,100.0,13,6,26,5,3,12,18,9,38,0.036358730886838816,18.041836026394733
Greensboro College,944,772,North CaroliNA,Large City,NA,75.16,52.06,93.64,1,1,2,0,0,1,1,1,3,0.2672602678304087,1.1227147552355246
Greenville University,988,887,Illinois,Town,NA,53.58,35.61,77.18,1,0,1,0,0,0,1,0,1,0.3313476681676312,0.43528686449763204
Grinnell College,1717,1662,Iowa,Town,private,92.14,74.68,99.38,2,1,4,1,0,2,3,1,6,0.22012095503552706,2.3186095679546046
Grove City College,2376,2315,Pennsylvania,Town,NA,93.62,79.1,99.36,2,1,4,1,0,2,3,1,6,1.040614300402109,1.7096592509786654
Guilford College,1669,1429,North CaroliNA,Large City,NA,84.9,62.81,97.45,1,1,3,1,0,1,2,1,4,0.41471420870235826,1.473382849879915
Gustavus Adolphus College,2184,2150,Minnesota,Town,private,58.24,37.45,83.61,1,0,1,0,0,1,1,0,2,0.35163744287401777,0.5206077545344163
Gwynedd Mercy University,2081,1934,Pennsylvania,Suburb,private,91.64,76.99,98.82,2,1,3,1,0,1,3,1,4,1.7401270444101802,0.7403624484283411
Hamilton College,1894,1886,New York,Suburb,private,95.6,83.42,99.67,2,1,4,1,1,2,3,2,6,0.7344558456685369,2.384061213540017
Hamline University,2166,2082,Minnesota,Large City,NA,61.6,41.54,83.85,1,0,1,0,0,1,1,0,2,0.3347261894024647,0.6211432905575219
Hampden - Sydney College,1044,1039,Virginia,Rural,NA,83.04,55.96,96.57,1,1,2,1,0,1,2,1,3,1.326093444671513,0.4460451747092186
Hampshire College,1264,1268,Massachusetts,Suburb,private,88.2,69.45,98.28,2,1,3,1,0,1,3,1,4,0.44411783315764874,1.6899079091179896
Hampton University,3796,3651,Virginia,Midsize City,NA,99.87,96.89,100.0,5,2,9,2,1,4,7,3,13,1.7482858877857252,4.8672683954261
Hannibal - LaGrange University,913,706,Missouri,Town,NA,50.71,29.82,78.0,1,0,1,0,0,0,1,0,1,0.3408715108023088,0.36602592084929786
Hanover College,1096,1081,IndiaNA,Town,NA,64.24,44.11,85.82,1,0,1,0,0,1,1,0,2,0.4630684909599041,0.5642505741355279
Hardin - Simmons University,1741,1585,Texas,Midsize City,NA,100.0,99.56,100.0,8,4,17,4,2,8,12,6,25,11.27793650975249,0.15537262442979874
Harding University,4187,3945,Arkansas,Town,NA,99.99,98.63,100.0,6,3,14,3,1,6,9,4,20,0.5784905065988333,8.47864034792148
Harris - Stowe State University,1441,1163,Missouri,Large City,NA,56.09,31.65,84.5,1,0,1,0,0,1,1,0,2,0.7267745422624478,0.0959259780984723
Harrisburg University of Science and Technology,509,463,Pennsylvania,Small City,NA,41.21,27.53,60.7,0,0,1,0,0,0,0,0,1,0.4561596933269519,0.07471243466500319
Hartwick College,1198,1180,New York,Town,private,77.53,60.34,91.72,1,1,2,0,0,1,1,1,3,1.1274756961935066,0.3644865848437207
Harvard University,9964,7147,Massachusetts,Midsize City,NA,100.0,100.0,100.0,15,8,29,6,3,12,21,11,41,2.931177698840482,18.16275720284771
Harvey Mudd College,867,844,California,Suburb,NA,87.88,69.08,98.21,1,1,3,1,0,1,2,1,4,1.3435171201126557,0.7627262114888538
Hastings College,1156,1073,Nebraska,Town,NA,35.5,20.67,59.64,0,0,1,0,0,0,0,0,1,0.07502632805089594,0.36287980338771264
Haverford College,1293,1294,Pennsylvania,Suburb,private,86.98,68.68,97.65,1,1,3,1,0,1,2,1,4,0.1792055938070168,1.8566690038419238
Hawaii Pacific University,3565,2411,Hawaii,Large City,NA,97.41,86.24,99.92,3,1,5,1,1,2,4,2,7,0.003383583024651294,3.6454196294552954
Heidelberg University,1049,1031,Ohio,Town,NA,69.76,47.84,90.22,1,0,2,0,0,1,1,0,3,0.5653558586224413,0.6288513656764757
Henderson State University,2838,2565,Arkansas,Town,public,96.61,77.24,99.94,2,1,5,1,0,2,3,1,7,1.3027966770974642,2.0754326001617103
Hendrix College,1240,1228,Arkansas,Small City,NA,92.05,69.53,99.57,2,1,4,1,0,2,3,1,6,0.3165525503570151,2.2093410537268645
Heritage University,812,734,Washington,Rural,private,65.41,50.27,81.44,1,0,1,0,0,1,1,0,2,1.0608766513079895,0.0
Herzing University - Atlanta,593,365,Georgia,Large City,NA,37.72,13.95,75.62,0,0,1,0,0,0,0,0,1,0.47331818995104324,0.0
High Point University,4467,4418,North CaroliNA,Midsize City,NA,99.61,95.26,100.0,4,2,7,2,1,3,6,3,10,0.5416884355643149,5.00739816791048
Hilbert College,744,680,New York,Suburb,private,59.65,43.89,77.02,1,0,1,0,0,0,1,0,1,0.8842946636811817,0.022811513668998324
Hiram College,1209,853,Ohio,Town,NA,68.57,47.17,88.96,1,0,2,0,0,1,1,0,3,0.7099657615587539,0.44618857478899976
Hobart and William Smith Colleges,2239,2220,New York,Town,private,95.23,83.49,99.52,2,1,4,1,1,2,3,2,6,1.147126688719755,1.8935643353194314
Hodges University,1076,573,Florida,Suburb,NA,99.82,97.16,100.0,4,2,9,2,1,4,6,3,13,6.204100148757477,0.09899820081768144
Hofstra University,6863,6494,New York,Suburb,NA,100.0,99.76,100.0,7,4,13,3,2,5,10,6,18,4.550432956859414,5.6088686639584
Hollins University,647,632,Virginia,Suburb,NA,73.59,47.29,93.21,1,0,2,0,0,1,1,0,3,0.5933012746847302,0.7356963896347712
Holy Cross College,555,526,IndiaNA,Suburb,NA,41.95,27.63,62.64,0,0,1,0,0,0,0,0,1,0.2095994222239566,0.33363213297319805
Holy Family University,2095,1630,Pennsylvania,Large City,private,91.85,77.3,98.87,2,1,3,1,0,1,3,1,4,1.725872053993713,0.7792725605499747
Holy Names University,591,543,California,Large City,private,85.81,67.05,97.49,1,1,3,1,0,1,2,1,4,1.9051513260613888,0.043836129290667956
Hood College,1132,1048,Maryland,Small City,NA,74.99,55.06,91.78,1,1,2,0,0,1,1,1,3,0.8526043506514632,0.5323361420420267
Hope College,3150,3019,Michigan,Small City,private,96.57,84.95,99.87,2,1,5,1,1,2,3,2,7,2.292976668984606,1.0759166399827136
Hope InterNAtioNAl University,866,579,California,Suburb,NA,93.92,79.65,99.49,2,1,4,1,0,2,3,1,6,2.609947192349995,0.1854432439544581
Houghton College,1036,971,New York,Rural,private,74.9,55.87,91.22,1,1,2,0,0,1,1,1,3,0.7467377159974423,0.6341659468715595
Houston Baptist University,2320,2098,Texas,Large City,NA,100.0,99.94,100.0,11,5,23,5,2,11,16,7,34,15.398197130767137,0.12754144125190017
Howard Payne University,980,860,Texas,Town,private,99.85,95.37,100.0,4,2,10,2,1,4,6,3,14,6.408537594007906,0.07236094541116839
Howard University,6354,6090,District of Columbia,Large City,NA,100.0,99.87,100.0,9,5,17,4,2,8,13,7,25,0.0744630764671837,12.48389399838149
Humboldt State University,7860,7270,California,Town,NA,100.0,100.0,100.0,19,11,35,8,4,15,27,15,50,25.68099937789109,0.9405290658734096
Humphreys University - Stockton and Modesto Campuses,324,208,California,Large City,NA,69.62,49.45,89.24,1,0,2,0,0,1,1,0,3,1.189343024362023,0.0
Huntingdon College,1101,878,Alabama,Midsize City,private,90.62,69.42,99.19,2,1,3,1,0,1,3,1,4,1.2569697439474123,1.1055498352206847
Huntington University,1075,859,IndiaNA,Town,NA,59.45,41.97,79.64,1,0,1,0,0,0,1,0,1,0.4874405167998991,0.4144836383880329
Huston - Tillotson University,1052,1003,Texas,Large City,NA,99.91,96.41,100.0,5,2,10,2,1,5,7,3,15,6.946555096586678,0.06208454018120164
Idaho State University,10565,6279,Idaho,Small City,public,100.0,98.14,100.0,8,3,22,4,1,11,12,4,33,10.876901010497598,1.371058119696332
Illinois College,956,950,Illinois,Town,NA,49.68,33.78,72.42,0,0,1,0,0,0,0,0,1,0.43769958101498385,0.24854503177156864
Illinois Institute of Technology,2895,2631,Illinois,Large City,NA,91.3,76.1,98.96,2,1,3,1,0,1,3,1,4,1.1303230938299034,1.308782987204438
Illinois State University,18336,17165,Illinois,Suburb,NA,100.0,99.86,100.0,7,5,12,3,2,5,10,7,17,9.688712703566107,0.2922691617543942
Illinois Wesleyan University,1650,1646,Illinois,Small City,NA,61.91,45.43,82.5,1,0,1,0,0,1,1,0,2,0.7674439540140621,0.19720934365989656
Immaculata University,1481,885,Pennsylvania,Suburb,NA,84.68,66.64,96.58,1,1,2,1,0,1,2,1,3,1.0202500283785843,0.854036149508231
IndiaNA State University,11578,9369,IndiaNA,Small City,public,99.97,99.46,100.0,6,4,10,2,2,4,8,6,14,7.0713692115756785,1.1065430076979386
IndiaNA University - Bloomington,33427,32212,IndiaNA,Small City,public,100.0,100.0,100.0,20,12,36,8,5,15,28,17,51,16.01451000766297,12.792469333272207
IndiaNA University - East,3292,1887,IndiaNA,Rural,public,89.88,76.33,97.78,2,1,3,1,0,1,3,1,4,1.9274790721458865,0.3625890525847753
IndiaNA University - Kokomo,2877,2215,IndiaNA,Small City,NA,86.45,72.44,96.09,1,1,2,1,0,1,2,1,3,1.9922390265207304,0.00611521178115398
IndiaNA University - Northwest,3700,2608,IndiaNA,Small City,NA,92.38,81.01,98.46,2,1,3,1,0,1,3,1,4,2.565329805558326,0.00855090756561629
IndiaNA University of Pennsylvania - Main Campus,10255,9526,Pennsylvania,Town,NA,100.0,99.86,100.0,8,5,14,3,2,6,11,7,20,9.536588588616588,1.4242050291144475
IndiaNA University - Purdue University - Fort Wayne,9952,5913,IndiaNA,Large City,public,99.91,98.91,100.0,5,3,8,2,1,3,7,4,11,6.716930321502609,0.3288492022992215
IndiaNA University - Purdue University - IndiaNApolis,21615,17521,IndiaNA,Large City,NA,100.0,100.0,100.0,11,7,18,4,3,7,15,10,25,14.513889559514709,1.062550421758402
IndiaNA University - South Bend,4877,3767,IndiaNA,Midsize City,NA,96.7,88.84,99.61,2,2,4,1,1,2,3,3,6,3.3271296989570254,0.08333889999503559
IndiaNA University - Southeast,4824,3218,IndiaNA,Suburb,NA,97.51,88.6,99.88,3,2,5,1,1,2,4,3,7,2.596665267352605,1.0932284659826044
IndiaNA Wesleyan University,2803,2634,IndiaNA,Town,private,89.02,72.98,98.12,2,1,3,1,0,1,3,1,4,1.134343716952908,1.073339804478798
Institute of American Indian and Alaska Native Culture and Arts Development,612,264,New Mexico,Rural,NA,63.24,36.39,91.96,1,0,2,0,0,1,1,0,3,0.4521239939993288,0.5476170046787081
IoNA College,3177,2949,New York,Suburb,private,98.47,92.39,99.91,3,2,5,1,1,2,4,3,7,2.9279978864110237,1.2464381371192157
Iowa State University,30573,28743,Iowa,Small City,public,100.0,100.0,100.0,16,7,38,6,3,16,22,10,54,15.656769383080603,7.0063820656596665
Iowa Wesleyan University,625,550,Iowa,Town,private,44.07,24.9,72.11,0,0,1,0,0,0,0,0,1,0.15614116187641192,0.42417043489967887
Ithaca College,6062,5936,New York,Suburb,NA,99.98,99.37,100.0,6,4,11,3,1,5,9,5,16,3.120823250574837,5.540801252287483
Jackson State University,6498,5935,Mississippi,Midsize City,NA,100.0,100.0,100.0,15,8,30,6,3,12,21,11,42,17.30554595692715,3.949568495278003
Jacksonville State University,7492,5523,Alabama,Small City,NA,100.0,99.2,100.0,8,4,16,3,1,6,11,5,22,8.788350736448457,1.853551267489762
Jacksonville University,2878,2180,Florida,Large City,NA,100.0,99.94,100.0,9,5,18,4,2,8,13,7,26,11.753837495755459,1.3817030309035605
James Madison University,19972,18905,Virginia,Small City,NA,100.0,100.0,100.0,25,12,44,11,5,20,36,17,64,26.11641535775229,9.051253727565806
University of Jamestown,916,871,North Dakota,Town,NA,74.49,43.89,97.42,1,0,2,0,0,1,1,0,3,0.7162537375029212,0.6479285416777055
Jarvis Christian College,908,835,Texas,Rural,NA,99.67,93.27,100.0,4,2,8,2,1,4,6,3,12,5.57086477353716,0.11538350697807373
John Brown University,1972,1489,Arkansas,Town,NA,97.39,82.14,99.96,3,1,5,1,0,2,4,1,7,0.3425342504700699,3.295764426321459
John Carroll University,3079,2987,Ohio,Suburb,private,93.14,78.4,99.23,2,1,3,1,0,1,3,1,4,1.4109794815071646,1.2672947928572937
Johns Hopkins University,6106,5668,Maryland,Large City,NA,100.0,99.82,100.0,8,4,15,3,2,6,11,6,21,0.7524207305014748,10.47454099645433
Johnson & Wales University - Providence,7717,7267,Rhode Island,Midsize City,private,100.0,99.8,100.0,8,4,14,3,2,6,11,6,20,0.43003228951947875,10.459041617537443
Johnson C Smith University,1395,1329,North CaroliNA,Large City,NA,85.72,62.1,97.93,1,1,3,1,0,1,2,1,4,0.28773998184040167,1.6562164915052469
Johnson State College,1377,882,Vermont,Rural,NA,43.88,27.19,65.28,0,0,1,0,0,0,0,0,1,0.0022684733160634025,0.5748035134358719
Judson College,313,230,Alabama,Rural,NA,41.92,22.98,67.74,0,0,1,0,0,0,0,0,1,0.36829362604390375,0.17448150407639806
Judson University,1078,761,Illinois,Midsize City,private,49.11,34.01,70.5,0,0,1,0,0,0,0,0,1,0.46174900854327966,0.21339608466192733
Juniata College,1487,1400,Pennsylvania,Town,NA,84.3,66.17,96.46,1,1,2,1,0,1,2,1,3,0.9418475810880145,0.9077418145061527
Kalamazoo College,1434,1427,Michigan,Small City,NA,82.42,62.13,96.73,1,1,2,1,0,1,2,1,3,1.0674016216014683,0.6693270277096429
Kansas State University,18484,16770,Kansas,Small City,NA,99.97,98.29,100.0,6,3,11,2,1,5,8,4,16,2.689322474490458,5.458165793244047
Kansas Wesleyan University,693,631,Kansas,Town,NA,78.32,52.27,96.12,1,1,2,0,0,1,1,1,3,0.0686970251852291,1.4556381704872665
Kaplan University - Davenport Campus,25486,3127,Iowa,Midsize City,NA,100.0,100.0,100.0,38,20,78,16,8,34,54,28,112,0.5659165037764589,53.968656345635374
Kean University,11985,9516,New Jersey,Suburb,NA,100.0,100.0,100.0,21,11,38,8,4,15,29,15,53,27.964181307997865,0.5862116225849654
Keene State College,3778,3624,New Hampshire,Town,NA,95.22,74.08,99.66,2,1,4,1,0,2,3,1,6,0.775067779265263,2.262639355731894
Kent State University at Kent,23179,19108,Ohio,Suburb,public,100.0,99.99,100.0,13,7,23,5,3,9,18,10,32,13.784078224172237,3.8486994177824245
Kentucky Christian University,589,439,Kentucky,Town,NA,50.11,29.85,76.82,0,0,1,0,0,0,0,0,1,0.3007181699685986,0.39377239572532974
Kentucky State University,1762,1122,Kentucky,Town,public,82.38,60.05,97.16,1,1,3,1,0,1,2,1,4,0.6124626728360458,1.122398189900875
Kentucky Wesleyan College,716,673,Kentucky,Small City,private,55.19,32.43,82.58,1,0,1,0,0,1,1,0,2,0.4881658292490251,0.3139090764995244
Kenyon College,1678,1661,Ohio,Town,NA,91.05,73.79,98.95,2,1,3,1,0,1,3,1,4,0.17353188352357515,2.2365971744495803
Kettering University,1891,1807,Michigan,Small City,NA,89.54,71.28,98.87,2,1,3,1,0,1,3,1,4,1.3654563082784914,0.8898323428404827
Keuka College,1645,1312,New York,Town,private,86.26,71.41,96.06,1,1,2,1,0,1,2,1,3,1.8484214845002478,0.13544938118774297
Keystone College,1454,1065,Pennsylvania,Suburb,private,79.69,61.68,93.96,1,1,2,0,0,1,1,1,3,1.2310202438220643,0.3619123404253202
King University,1798,1608,Tennessee,Small City,NA,91.86,66.2,99.54,2,1,4,1,0,2,3,1,6,1.0480353687636323,1.4569956357085507
King's College,2198,2025,Pennsylvania,Small City,NA,94.24,81.35,99.4,2,1,4,1,0,2,3,1,6,1.4519725952773066,1.3999971800434323
Knox College,1354,1334,Illinois,Town,private,67.76,47.41,88.77,1,0,2,0,0,1,1,0,3,0.4013582238611146,0.7296157024245922
Kutztown University of Pennsylvania,7489,7053,Pennsylvania,Town,NA,99.98,99.47,100.0,6,4,11,3,2,5,9,6,16,6.5929330676161015,2.2033706552506236
Kuyper College,182,146,Michigan,Suburb,NA,17.36,10.01,31.91,0,0,0,0,0,0,0,0,0,0.17216155187120458,0.018447634452043612
La Roche College,1379,1163,Pennsylvania,Suburb,NA,75.13,57.05,91.33,1,1,2,0,0,1,1,1,3,1.2371295254291217,0.1538144212959411
La Salle University,3822,3322,Pennsylvania,Large City,NA,99.48,95.27,99.99,4,2,7,2,1,3,6,3,10,2.3571644867229766,2.891993568054766
La Sierra University,2027,1830,California,Large City,private,99.92,98.33,100.0,5,3,9,2,1,4,7,4,13,6.9561883677964005,0.18327750899966275
Lafayette College,2590,2551,Pennsylvania,Suburb,NA,98.52,90.88,99.96,3,2,5,1,1,2,4,3,7,0.5477989174328127,3.6611832000856976
LaGrange College,940,888,Georgia,Town,NA,69.59,39.56,95.03,1,0,2,0,0,1,1,0,3,0.6417332625980418,0.5469727658957109
Lake Erie College,959,724,Ohio,Suburb,private,63.69,42.54,85.93,1,0,1,0,0,1,1,0,2,0.45793135929832335,0.5538689315485744
Lake Forest College,1505,1487,Illinois,Suburb,NA,78.71,59.44,94.47,1,1,2,0,0,1,1,1,3,0.443043898243494,1.1019690713566046
Lake Superior State University,1962,1706,Michigan,Town,public,88.88,70.5,98.78,2,1,3,1,0,1,3,1,4,1.951881594339782,0.24322690371212027
Lakeland University,1997,779,Wisconsin,Rural,private,49.39,33.72,71.3,0,0,1,0,0,0,0,0,1,0.3024700149907898,0.37796027581946623
Lamar University,9270,5967,Texas,Midsize City,NA,100.0,100.0,100.0,43,21,92,19,9,42,62,30,134,61.80390931521971,0.3463315510808554
Lander University,2785,2600,South CaroliNA,Town,NA,99.99,98.22,100.0,6,3,13,3,1,5,9,4,18,8.506777612049268,0.36294153149435193
Lane College,1416,1370,Tennessee,Small City,NA,77.75,46.53,96.96,1,0,2,0,0,1,1,0,3,0.9185029074557677,0.5827591673762937
Langston University,2028,1822,Oklahoma,Rural,NA,97.18,82.68,99.95,3,1,5,1,1,2,4,2,7,0.9697230635840016,2.5906971544891375
Lasell College,1733,1669,Massachusetts,Small City,NA,92.05,76.28,98.97,2,1,3,1,0,1,3,1,4,2.038994318452672,0.4903680683116596
Lawrence Technological University,2191,1672,Michigan,Small City,NA,91.33,74.46,99.24,2,1,3,1,0,1,3,1,4,2.170311563276373,0.2734020560481144
Lawrence University,1471,1434,Wisconsin,Small City,private,65.21,45.89,85.64,1,0,1,0,0,1,1,0,2,0.08636772357873732,0.9682398568854786
Le Moyne College,2793,2410,New York,Suburb,NA,97.21,89.43,99.72,3,2,4,1,1,2,4,3,6,3.099944071015698,0.47709323547658483
Le Moyne - Owen College,867,770,Tennessee,Large City,private,60.42,29.88,89.26,1,0,2,0,0,1,1,0,3,0.7742508482720093,0.15198113561767132
Lebanon Valley College,1756,1624,Pennsylvania,Suburb,private,87.61,71.06,97.56,1,1,3,1,0,1,2,1,4,1.312477331916163,0.7739492430276881
Lee University,4856,3854,Tennessee,Small City,NA,99.83,94.3,100.0,5,2,10,2,1,4,7,3,14,2.233453651035606,4.144227456247759
Lees - McRae College,920,891,North CaroliNA,Rural,NA,74.8,50.49,94.01,1,1,2,0,0,1,1,1,3,0.2539484537239132,1.1217168258854417
Lehigh University,5065,5013,Pennsylvania,Small City,NA,99.97,99.02,100.0,6,3,11,2,1,4,8,4,15,1.2065831173938348,6.915372261729867
Lenoir - Rhyne University,1698,1441,North CaroliNA,Small City,private,80.3,56.44,96.35,1,1,2,0,0,1,1,1,3,0.6579108125710251,0.9647355480490493
Lesley University,2097,1645,Massachusetts,Midsize City,private,95.45,82.25,99.67,2,1,4,1,0,2,3,1,6,1.7981837600294133,1.287944028998937
LeTourneau University,2606,1301,Texas,Small City,NA,100.0,99.87,100.0,10,5,20,4,2,9,14,7,29,12.660437180935917,1.1991579894522666
Lewis & Clark College,2113,2067,Oregon,Large City,NA,98.57,90.62,99.97,3,2,6,1,1,2,4,3,8,0.20658062659207493,4.036038372051013
Lewis - Clark State College,3746,2215,Idaho,Small City,NA,98.65,79.86,100.0,3,1,7,1,0,4,4,1,11,3.3985500678353313,0.90104619312386
Lewis University,4502,3687,Illinois,Suburb,private,92.71,81.48,98.98,2,1,3,1,0,1,3,1,4,2.251026416648488,0.3662613763212194
Liberty University,45756,26892,Virginia,Small City,NA,100.0,100.0,100.0,60,30,117,25,12,51,85,42,168,23.092252747603794,62.28946828614364
Life University,760,624,Georgia,Small City,NA,61.27,35.35,89.78,1,0,2,0,0,1,1,0,3,0.3679589975842006,0.5792251965502434
Limestone College,2599,1943,South CaroliNA,Town,private,99.92,96.41,100.0,5,2,10,2,1,4,7,3,14,5.677644283212836,1.4061202634127532
Lincoln Memorial University,1923,1355,Tennessee,Town,NA,89.84,60.94,99.53,2,1,4,1,0,2,3,1,6,1.3777543611836514,0.9065398906255974
Lincoln University California,107,72,California,Large City,private,32.53,20.17,52.11,0,0,1,0,0,0,0,0,1,0.3927768629837545,0.0
Lincoln University Missouri,2513,1804,Missouri,Small City,NA,86.97,62.06,98.88,1,1,3,1,0,1,2,1,4,1.01976443616276,1.015911113370538
Lincoln University of Pennsylvania,2002,1826,Pennsylvania,Suburb,NA,92.98,78.93,99.13,2,1,3,1,0,1,3,1,4,0.7707876960904075,1.8839386435698549
Lindenwood University,6931,6215,Missouri,Small City,private,99.75,94.53,100.0,4,2,9,2,1,4,6,3,13,2.7891041845412996,3.210946078176285
Lindsey Wilson College,2071,1919,Kentucky,Town,NA,88.44,62.85,99.28,2,1,3,1,0,1,3,1,4,1.8333784429085562,0.323210461964613
Linfield College - McMinnville Campus,1536,1505,Oregon,Town,NA,82.55,64.94,96.23,1,1,2,1,0,1,2,1,3,0.5661103709494361,1.1777383459102735
Lipscomb University,2994,2723,Tennessee,Large City,NA,97.73,80.35,99.98,3,1,6,1,0,2,4,1,8,1.9331738543673742,1.8484564594130155
Livingstone College,1153,1140,North CaroliNA,Suburb,private,74.12,50.87,92.93,1,1,2,0,0,1,1,1,3,0.35839499517487755,0.9915768345866771
Lock Haven University,3471,3176,Pennsylvania,Town,public,97.74,89.77,99.88,3,2,5,1,1,2,4,3,7,3.2297735429310075,0.5581027153380341
LIU Brooklyn,3947,3396,New York,Large City,NA,99.58,96.51,99.99,4,2,7,2,1,3,6,3,10,3.889668333164309,1.5874660851827607
LIU Post,6317,2845,New York,Suburb,private,99.98,99.45,100.0,6,4,10,2,1,4,8,5,14,6.939256735831495,1.4014372251833143
Longwood University,4469,3959,Virginia,Town,NA,99.97,97.69,100.0,6,3,10,3,1,5,9,4,15,8.043974962418364,0.2024004299127132
Loras College,1395,1335,Iowa,Small City,NA,58.05,37.54,83.59,1,0,1,0,0,1,1,0,2,0.35798217600933463,0.5103542281274088
LouisiaNA College,985,866,LouisiaNA,Suburb,NA,91.45,68.38,99.52,2,1,4,1,0,2,3,1,6,2.0745165770392706,0.3815242920583846
LouisiaNA State University - Alexandria,3372,1844,LouisiaNA,Rural,public,99.96,97.38,100.0,6,3,12,2,1,5,8,4,17,7.348941076831926,0.4277377385711178
LouisiaNA State University and Agricultural & Mechanical College,25448,22060,LouisiaNA,Midsize City,NA,100.0,100.0,100.0,52,25,111,21,10,47,73,35,158,42.13212098291957,31.222040622154697
LouisiaNA State University - Shreveport,2641,1641,LouisiaNA,Midsize City,public,99.85,95.32,100.0,5,2,10,2,1,4,7,3,14,5.394195064697973,1.1181948069353314
LouisiaNA Tech University,11323,8090,LouisiaNA,Town,NA,100.0,100.0,100.0,20,10,43,8,4,18,28,14,61,22.86487878701889,5.257782535439016
Lourdes University,1046,827,Ohio,Suburb,NA,55.81,36.2,78.52,1,0,1,0,0,0,1,0,1,0.6252656755531993,0.190871614585173
Loyola Marymount University,6395,6164,California,Large City,NA,100.0,100.0,100.0,14,8,27,6,3,12,20,11,39,16.647131529264737,3.588180683784047
Loyola University Maryland,3927,3886,Maryland,Large City,private,99.78,96.99,100.0,4,3,8,2,1,3,6,4,11,0.6918931266608569,5.403896715447355
Loyola University Chicago,11426,10681,Illinois,Large City,private,99.99,99.61,100.0,7,4,12,3,2,5,10,6,17,3.60100094857016,5.817800093744108
Loyola University New Orleans,2607,2446,LouisiaNA,Large City,private,99.83,95.85,100.0,5,2,9,2,1,4,7,3,13,2.5310006168670838,3.829587202457742
Lubbock Christian University,1482,1276,Texas,Large City,NA,99.99,98.8,100.0,6,3,14,3,1,6,9,4,20,9.125866499437402,0.21449393238915349
Luther College,2046,2014,Iowa,Town,NA,64.67,40.47,89.45,1,0,2,0,0,1,1,0,3,0.46537682881213505,0.5744807294299316
Lycoming College,1222,1199,Pennsylvania,Small City,private,78.86,59.81,93.84,1,1,2,0,0,1,1,1,3,0.7473687832633542,0.8053135883425769
University of Lynchburg,2051,1928,Virginia,Small City,private,96.77,81.18,99.81,2,1,4,1,0,2,3,1,6,2.4587595145241794,0.971160877531206
Lyndon State College,1069,871,Vermont,Town,NA,32.59,18.34,51.92,0,0,1,0,0,0,0,0,1,0.0016957026448978924,0.39225475827547984
Lynn University,2205,1826,Florida,Small City,NA,99.87,97.49,100.0,5,3,9,2,1,4,7,4,13,4.259531445415581,2.346631662268168
Lyon College,670,652,Arkansas,Town,NA,54.34,29.02,82.38,1,0,1,0,0,1,1,0,2,0.2889801339105079,0.4934665352797608
Macalester College,2138,2093,Minnesota,Large City,NA,92.96,76.97,99.41,2,1,4,1,0,2,3,1,6,0.06511804497666995,2.5839464984831264
MadonNA University,2455,1358,Michigan,Small City,NA,93.09,77.38,99.53,2,1,4,1,0,2,3,1,6,2.602867462352774,0.06771850375512328
Maharishi University of MaNAgement,325,261,Iowa,Town,NA,36.98,21.26,61.29,0,0,1,0,0,0,0,0,1,0.08225973406171945,0.3788239508635807
Maine Maritime Academy,1021,989,Maine,Rural,NA,42.98,23.24,67.08,0,0,1,0,0,0,0,0,1,0.2629423182977233,0.2983192751502569
Malone University,1334,1099,Ohio,Small City,NA,68.86,47.07,89.14,1,0,2,0,0,1,1,0,3,0.7788276200998552,0.38680144142315964
Manchester University,1264,1244,IndiaNA,Town,NA,61.45,45.04,80.33,1,0,1,0,0,0,1,0,1,0.7938316987884071,0.1589776625393962
Manhattan College,3666,3479,New York,Large City,NA,99.51,95.92,99.99,4,2,6,2,1,3,6,3,9,3.123279624640618,2.1848096102874943
Manhattanville College,1731,1633,New York,Suburb,NA,92.44,78.35,98.99,2,1,3,1,0,1,3,1,4,1.1950259830024859,1.3845805481387878
Mansfield University of Pennsylvania,1827,1655,Pennsylvania,Town,NA,85.41,69.3,96.45,1,1,2,1,0,1,2,1,3,1.554812168996106,0.3690396915537314
MaraNAtha Baptist University,933,591,Wisconsin,Town,NA,59.57,38.03,84.62,1,0,1,0,0,1,1,0,2,0.04537965137187893,0.8589892383738121
Marian University IndiaNA,2301,1961,IndiaNA,Large City,NA,82.66,66.69,94.81,1,1,2,1,0,1,2,1,3,1.419844591078563,0.3311452887134032
Marian University Wisconsin,1508,1254,Wisconsin,Small City,NA,28.78,20.48,42.06,0,0,0,0,0,0,0,0,0,0.24153685407612976,0.09776872190300254
Marietta College,1063,960,Ohio,Town,NA,64.0,43.1,85.54,1,0,1,0,0,1,1,0,2,0.4765240611044207,0.5440755096420163
Marist College,5697,5085,New York,Suburb,private,99.98,99.28,100.0,6,4,10,2,1,4,8,5,14,3.6550846098822176,4.644179564708115
Marquette University,8334,8026,Wisconsin,Large City,NA,99.24,94.84,99.98,3,2,6,1,1,3,4,3,9,0.5160105518899136,4.355500677567142
Mars Hill University,1265,1199,North CaroliNA,Suburb,private,77.69,52.3,95.56,1,1,2,0,0,1,1,1,3,0.4223941014561057,1.075387740396109
Marshall University,9492,7846,West Virginia,Small City,NA,97.21,84.17,99.9,3,1,5,1,1,2,4,2,7,0.5088203283398793,3.0669905011042937
Martin Luther College,896,743,Minnesota,Town,private,49.73,32.3,72.95,0,0,1,0,0,0,0,0,1,0.021187662395394106,0.6653439307460355
Martin Methodist College,979,810,Tennessee,Town,NA,65.46,33.18,92.17,1,0,2,0,0,1,1,0,3,0.8694375812027886,0.19276252305261626
Martin University,263,159,IndiaNA,Large City,NA,16.74,11.15,25.67,0,0,0,0,0,0,0,0,0,0.18313836559767638,0.0
Mary Baldwin University,1133,720,Virginia,Small City,private,85.55,60.83,97.22,1,1,2,1,0,1,2,1,3,1.3335329590876224,0.5985957545603833
Marymount Manhattan College,2149,1915,New York,Large City,private,97.94,88.93,99.92,3,2,5,1,1,2,4,3,7,0.9211402746678976,2.9554473743002667
Marymount University,2306,2069,Virginia,Midsize City,NA,97.66,84.73,99.89,3,1,5,1,1,2,4,2,7,2.308109347597963,1.4447724919699068
Maryville College,1184,1158,Tennessee,Suburb,NA,83.95,56.22,98.45,1,1,3,1,0,1,2,1,4,0.838035772400882,0.9882589123191073
Maryville University of Saint Louis,3184,2375,Missouri,Suburb,private,90.82,68.59,99.45,2,1,4,1,0,1,3,1,5,1.366906158702235,1.0193682159643764
Marywood University,1957,1756,Pennsylvania,Small City,NA,92.07,77.74,98.9,2,1,3,1,0,1,3,1,4,1.322659467927925,1.2094030884760287
Massachusetts College of Liberal Arts,1407,1201,Massachusetts,Town,public,91.88,76.92,98.88,2,1,3,1,0,1,3,1,4,2.179138168026863,0.3287462686706386
Massachusetts Institute of Technology,4551,4510,Massachusetts,Midsize City,private,100.0,99.68,100.0,7,4,14,3,2,6,10,6,20,0.9632422336930337,9.611195268670047
Massachusetts Maritime Academy,1687,1607,Massachusetts,Suburb,NA,95.61,83.04,99.69,2,1,4,1,1,2,3,2,6,2.489033722719089,0.633673023893073
Mayville State University,1097,600,North Dakota,Rural,NA,82.73,50.51,98.71,1,1,3,1,0,1,2,1,4,1.3188450431099128,0.4352469988556273
McDaniel College,1588,1543,Maryland,Suburb,private,82.11,64.12,94.94,1,1,2,0,0,1,1,1,3,1.5778920173623163,0.1420939786695864
McKendree University,2103,1692,Illinois,Suburb,NA,73.41,56.34,90.95,1,1,2,0,0,1,1,1,3,0.9865609603829795,0.3371021059076915
McMurry University,1106,956,Texas,Midsize City,private,99.93,96.85,100.0,5,2,11,2,1,5,7,3,16,7.232589718210836,0.07509229449558236
McNeese State University,6924,5567,LouisiaNA,Small City,NA,100.0,99.97,100.0,13,6,27,5,2,11,18,8,38,14.614268740428065,2.763791012911609
McPherson College,723,673,Kansas,Town,private,69.89,43.52,92.48,1,0,2,0,0,1,1,0,3,0.06153015996234261,1.1356359440869979
Medaille College,1526,1426,New York,Large City,NA,84.77,69.76,95.26,1,1,2,1,0,1,2,1,3,1.8287704919739993,0.051871269970379504
Menlo College,746,728,California,Suburb,private,91.47,74.96,99.14,2,1,3,1,0,1,3,1,4,2.1437540932945107,0.3131182859340979
Mercer University,4746,4135,Georgia,Midsize City,NA,99.37,86.64,100.0,4,1,9,1,1,4,5,2,13,3.153592189707541,1.915067328138729
Mercy College,6862,5055,New York,Suburb,private,99.98,99.58,100.0,6,4,10,3,2,4,9,6,14,7.710558192486748,0.9920827188944228
Mercyhurst University,2452,2373,Pennsylvania,Small City,NA,93.13,79.91,99.12,2,1,3,1,0,1,3,1,4,1.4336447504561345,1.2421271703443937
Meredith College,1682,1600,North CaroliNA,Large City,NA,66.95,42.36,89.46,1,0,2,0,0,1,1,0,3,0.763893332572739,0.3424013605090359
Merrimack College,3535,3323,Massachusetts,Suburb,NA,99.73,96.48,100.0,4,2,8,2,1,3,6,3,11,4.916877877314236,1.0035649600650907
Colorado Mesa University,9461,7145,Colorado,Small City,public,99.7,92.9,100.0,4,2,10,2,1,4,6,3,14,3.428749436967651,2.3888332278778317
Messiah College,2760,2637,Pennsylvania,Suburb,private,96.58,86.06,99.76,2,1,4,1,1,2,3,2,6,1.5873950042337455,1.786864386224076
Methodist University,1938,1755,North CaroliNA,Midsize City,NA,93.11,75.3,99.51,2,1,4,1,0,2,3,1,6,0.5928877205892974,2.078162364740149
Metropolitan College of New York,777,681,New York,Large City,NA,62.06,46.0,79.22,1,0,1,0,0,0,1,0,1,0.9395630801612556,0.0291040915607957
Metropolitan State University of Denver,19668,12759,Colorado,Large City,public,99.98,97.61,100.0,6,3,16,2,1,6,8,4,22,8.153543423485399,0.5733754081920884
Metropolitan State University,7317,2878,Minnesota,Large City,NA,75.89,58.02,91.35,1,1,2,0,0,1,1,1,3,1.4222947316247585,0.0
Miami University - Oxford,17153,16619,Ohio,Town,NA,100.0,99.96,100.0,10,6,19,4,2,8,14,8,27,8.076118769700354,6.059792385009018
Michigan State University,38997,35404,Michigan,Small City,NA,100.0,100.0,100.0,31,17,62,13,7,27,44,24,89,37.37304488214093,6.785130158920445
Michigan Technological University,5886,5492,Michigan,Town,NA,99.56,95.25,100.0,4,2,8,2,1,3,6,3,11,4.923820383516451,0.5025590180031085
Mid - America Christian University,1622,1170,Oklahoma,Large City,private,94.22,73.92,99.82,2,1,4,1,0,2,3,1,6,0.7969514435218739,2.0482910936017853
Mid - Atlantic Christian University,192,166,North CaroliNA,Town,private,14.77,7.44,26.34,0,0,0,0,0,0,0,0,0,0.05887917777872988,0.10087961657263332
MidAmerica Nazarene University,1311,998,Kansas,Suburb,NA,65.33,40.65,89.85,1,0,2,0,0,1,1,0,3,0.1047061528904637,0.9527695226103217
Middle Tennessee State University,19520,15812,Tennessee,Midsize City,public,100.0,99.94,100.0,15,6,35,5,2,13,20,8,48,18.2110864920557,1.7401511637099776
Middlebury College,2547,2528,Vermont,Town,NA,98.19,89.2,99.96,3,2,5,1,1,2,4,3,7,0.00031150685624790913,4.007264856758912
Midland University,1660,1187,Nebraska,Town,NA,72.67,50.15,92.86,1,0,2,0,0,1,1,0,3,0.10230004982034115,1.1919882189851434
Midway University,1003,760,Kentucky,Rural,private,65.38,38.72,91.03,1,0,2,0,0,1,1,0,3,0.9091712672050631,0.150932438072575
Midwestern State University,5328,4199,Texas,Midsize City,public,100.0,100.0,100.0,24,12,52,11,5,24,35,17,76,34.84855140120984,0.23700393706811965
Miles College,1654,1555,Alabama,Suburb,private,92.34,71.45,99.53,2,1,4,1,0,2,3,1,6,1.3300320422314258,1.235191941045713
Millersville University of Pennsylvania,6756,5671,Pennsylvania,Suburb,NA,99.92,98.68,100.0,5,3,9,2,1,4,7,4,13,6.456492445058486,0.6982344944102329
Millikin University,1951,1840,Illinois,Small City,private,70.21,52.81,89.03,1,1,2,0,0,1,1,1,3,0.9058617702324757,0.304467249879244
Mills College,764,739,California,Large City,private,91.65,75.54,99.08,2,1,3,1,0,1,3,1,4,2.2281827647770003,0.25056095075487217
Millsaps College,808,797,Mississippi,Midsize City,NA,92.86,72.32,99.56,2,1,4,1,0,2,3,1,6,1.2276896591477566,1.4065439579118066
Milwaukee School of Engineering,2607,2508,Wisconsin,Large City,private,62.98,45.41,84.31,1,0,1,0,0,1,1,0,2,0.3282705425852855,0.6645966334455665
Minnesota State University - Mankato,12781,10832,Minnesota,Small City,NA,95.91,84.86,99.67,2,1,4,1,1,2,3,2,6,2.129651644072824,1.064675307260972
Minnesota State University - Moorhead,5126,4157,Minnesota,Suburb,NA,95.6,75.64,99.92,2,1,5,1,0,2,3,1,7,0.6850029567098057,2.437158754333624
Minot State University,2959,1952,North Dakota,Town,public,99.51,87.28,100.0,4,1,10,2,1,5,6,2,15,4.434639009526903,0.8853861595843875
Misericordia University,2148,1660,Pennsylvania,Suburb,private,92.54,78.65,99.0,2,1,3,1,0,1,3,1,4,1.5873950042337455,1.006057730252376
Mississippi College,3246,2793,Mississippi,Suburb,private,100.0,99.69,100.0,8,4,16,3,2,7,11,6,23,8.41902411951988,3.254001516577886
Mississippi State University,18312,16803,Mississippi,Town,public,100.0,100.0,100.0,42,21,83,17,8,34,59,29,117,48.93278287139585,10.082714696246452
Mississippi University for Women,2577,2113,Mississippi,Town,NA,99.99,99.02,100.0,7,3,13,3,1,5,10,4,18,8.252351020099159,1.0216111886811143
Mississippi Valley State University,1974,1667,Mississippi,Town,public,99.91,97.01,100.0,5,3,10,2,1,4,7,4,14,6.227882641769415,0.7887681153618882
Missouri Baptist University,4507,1519,Missouri,Suburb,NA,97.65,83.45,99.97,3,1,6,1,1,2,4,2,8,2.109641239932015,1.6345547814677333
Missouri Southern State University,6025,4358,Missouri,Small City,NA,98.06,83.25,99.99,3,1,6,1,0,3,4,1,9,2.9219186695194566,1.0188103099488741
Missouri State University - Springfield,20365,15363,Missouri,Midsize City,NA,100.0,99.69,100.0,9,4,21,4,2,8,13,6,29,10.565876796373907,2.257323197217904
Missouri Valley College,1793,1296,Missouri,Town,NA,85.91,61.66,98.55,1,1,3,1,0,1,2,1,4,0.770096005173778,1.1861577006270576
Missouri Western State University,5290,3498,Missouri,Small City,NA,95.23,74.15,99.91,2,1,5,1,0,2,3,1,7,2.8204552432271304,0.2209511813191949
Mitchell College,706,575,Connecticut,Small City,NA,50.84,35.07,70.94,1,0,1,0,0,0,1,0,1,0.11047967761197414,0.5989282745304991
Molloy College,3534,2800,New York,Suburb,private,98.71,93.78,99.91,3,2,5,1,1,2,4,3,7,4.329359290939118,0.021828068670596775
Monmouth College,1035,1016,Illinois,Town,NA,44.86,31.55,65.35,0,0,1,0,0,0,0,0,1,0.5194676346111896,0.07550474410344138
Monmouth University,4708,4502,New Jersey,Suburb,NA,100.0,99.68,100.0,7,4,14,3,2,6,10,6,20,9.422449642807607,0.9648632462422053
MontaNA State University,14652,12403,MontaNA,Town,NA,100.0,98.1,100.0,12,3,84,7,1,60,19,4,144,11.135700984064542,7.228491408569531
MontaNA State University - Billings,4022,2400,MontaNA,Midsize City,public,99.31,21.75,100.0,3,0,31,2,0,23,5,0,54,4.578248373808185,0.3949477783746381
MontaNA State University - Northern,1164,855,MontaNA,Town,NA,78.2,14.04,100.0,1,0,9,1,0,7,2,0,16,1.2837741037178152,0.23852947711248473
MontaNA Tech of the University of MontaNA,1657,1529,MontaNA,Town,NA,90.15,25.81,100.0,1,0,12,1,0,9,2,0,21,1.7158982622803378,0.5991024862022505
Montclair State University,16852,14944,New Jersey,Suburb,NA,100.0,100.0,100.0,29,16,54,11,6,22,40,22,76,39.78529316360772,0.5590306197413087
Montreat College,757,543,North CaroliNA,Suburb,NA,54.75,31.95,81.25,1,0,1,0,0,0,1,0,1,0.278012117685655,0.5138357090392844
Moravian College,2083,1886,Pennsylvania,Small City,private,95.62,83.33,99.67,2,1,4,1,1,2,3,2,6,1.2198198942091258,1.9050251830432965
Morehead State University,9660,5835,Kentucky,Town,NA,99.99,98.92,100.0,7,3,15,3,1,6,10,4,21,7.80664369238482,1.8779433431802912
Morehouse College,2202,2090,Georgia,Large City,private,97.56,83.97,99.96,3,1,6,1,1,2,4,2,8,0.5275941375339622,3.1782651742538803
Morgan State University,6436,5825,Maryland,Large City,public,99.97,99.08,100.0,6,3,10,2,1,4,8,4,14,4.68149708325883,3.3011428597120243
Morningside College,1322,1252,Iowa,Small City,NA,57.63,32.49,86.29,1,0,1,0,0,1,1,0,2,0.588004765700439,0.27032397583322715
Morris College,745,731,South CaroliNA,Small City,private,88.47,62.85,98.72,2,1,3,1,0,1,3,1,4,1.953910575280868,0.20263459144006063
Mount Aloysius College,1689,999,Pennsylvania,Town,NA,83.11,65.94,95.65,1,1,2,1,0,1,2,1,3,1.6097957034596226,0.16785406191947383
Mount Holyoke College,2213,2161,Massachusetts,Suburb,NA,98.3,90.13,99.95,3,2,5,1,1,2,4,3,7,0.9198173788953969,3.150596555810251
Mount Marty College,875,457,South Dakota,Town,private,47.67,30.8,68.24,0,0,1,0,0,0,0,0,1,0.44024107334623475,0.20695356098942438
Mount Mary University,700,624,Wisconsin,Large City,private,12.55,8.85,18.68,0,0,0,0,0,0,0,0,0,0.12497702373787624,0.009085339288467309
Mount Mercy University,1517,1083,Iowa,Midsize City,NA,71.45,40.66,95.54,1,0,2,0,0,1,1,0,3,1.0861331552964069,0.1664243008234074
University of Mount Olive,3206,1472,North CaroliNA,Town,private,91.53,70.97,99.38,2,1,4,1,0,1,3,1,5,1.4566196589607523,1.009641850456768
Mount Saint Mary College,2036,1737,New York,Suburb,private,91.95,79.26,98.47,2,1,3,1,0,1,3,1,4,1.9847502451510965,0.5331697083359977
Mount Saint Mary's University,2603,2056,California,Large City,NA,99.99,99.54,100.0,7,4,12,3,2,5,10,6,17,9.279812239466649,0.12464918939476538
Mount St Mary's University,1815,1696,Maryland,Town,private,90.38,73.9,98.51,2,1,3,1,0,1,3,1,4,0.9079140576092692,1.4316796028218932
Mount Vernon Nazarene University,1829,1440,Ohio,Town,NA,73.17,51.61,91.36,1,1,2,0,0,1,1,1,3,1.1072986853409081,0.20800213570456147
Muhlenberg College,2369,2279,Pennsylvania,Midsize City,NA,97.87,89.0,99.91,3,2,5,1,1,2,4,3,7,0.4704146837434191,3.375331465087853
Murray State University,8559,6584,Kentucky,Town,NA,99.97,97.85,100.0,6,3,13,2,1,5,8,4,18,5.761760136598349,2.495614388375512
Muskingum University,1559,1363,Ohio,Town,NA,70.3,48.64,89.8,1,0,2,0,0,1,1,0,3,0.9633774009900066,0.24996392802976444
Naropa University,391,368,Colorado,Midsize City,NA,41.8,25.15,68.67,0,0,1,0,0,0,0,0,1,0.024000824991668442,0.5164100136716925
NatioNAl Louis University,1883,1250,Illinois,Large City,NA,63.45,48.51,82.39,1,0,1,0,0,0,1,0,1,1.006334934128467,0.0
NatioNAl University,7881,2899,California,Large City,private,100.0,100.0,100.0,21,12,39,9,5,17,30,17,56,26.176558971375268,3.1245405155545884
Nazareth College,2195,2099,New York,Suburb,NA,93.78,82.53,98.97,2,1,3,1,1,1,3,2,4,2.5349780358860543,0.24067419692047837
Nebraska Wesleyan University,1776,1566,Nebraska,Large City,NA,39.6,23.84,63.31,0,0,1,0,0,0,0,0,1,0.1436353098030989,0.3597800739770933
Neumann University,2085,1462,Pennsylvania,Suburb,private,92.38,77.9,99.02,2,1,3,1,0,1,3,1,4,1.4071711968255525,1.165780946878583
Nevada State College,4217,1708,Nevada,Rural,public,100.0,99.98,100.0,18,6,48,8,2,22,26,8,70,25.328722602217034,0.06843768401560758
New College of Florida,836,835,Florida,Small City,NA,98.71,91.32,99.98,3,2,6,1,1,3,4,3,9,4.092854127986276,0.24528377451308225
New England College,1841,1811,New Hampshire,Rural,NA,85.85,62.19,97.35,1,1,3,1,0,1,2,1,4,0.2870955781087404,1.666710737300748
New Jersey City University,6508,5210,New Jersey,Large City,NA,100.0,99.98,100.0,11,6,21,4,2,8,15,8,29,15.684680010305481,0.0431069575690487
New Jersey Institute of Technology,8479,6380,New Jersey,Large City,public,100.0,100.0,100.0,15,8,27,6,3,11,21,11,38,19.596754984269104,0.6267405561062044
New Mexico Highlands University,1933,1315,New Mexico,Town,public,99.03,86.1,100.0,3,1,8,1,1,3,4,2,11,2.069799577091984,2.5582394785674265
New Mexico Institute of Mining and Technology,1471,1294,New Mexico,Town,NA,93.45,64.35,99.9,2,1,5,1,0,2,3,1,7,2.0268220111224666,0.6956220869067449
New Mexico State University - Main Campus,11711,9703,New Mexico,Suburb,public,100.0,100.0,100.0,20,8,48,8,3,20,28,11,68,15.769328505535526,12.659277446106556
New York Institute of Technology,3663,3234,New York,Suburb,NA,99.21,95.12,99.97,3,2,6,1,1,2,4,3,8,3.9866951087626608,0.8558104068949176
New York University,26418,25347,New York,Large City,NA,100.0,100.0,100.0,39,22,72,16,9,31,55,31,103,9.58968435280926,44.94921452731679
Newberry College,1177,1158,South CaroliNA,Town,private,97.28,81.13,99.93,3,1,5,1,0,2,4,1,7,3.110108899166076,0.48748556487942646
Newman University,2811,1013,Kansas,Large City,private,79.08,52.31,96.24,1,1,2,0,0,1,1,1,3,0.39347838089554893,1.1680465490961822
Niagara University,2998,2827,New York,Suburb,private,97.91,91.05,99.84,3,2,5,1,1,2,4,3,7,3.2964539962781827,0.5688824861433763
Nicholls State University,5684,4662,LouisiaNA,Small City,public,100.0,99.79,100.0,10,4,20,4,2,8,14,6,28,12.39738337869002,0.736480581074384
Nichols College,1339,1232,Massachusetts,Suburb,private,89.76,73.09,98.46,2,1,3,1,0,1,3,1,4,1.640275197128916,0.6359656160518123
Norfolk State University,4684,4011,Virginia,Midsize City,NA,99.97,97.88,100.0,6,3,10,2,1,5,8,4,15,6.721601274954906,1.4146162626746601
North CaroliNA A & T State University,10339,9347,North CaroliNA,Large City,NA,99.91,96.94,100.0,5,3,10,2,1,4,7,4,14,4.570560174180188,2.463584543490864
North CaroliNA Central University,6355,5363,North CaroliNA,Large City,NA,98.62,88.55,99.98,3,2,6,1,1,2,4,3,8,2.7110021420728234,1.5705677643729108
North CaroliNA State University,24149,21384,North CaroliNA,Large City,NA,100.0,99.96,100.0,11,6,23,4,2,9,15,8,32,11.171683992451182,4.525192101288445
North CaroliNA Wesleyan College,2090,1754,North CaroliNA,Small City,NA,91.03,69.97,99.08,2,1,3,1,0,1,3,1,4,0.6323111700585339,1.776059933293125
North Central College,2772,2634,Illinois,Midsize City,NA,78.99,63.48,93.54,1,1,2,0,0,1,1,1,3,1.3590598712101392,0.20038237634544803
North Central University,1081,912,Minnesota,Large City,NA,39.58,23.76,63.0,0,0,1,0,0,0,0,0,1,0.11546304094370732,0.38808293632664337
North Dakota State University - Main Campus,11981,10782,North Dakota,Midsize City,NA,99.99,98.47,100.0,7,3,16,3,1,8,10,4,24,7.709199547481064,2.1746846395497146
North Greenville University,2359,2080,South CaroliNA,Rural,NA,99.87,95.06,100.0,5,2,9,2,1,4,7,3,13,5.98122708333912,0.6378766262207963
North Park University,2033,1812,Illinois,Large City,NA,80.55,62.04,95.25,1,1,2,0,0,1,1,1,3,0.676590561129389,0.9593448908142537
Northcentral University,90,14,California,Large City,NA,15.91,8.11,31.65,0,0,0,0,0,0,0,0,0,0.0,0.1728896441545429
Northeastern Illinois University,7113,4164,Illinois,Large City,NA,97.77,91.86,99.86,3,2,5,1,1,2,4,3,7,3.7976718225793347,0.004874405167998991
Northeastern State University,6830,4753,Oklahoma,Town,NA,99.86,94.48,100.0,5,2,10,2,1,4,7,3,14,5.505825009921043,1.035315411278849
Northeastern University,13824,13786,Massachusetts,Large City,private,100.0,100.0,100.0,17,10,31,7,4,14,24,14,45,8.615885963258386,15.726274542237666
Northern ArizoNA University,27092,21990,ArizoNA,Small City,NA,100.0,100.0,100.0,56,33,100,23,13,41,79,46,141,53.84945481740123,25.328505411362606
Northern Illinois University,13456,11788,Illinois,Suburb,public,99.95,99.26,100.0,5,3,9,2,1,4,7,4,13,6.977540573542893,0.5710350522540635
Northern Kentucky University,12326,8962,Kentucky,Suburb,public,100.0,99.55,100.0,8,4,17,3,2,7,11,6,24,8.300823885033218,2.9266743330180867
Northern Michigan University,7018,6207,Michigan,Town,NA,99.91,98.02,100.0,5,3,10,2,1,4,7,4,14,5.905141229182317,1.084409811525271
Northern State University,3164,1346,South Dakota,Town,NA,94.01,78.87,99.51,2,1,4,1,0,2,3,1,6,1.6460168017652295,1.1669939449033322
Northland College,631,594,Wisconsin,Town,private,32.09,20.13,51.27,0,0,1,0,0,0,0,0,1,0.05196702011940974,0.3345586892069558
Northwest Christian University,604,444,Oregon,Midsize City,NA,53.61,34.79,77.47,1,0,1,0,0,0,1,0,1,0.28868318331456627,0.47824083267331685
Northwest Missouri State University,5478,4806,Missouri,Town,NA,95.52,74.6,99.93,2,1,5,1,0,2,3,1,7,2.3074379192771675,0.7960598677472202
Northwest Nazarene University,1482,1125,Idaho,Suburb,NA,82.81,55.62,98.75,1,1,3,1,0,1,2,1,4,0.7560893447548163,1.0034394496283638
Northwest University,946,929,Washington,Suburb,NA,69.84,50.9,92.95,1,0,2,0,0,1,1,0,3,0.8727408904848978,0.3248544211366764
Northwestern College - 2,1039,997,Iowa,Town,private,64.64,40.06,89.41,1,0,2,0,0,1,1,0,3,0.38159376634186526,0.6566120561001951
University of Northwestern - St Paul,3325,2033,Minnesota,Suburb,NA,71.75,49.78,92.86,1,0,2,0,0,1,1,0,3,0.4424139413937338,0.8205373613412215
Northwestern Oklahoma State University,1881,1329,Oklahoma,Town,NA,91.57,67.79,99.57,2,1,4,1,0,2,3,1,6,1.2441250483885575,1.2249076347637617
Northwestern State University of LouisiaNA,9440,5471,LouisiaNA,Town,public,100.0,100.0,100.0,18,8,38,7,3,16,25,11,54,19.127133233181247,5.810412597226013
Northwestern University,8699,8205,Illinois,Small City,NA,100.0,99.97,100.0,10,6,19,4,2,8,14,8,27,1.3152364699363557,13.084213231373019
Norwich University,3229,2542,Vermont,Town,private,99.33,93.23,99.99,4,2,7,1,1,3,5,3,10,0.0008365466381496269,5.00158581813379
Notre Dame College,1736,1216,Ohio,Suburb,NA,70.68,48.87,89.86,1,0,2,0,0,1,1,0,3,1.1678971208570772,0.05830378288255547
Notre Dame de Namur University,922,718,California,Suburb,private,95.51,82.96,99.71,2,1,4,1,1,2,3,2,6,2.9696867491014713,0.1269910870233581
Nova Southeastern University,4501,3154,Florida,Suburb,NA,100.0,100.0,100.0,17,9,32,7,4,14,24,13,46,20.99516876211361,2.6641176741038026
Nyack College,1397,1131,New York,Suburb,NA,86.4,69.54,96.93,1,1,2,1,0,1,2,1,3,1.1115092647659297,0.8816160007224415
Oakland City University,1112,572,IndiaNA,Town,NA,54.64,39.33,73.25,1,0,1,0,0,0,1,0,1,0.7116631545278527,0.07866835931131885
Oakland University,15902,12549,Michigan,Suburb,NA,100.0,99.99,100.0,12,7,24,5,3,10,17,10,34,16.922404539240215,0.35415286449431915
Oakwood University,1648,1521,Alabama,Midsize City,private,97.16,85.2,99.91,3,1,5,1,1,2,4,2,7,0.3876775010988461,3.1658211603492146
Oberlin College,2828,2790,Ohio,Town,NA,99.06,92.53,99.99,3,2,6,1,1,3,4,3,9,0.14047819142384654,4.515483975987033
Occidental College,1976,1952,California,Large City,private,99.31,94.0,99.99,4,2,7,1,1,3,5,3,10,3.5019544606215125,1.4716108293808876
Oglethorpe University,1253,1166,Georgia,Suburb,NA,80.79,50.47,98.29,1,1,3,0,0,1,1,1,4,0.7183581297739273,0.9290393069368273
Ohio Christian University,3988,2429,Ohio,Town,NA,98.35,89.18,99.96,3,2,6,1,1,2,4,3,8,2.125765573163796,1.9709989275281974
Ohio Dominican University,1176,957,Ohio,Large City,NA,63.01,42.16,84.81,1,0,1,0,0,1,1,0,2,0.7333787934627284,0.26036169139142157
Ohio Northern University,2315,2092,Ohio,Town,private,87.04,67.62,97.88,1,1,3,1,0,1,2,1,4,1.267058197156263,0.7742855427698727
Ohio State University - Lima Campus,1007,844,Ohio,Rural,public,50.09,31.81,72.35,1,0,1,0,0,0,1,0,1,0.6906844411672456,0.004050998069539314
Ohio State University - Main Campus,45943,42003,Ohio,Large City,NA,100.0,100.0,100.0,28,16,53,11,6,22,39,22,75,26.681215710335092,12.962226191965096
Ohio State University - Newark Campus,2605,2218,Ohio,Suburb,NA,83.59,63.02,96.49,1,1,2,0,0,1,1,1,3,1.7807676618728785,0.025971265156621737
Ohio University - Main Campus,23167,17695,Ohio,Town,public,100.0,99.99,100.0,12,7,23,5,3,9,17,10,32,14.45272687060633,2.766521487327091
Ohio Valley University,528,435,West Virginia,Small City,NA,41.22,24.64,65.58,0,0,1,0,0,0,0,0,1,0.01608091457196614,0.5142343159619294
Ohio Wesleyan University,1557,1545,Ohio,Suburb,private,84.22,63.48,97.15,1,1,2,1,0,1,2,1,3,0.5267932178394246,1.317115831236689
Oklahoma Baptist University,1962,1835,Oklahoma,Town,NA,98.4,85.3,99.99,3,1,6,1,1,3,4,2,9,1.0476396765531966,3.0790505581018968
Oklahoma Christian University,1976,1846,Oklahoma,Large City,NA,99.12,89.49,100.0,3,2,7,1,1,3,4,3,10,0.6690665678876517,4.049518757552237
Oklahoma City University,1715,1579,Oklahoma,Large City,NA,96.97,80.73,99.95,2,1,5,1,0,2,3,1,7,0.718187910846492,2.7714443373627033
Oklahoma Panhandle State University,1136,852,Oklahoma,Rural,public,92.84,71.74,99.66,2,1,4,1,0,2,3,1,6,0.4412451669233754,2.1887209164649843
Oklahoma State University - Main Campus,20992,18221,Oklahoma,Town,NA,100.0,100.0,100.0,30,14,66,13,6,29,43,20,95,12.452260440066004,31.24389950890926
Oklahoma Wesleyan University,1005,609,Oklahoma,Town,NA,85.82,60.79,98.47,1,1,3,1,0,1,2,1,4,0.4471736048666837,1.5012488754681874
Old Dominion University,19543,15036,Virginia,Midsize City,public,100.0,100.0,100.0,25,12,45,11,5,20,36,17,65,33.68984103335173,1.9987703357338773
Olivet College,1178,1032,Michigan,Rural,private,72.4,51.19,92.46,1,1,2,0,0,1,1,1,3,1.2460192316678431,0.04042451436268102
Olivet Nazarene University,3377,3113,Illinois,Suburb,NA,92.31,78.37,99.16,2,1,3,1,0,1,3,1,4,1.0832931022190138,1.4797612110285667
Oral Roberts University,3384,2866,Oklahoma,Large City,private,99.92,96.74,100.0,5,2,11,2,1,5,7,3,16,0.8985818082643019,6.206354346526422
Oregon Institute of Technology,5380,2284,Oregon,Town,NA,98.77,93.09,99.97,3,2,5,1,1,3,4,3,8,3.180811955603615,1.2113622421535675
Oregon State University,25835,18829,Oregon,Small City,NA,100.0,100.0,100.0,19,12,34,8,5,15,27,17,49,13.001337127442254,14.723585169186792
Ottawa University - Online,156,85,Kansas,Town,NA,31.7,16.88,55.58,0,0,1,0,0,0,0,0,1,0.009089682721709704,0.3708872086070403
Ottawa University - Ottawa,669,646,Kansas,Town,NA,40.36,22.12,66.17,0,0,1,0,0,0,0,0,1,0.07970952540576202,0.43597834297611315
Otterbein University,2483,2294,Ohio,Suburb,private,87.12,67.5,97.9,1,1,3,1,0,1,2,1,4,1.5445714870769012,0.5031579847870203
Ouachita Baptist University,1542,1500,Arkansas,Town,private,98.7,86.57,99.99,3,1,7,1,1,3,4,2,10,0.4422191406997497,3.8845998851879857
University of Holy Cross,912,457,LouisiaNA,Large City,private,87.02,61.43,98.82,1,1,3,1,0,1,2,1,4,2.0202808495349758,0.019368174585510517
Our Lady of the Lake University,1344,1221,Texas,Large City,NA,99.99,98.57,100.0,6,3,13,3,1,6,9,4,19,8.894314662884511,0.06378707786519708
Pace University - New York,8670,7878,New York,Large City,NA,100.0,99.96,100.0,9,6,16,4,2,7,13,8,23,6.569572438931446,6.404244482414476
Pacific Lutheran University,2764,2655,Washington,Suburb,NA,97.25,88.63,99.93,2,2,5,1,1,2,3,3,7,2.599931694708004,0.9897044653248328
Pacific Union College,1227,1077,California,Rural,NA,98.46,90.56,99.96,3,2,5,1,1,2,4,3,7,3.83966914655147,0.3243066346798232
Pacific University,1876,1818,Oregon,Suburb,NA,86.56,68.77,98.15,1,1,3,1,0,1,2,1,4,0.5104925099438775,1.4941998391146458
Paine College,425,328,Georgia,Midsize City,NA,40.91,20.22,72.05,0,0,1,0,0,0,0,0,1,0.24982899402137695,0.27564593651394453
Palm Beach Atlantic University,3005,2350,Florida,Midsize City,NA,100.0,99.92,100.0,9,5,17,4,2,8,13,7,25,10.945143844524384,1.6784906412770277
Park University,9864,4134,Missouri,Suburb,NA,99.83,94.87,100.0,5,2,10,2,1,4,7,3,14,4.635966550761167,1.7358671607135294
Paul Quinn College,518,492,Texas,Large City,private,94.89,75.81,99.84,2,1,4,1,0,2,3,1,6,2.6968978610277694,0.26778159816625846
Paul Smiths College of Arts and Science,768,760,New York,Rural,private,57.83,40.59,76.91,1,0,1,0,0,0,1,0,1,0.588301588754564,0.2745684665176199
William Peace University,932,814,North CaroliNA,Large City,NA,43.47,24.71,68.64,0,0,1,0,0,0,0,0,1,0.44133783691534917,0.12874427677521538
Peirce College,1388,307,Pennsylvania,Large City,NA,77.58,59.14,93.09,1,1,2,0,0,1,1,1,3,1.3033134095055767,0.1908506477205204
Pennsylvania State University - Brandywine,1439,1245,Pennsylvania,Suburb,NA,78.96,61.05,93.69,1,1,2,0,0,1,1,1,3,1.3684790799808557,0.18918083338097946
Pennsylvania State University - University Park,40833,39785,Pennsylvania,Small City,NA,100.0,100.0,100.0,38,22,68,16,9,29,54,31,97,26.759671652512548,27.15932252238602
Pennsylvania State University - Abington,3891,3312,Pennsylvania,Suburb,NA,98.69,92.61,99.95,3,2,5,1,1,2,4,3,7,3.6431682650085575,0.6865164751954772
Pennsylvania State University - AltooNA,3478,3374,Pennsylvania,Small City,NA,98.44,91.59,99.94,3,2,5,1,1,2,4,3,7,2.8805262777275598,1.2783602064133475
Pennsylvania State University - Beaver,652,563,Pennsylvania,Suburb,NA,52.3,35.76,73.41,1,0,1,0,0,0,1,0,1,0.5824181798728046,0.15731126936552514
Pennsylvania State University - Berks,2718,2411,Pennsylvania,Suburb,public,95.07,83.62,99.52,2,1,4,1,1,2,3,2,6,2.4946233228817682,0.5139845899529647
Pennsylvania State University - Erie - Behrend College,4341,4138,Pennsylvania,Suburb,NA,99.18,94.43,99.98,3,2,6,1,1,3,4,3,9,3.907903801314378,0.8958842593102854
Pennsylvania State University - Greater Allegheny,497,453,Pennsylvania,Suburb,public,42.82,28.4,63.06,0,0,1,0,0,0,0,0,1,0.4531050525234232,0.10550090854680368
Pennsylvania State University - Harrisburg,4288,3960,Pennsylvania,Suburb,public,99.49,95.43,99.99,4,2,7,2,1,3,6,3,10,3.1248975420098555,2.1493697288407385
Pennsylvania State University - Lehigh Valley,899,739,Pennsylvania,Suburb,public,63.08,45.25,82.98,1,0,1,0,0,1,1,0,2,0.8797365514162643,0.11605289857186202
Pennsylvania State University - New Kensington,597,484,Pennsylvania,Rural,NA,46.49,31.37,67.08,0,0,1,0,0,0,0,0,1,0.592600315884567,0.03234453072184949
Pennsylvania State University - Schuylkill,733,595,Pennsylvania,Town,NA,57.97,40.59,78.32,1,0,1,0,0,0,1,0,1,0.56205390784928,0.3041486535504034
Pennsylvania State University - SheNAngo,490,241,Pennsylvania,Suburb,NA,38.08,25.16,57.1,0,0,1,0,0,0,0,0,1,0.4378318485057797,0.04131711512466075
Pennsylvania State University - Wilkes - Barre,456,387,Pennsylvania,Rural,NA,38.93,25.74,58.24,0,0,1,0,0,0,0,0,1,0.43986827570813214,0.052906536372722066
Pennsylvania State University - Worthington Scranton,1030,904,Pennsylvania,Suburb,public,65.16,47.35,84.33,1,0,1,0,0,1,1,0,2,1.0334868051938753,0.020441116073238102
Pennsylvania State University - York,966,793,Pennsylvania,Suburb,NA,64.22,46.08,83.86,1,0,1,0,0,1,1,0,2,0.8705726290056782,0.1564627100009932
Pepperdine University,3603,3300,California,Suburb,NA,100.0,99.75,100.0,8,4,15,3,2,6,11,6,21,7.282890618315599,3.6400102824728062
Peru State College,2046,1105,Nebraska,Rural,public,48.92,31.45,72.83,0,0,1,0,0,0,0,0,1,0.14306907336497893,0.5280348819333988
Pfeiffer University,812,733,North CaroliNA,Rural,NA,59.56,36.43,84.27,1,0,1,0,0,1,1,0,2,0.30361176019814623,0.6003174363876387
Cairn University,770,727,Pennsylvania,Suburb,private,62.54,43.49,82.87,1,0,1,0,0,1,1,0,2,0.44801398451754204,0.5330345865596859
Thomas Jefferson University,2690,2279,Pennsylvania,Large City,private,98.03,89.52,99.92,3,2,5,1,1,2,4,3,7,1.2554573702502938,2.6673765640439617
Philander Smith College,893,845,Arkansas,Midsize City,private,63.58,38.34,88.33,1,0,2,0,0,1,1,0,3,0.17709975179102685,0.8309783269983452
Piedmont College,1281,1160,Georgia,Town,NA,68.32,33.07,96.17,1,0,2,0,0,1,1,0,3,0.9777652321922901,0.17088626555536887
University of Pikeville,1562,1049,Kentucky,Town,NA,82.26,55.06,97.91,1,1,3,1,0,1,2,1,4,1.1928487408754411,0.5347671916232701
Pine Manor College,419,417,Massachusetts,Suburb,NA,52.39,34.88,73.89,1,0,1,0,0,0,1,0,1,0.6434773938195266,0.09793984143004401
Pittsburg State University,5709,5109,Kansas,Town,NA,83.9,57.59,97.69,1,1,3,0,0,1,1,1,4,0.7310202527344227,1.094391783101604
Pitzer College,1070,1046,California,Suburb,NA,90.38,73.83,98.71,2,1,3,1,0,1,3,1,4,1.5674366401314317,0.7697183489340962
Platt College - Aurora,236,236,Colorado,Large City,private,9.46,4.11,22.47,0,0,0,0,0,0,0,0,0,0.09937183680760969,0.0
Plymouth State University,4148,3971,New Hampshire,Town,NA,97.55,79.52,99.91,3,1,5,1,0,2,4,1,7,0.9705275046128804,2.733846464305274
Point Loma Nazarene University,3097,2571,California,Large City,private,100.0,99.69,100.0,7,4,13,3,2,6,10,6,19,9.232091686020025,0.8925396083438559
Point Park University,3282,2758,Pennsylvania,Large City,private,98.56,91.17,99.96,3,2,6,1,1,2,4,3,8,2.1728678249100786,2.0656082336123793
PomoNA College,1600,1578,California,Suburb,private,97.27,86.29,99.9,3,1,5,1,1,2,4,2,7,1.9051513260613888,1.6901765716141908
Portland State University,21163,13990,Oregon,Large City,NA,100.0,100.0,100.0,13,8,24,6,3,11,19,11,35,11.067954340106168,8.041861347667147
Post University,7845,2617,Connecticut,Suburb,private,100.0,99.74,100.0,8,4,15,3,2,7,11,6,22,1.042309728140957,10.072632718614296
University of the Potomac - VA Campus,37,37,Virginia,Suburb,NA,6.66,3.08,11.82,0,0,0,0,0,0,0,0,0,0.0688155083490126,0.0
Prairie View A & M University,7977,7341,Texas,Town,NA,100.0,100.0,100.0,35,17,76,16,7,35,51,24,111,49.74278277006775,1.3278067225948995
Pratt Institute - Main,3642,3537,New York,Large City,NA,99.9,97.89,100.0,5,3,9,2,1,4,7,4,13,1.2060796662985005,5.678948480881095
Presbyterian College,1014,975,South CaroliNA,Town,NA,93.55,71.58,99.65,2,1,4,1,0,2,3,1,6,2.1864420817605748,0.5498900839869879
Prescott College,386,291,ArizoNA,Small City,NA,48.7,30.47,73.55,0,0,1,0,0,0,0,0,1,0.12255755404415583,0.5439473852297371
Presentation College,762,475,South Dakota,Town,private,36.98,22.64,56.37,0,0,1,0,0,0,0,0,1,0.31512815729757127,0.14635788274434597
Princeton University,5397,5260,New Jersey,Suburb,private,100.0,99.81,100.0,8,4,15,3,2,7,11,6,22,2.0469877731092976,9.371998066552074
Principia College,456,441,Illinois,Rural,private,58.71,38.25,82.39,1,0,1,0,0,1,1,0,2,0.01923954202263665,0.8634415352429127
Providence Christian College,165,161,California,Midsize City,private,36.32,22.72,57.03,0,0,1,0,0,0,0,0,1,0.38176442757299506,0.06881090233990782
Providence College,4076,3826,Rhode Island,Midsize City,private,99.65,96.19,100.0,4,2,7,2,1,3,6,3,10,0.20068173510909007,5.440875988418276
Purdue University - Main Campus,32130,30277,IndiaNA,Small City,NA,100.0,100.0,100.0,22,13,39,9,5,16,31,18,55,15.488770593114507,15.168385854449385
Queens University of Charlotte,1717,1449,North CaroliNA,Large City,private,84.45,61.32,97.64,1,1,3,1,0,1,2,1,4,0.5365685070618167,1.322229425316317
Quincy University,992,874,Illinois,Town,NA,74.44,54.27,93.05,1,1,2,0,0,1,1,1,3,0.33562312195043936,1.0255873695851743
Quinnipiac University,7311,6959,Connecticut,Suburb,private,100.0,99.7,100.0,7,4,13,3,2,5,10,6,18,0.5304957114487504,9.47084429741116
Radford University,8419,8049,Virginia,Small City,NA,100.0,99.91,100.0,11,5,19,5,2,9,16,7,28,14.618645827655108,0.6920969309109131
Ramapo College of New Jersey,5616,4910,New Jersey,Suburb,NA,100.0,99.94,100.0,10,5,18,4,2,7,14,7,25,13.288443138466636,0.13878627072649943
Randolph College,666,645,Virginia,Small City,NA,66.82,41.17,87.16,1,0,1,0,0,1,1,0,2,0.7513909560270564,0.3507586849280928
Randolph - Macon College,1452,1428,Virginia,Suburb,private,91.14,68.51,98.82,2,1,3,1,0,1,3,1,4,1.9510126556247083,0.4702997078167934
Reed College,1446,1408,Oregon,Large City,NA,96.16,83.51,99.83,2,1,4,1,1,2,3,2,6,0.0662117392923317,3.187412250606238
Regent University,4280,2263,Virginia,Large City,NA,99.96,97.94,100.0,6,3,11,2,1,5,8,4,16,3.5374891048600525,4.3760427360692775
Regis University,4084,2378,Colorado,Large City,NA,97.8,84.8,99.98,3,1,6,1,1,3,4,2,9,1.0930902048837066,2.719397686548991
Reinhardt University,1408,1260,Georgia,Rural,NA,71.45,35.49,97.18,1,0,3,0,0,1,1,0,4,1.0871153030578768,0.1653749389841047
Rensselaer Polytechnic Institute,6366,6340,New York,Small City,NA,99.99,99.54,100.0,7,4,12,3,2,5,10,6,17,2.5963873875305805,6.824780680933316
Rhode Island College,7079,5461,Rhode Island,Suburb,public,99.06,94.18,99.96,3,2,6,1,1,2,4,3,8,2.7244934609334086,1.9361479864396633
Rhodes College,1984,1979,Tennessee,Large City,NA,98.69,87.14,99.99,3,1,6,1,1,3,4,2,9,0.5200924582815778,3.8052833696621615
Rice University,4004,3916,Texas,Large City,NA,100.0,99.99,100.0,13,6,27,6,3,12,19,9,39,14.38345525881477,3.868255912836428
Rider University,4092,3711,New Jersey,Suburb,private,99.98,99.15,100.0,6,3,11,2,1,5,8,4,16,7.273597549235525,1.347666010312105
Ripon College,759,739,Wisconsin,Town,NA,29.85,18.8,48.16,0,0,0,0,0,0,0,0,0,0.10100632079547245,0.25310269975591376
Rivier University,1427,908,New Hampshire,Small City,private,78.8,50.91,94.64,1,1,2,0,0,1,1,1,3,0.3232082294431732,1.2267963715265473
Roanoke College,2036,1973,Virginia,Suburb,NA,96.09,80.22,99.73,2,1,4,1,0,2,3,1,6,1.9063755691280515,1.3324490473935902
Robert Morris University,4245,3840,Pennsylvania,Suburb,NA,98.81,93.07,99.96,3,2,5,1,1,2,4,3,7,3.6910243042638404,0.7366056016705715
Roberts Wesleyan College,1322,1248,New York,Suburb,NA,80.44,63.99,93.27,1,1,2,0,0,1,1,1,3,1.3546902972782546,0.2757085530981734
Rochester College,1152,762,Michigan,Suburb,NA,71.45,50.33,91.87,1,0,2,0,0,1,1,0,3,1.1685465333258012,0.08413293604265215
Rochester Institute of Technology,13510,12447,New York,Suburb,private,100.0,100.0,100.0,13,8,23,5,3,10,18,11,33,8.605906539463945,9.916900567257006
Rockford University,1059,918,Illinois,Midsize City,NA,54.62,36.35,78.89,1,0,1,0,0,0,1,0,1,0.4366307175692818,0.35256395700404813
Rockhurst University,2208,1445,Missouri,Large City,NA,72.34,44.94,94.28,1,0,2,0,0,1,1,0,3,0.853888834752272,0.4303416512731517
Rocky Mountain College,898,868,MontaNA,Midsize City,private,72.34,29.09,99.98,1,0,5,0,0,4,1,0,9,0.6248792496997413,0.6586626389212146
Roger Williams University,4704,4042,Rhode Island,Suburb,private,99.75,96.85,100.0,4,2,8,2,1,3,6,3,11,0.18825858007852736,5.79241686214044
Rollins College,2614,2453,Florida,Suburb,private,100.0,99.61,100.0,7,4,14,3,2,6,10,6,20,8.315346169528677,1.6051526403437448
Roosevelt University,2576,2117,Illinois,Large City,NA,88.9,72.42,98.44,2,1,3,1,0,1,3,1,4,0.9389965370492388,1.2567545453051037
Rosemont College,634,520,Pennsylvania,Suburb,NA,55.32,37.88,76.43,1,0,1,0,0,0,1,0,1,0.4989246645763536,0.3061559229507012
Rowan University,15399,13634,New Jersey,Suburb,NA,100.0,100.0,100.0,26,15,49,10,5,20,36,20,69,36.18608717392265,0.5156872173978759
Rust College,862,792,Mississippi,Town,NA,84.5,59.45,97.71,1,1,3,1,0,1,2,1,4,1.2114288689603692,0.6496690488557377
Rutgers University - Camden,5489,4493,New Jersey,Small City,NA,100.0,99.92,100.0,9,5,18,4,2,7,13,7,25,12.682107897616726,0.4553520751617464
Rutgers University - New Brunswick,35638,33677,New Jersey,Small City,NA,100.0,100.0,100.0,61,34,113,24,13,46,85,47,159,79.98289429099337,4.710197343736221
Rutgers University - Newark,8549,7162,New Jersey,Large City,NA,100.0,100.0,100.0,15,8,27,6,3,11,21,11,38,19.83443839868227,0.6894681522525788
Sacred Heart University,5605,4982,Connecticut,Suburb,NA,99.92,98.53,100.0,5,3,9,2,1,4,7,4,13,0.5021510711284771,6.595617603630614
SagiNAw Valley State University,7850,6559,Michigan,Suburb,public,99.98,99.08,100.0,6,3,12,2,1,5,8,4,17,8.345531226956643,0.07182586971767344
Saint Ambrose University,2369,2215,Iowa,Midsize City,private,77.6,55.95,95.47,1,1,2,0,0,1,1,1,3,0.5605848543465326,0.9349453857191646
Saint Anselm College,1965,1926,New Hampshire,Suburb,NA,92.52,74.96,99.14,2,1,3,1,0,1,3,1,4,0.2004252149061018,2.39050240934406
Saint Augustine's University,972,961,North CaroliNA,Large City,private,65.83,42.73,87.3,1,0,1,0,0,1,1,0,2,0.2580443965259118,0.8148074001282355
St. BoNAventure University,1621,1586,New York,Town,NA,87.97,72.97,97.16,2,1,2,1,0,1,3,1,3,1.5597975317709731,0.5560361507691843
Saint Cloud State University,13133,8373,Minnesota,Small City,NA,96.53,85.83,99.79,2,1,4,1,1,2,3,2,6,2.241615804987934,1.1178326384927302
Saint Edward's University,3941,3528,Texas,Large City,NA,100.0,100.0,100.0,17,8,37,8,4,17,25,12,54,24.680701637284436,0.5030555184672587
Saint Francis University,2119,1526,Pennsylvania,Town,private,90.24,75.18,98.42,2,1,3,1,0,1,3,1,4,1.879622307771324,0.44562725682575777
St. John Fisher College,2746,2624,New York,Suburb,NA,96.69,88.55,99.6,2,2,4,1,1,2,3,3,6,3.2952258092452924,0.10971642471801649
Saint Johns University,1724,1703,Minnesota,Rural,NA,48.8,31.07,73.25,0,0,1,0,0,0,0,0,1,0.2861306334497259,0.3825833915699983
University of Saint Joseph,808,654,Connecticut,Small City,NA,33.88,24.03,49.03,0,0,0,0,0,0,0,0,0,0.22482453344944006,0.18859776077310722
St. Joseph's College - New York,928,798,New York,Large City,NA,69.64,53.0,85.77,1,1,1,0,0,1,1,1,2,1.1164220128974918,0.07458975767767573
Saint Joseph's College of Maine,1537,960,Maine,Rural,private,70.08,44.99,89.78,1,0,2,0,0,1,1,0,3,0.27966892887645883,0.9258605262732403
Saint Joseph's University,5143,4481,Pennsylvania,Large City,NA,99.95,98.76,100.0,5,3,10,2,1,4,7,4,14,1.949879046252484,5.744560482488562
Saint Leo University,9672,6732,Florida,Suburb,private,100.0,100.0,100.0,32,18,63,14,8,28,46,26,91,42.490369476515134,3.9354332611089453
Saint Louis University,9900,6625,Missouri,Large City,NA,99.98,98.76,100.0,6,3,12,2,1,5,8,4,17,1.9449056770191935,6.340349875419851
Saint Martin's University,1318,1121,Washington,Suburb,NA,81.02,65.69,93.75,1,1,2,1,0,1,2,1,3,1.4449871629884685,0.2154744912571098
Saint Mary - of - the - Woods College,662,491,IndiaNA,Rural,private,43.19,28.57,63.84,0,0,1,0,0,0,0,0,1,0.3419047053553578,0.22305571803666294
Saint Mary's College,1533,1486,IndiaNA,Suburb,NA,83.3,63.57,96.67,1,1,2,1,0,1,2,1,3,0.30290946401136587,1.4842403754893951
Saint Mary's College of California,2776,2614,California,Suburb,NA,99.99,99.56,100.0,7,4,13,3,2,5,10,6,18,9.01918460141201,0.5184319232480168
Saint Mary's University of Minnesota,1501,1129,Minnesota,Town,NA,41.45,27.19,62.56,0,0,1,0,0,0,0,0,1,0.19341031269190032,0.3413922081506426
Saint Michael's College,1790,1766,Vermont,Suburb,private,83.67,63.47,96.18,1,1,2,1,0,1,2,1,3,0.0009018625918790271,1.8098378275192297
Saint Norbert College,2068,2021,Wisconsin,Suburb,private,59.81,42.59,81.1,1,0,1,0,0,0,1,0,1,0.2567243986884925,0.6536588266067518
Saint Peter's University,2633,2387,New Jersey,Large City,NA,99.64,95.61,100.0,4,2,7,2,1,3,6,3,10,4.7391162424829,0.8799416302910512
St. Thomas AquiNAs College,1777,1091,New York,Suburb,NA,93.19,80.2,99.01,2,1,3,1,0,1,3,1,4,1.6187505093497188,1.065371702550484
St. Thomas University,2907,935,Florida,Suburb,NA,100.0,99.99,100.0,12,7,23,5,3,10,17,10,33,16.334377108071923,0.47218953240548384
Saint Vincent College,1667,1617,Pennsylvania,Suburb,NA,87.14,70.12,97.57,1,1,3,1,0,1,2,1,4,1.3684790799808557,0.6803125717385448
Saint Xavier University,2942,2638,Illinois,Large City,NA,80.27,65.1,94.14,1,1,2,0,0,1,1,1,3,1.4664806475031937,0.15605656242500376
Salem College,817,673,North CaroliNA,Midsize City,private,63.3,38.6,87.71,1,0,1,0,0,1,1,0,2,0.2754521534344059,0.72528513517035
Salem InterNAtioNAl University,892,892,West Virginia,Rural,private,79.21,56.13,95.62,1,1,2,0,0,1,1,1,3,0.010816758680694713,1.5566502316371853
Salem State University,7110,5792,Massachusetts,Suburb,NA,100.0,99.96,100.0,10,6,17,4,2,7,14,8,24,13.382750705817148,0.32105082702519805
Salisbury University,7783,7191,Maryland,Suburb,public,99.98,99.44,100.0,6,4,11,3,1,4,9,5,15,6.706041073789844,2.0641370011103906
Salve RegiNA University,2180,2087,Rhode Island,Suburb,NA,91.89,76.73,98.86,2,1,3,1,0,1,3,1,4,0.14716660574666607,2.3629498973329435
Sam Houston State University,18416,14808,Texas,Town,public,100.0,100.0,100.0,86,41,184,38,17,84,124,58,268,123.95514638526876,0.4084133949178917
Samford University,3375,3266,Alabama,Suburb,private,99.77,94.24,100.0,4,2,9,2,1,4,6,3,13,1.6908703317157363,4.371171523239252
San Diego Christian College,656,504,California,Suburb,private,88.34,70.55,98.25,2,1,3,1,0,1,3,1,4,1.9455302559008403,0.19957067001315124
San Diego State University,30267,27060,California,Large City,NA,100.0,100.0,100.0,75,43,141,32,18,60,107,61,201,101.47592149834496,5.416491390849291
San Francisco State University,26676,22263,California,Large City,public,100.0,100.0,100.0,69,39,127,29,16,54,98,55,181,97.063605710434,0.21725376518133074
San Jose State University,27777,23097,California,Large City,NA,100.0,100.0,100.0,72,41,133,30,17,57,102,58,190,101.70718264197092,0.08497875998919936
Santa Clara University,5498,5411,California,Midsize City,private,100.0,99.98,100.0,11,6,21,5,3,9,16,9,30,12.370635778086475,3.118855084786887
Sarah Lawrence College,1401,1384,New York,Suburb,NA,93.59,78.71,99.45,2,1,4,1,0,2,3,1,6,0.3389796210777863,2.40374582660771
SavanNAh State University,4237,3687,Georgia,Midsize City,NA,98.17,76.45,100.0,3,1,8,1,0,3,4,1,11,3.1192706346183425,0.8789856639937447
Schreiner University,1249,1137,Texas,Town,NA,99.98,98.08,100.0,6,3,12,3,1,6,9,4,18,8.26776263456493,0.06611382284787777
Scripps College,1064,1060,California,Suburb,NA,91.7,75.44,99.14,2,1,3,1,0,1,3,1,4,1.5857906991493642,0.8990871592680933
Seattle Pacific University,2898,2783,Washington,Large City,private,98.54,92.17,99.96,3,2,5,1,1,2,4,3,7,2.200143202958934,2.022028266004753
Seattle University,4563,4325,Washington,Large City,private,99.97,98.99,100.0,6,3,11,2,1,5,8,4,16,2.5437522661288865,5.4524773352001406
Seton Hall University,5972,5554,New Jersey,Suburb,NA,100.0,99.91,100.0,9,5,17,4,2,7,13,7,24,9.922069881267934,2.669470381677472
Seton Hill University,2091,1551,Pennsylvania,Suburb,NA,91.12,76.18,98.7,2,1,3,1,0,1,3,1,4,1.6332146162866759,0.7863404734192921
Sewanee - The University of the South,1700,1687,Tennessee,Rural,NA,96.38,79.41,99.91,2,1,5,1,0,2,3,1,7,0.4033169817994877,2.910074703289152
Shaw University,1545,1466,North CaroliNA,Large City,private,78.43,54.7,95.15,1,1,2,0,0,1,1,1,3,0.5073849145975766,1.0247337663081164
Shawnee State University,3408,2832,Ohio,Town,public,91.45,73.53,99.07,2,1,3,1,0,1,3,1,4,2.1285200475054395,0.33016878250938625
SheNAndoah University,2060,1991,Virginia,Small City,NA,96.89,82.05,99.82,2,1,4,1,0,2,3,1,6,2.354606312698647,1.1132748840493634
Shepherd University,3419,2614,West Virginia,Town,NA,85.8,64.34,96.93,1,1,2,1,0,1,2,1,3,0.14818959392551756,1.8023100180109028
Shippensburg University of Pennsylvania,5573,5160,Pennsylvania,Town,NA,99.72,97.11,100.0,4,2,7,2,1,3,6,3,10,5.260091463676414,0.6050949023502102
Shorter University,1402,1140,Georgia,Small City,NA,78.4,45.4,98.21,1,0,3,0,0,1,1,0,4,0.964994420996309,0.5655630824663722
Shorter University - College of Adult & ProfessioNAl Programs,113,56,Georgia,Small City,NA,8.63,2.82,23.58,0,0,0,0,0,0,0,0,0,0.09019385407161533,0.0
SieNA College,3161,3039,New York,Suburb,NA,98.2,91.72,99.88,3,2,5,1,1,2,4,3,7,3.095031322884136,0.9211113347720985
SieNA Heights University,2301,1290,Michigan,Town,NA,91.33,74.32,99.25,2,1,3,1,0,1,3,1,4,2.2757605137974855,0.16838440680396868
Sierra Nevada College,452,410,Nevada,Town,private,71.02,45.86,93.42,1,0,2,0,0,1,1,0,3,0.32200103092288385,0.9139003058433619
Silver Lake College of the Holy Family,393,267,Wisconsin,Town,NA,14.23,8.62,24.62,0,0,0,0,0,0,0,0,0,0.06477579268405298,0.08843982008501675
Simmons College,1743,1553,Massachusetts,Large City,NA,93.6,78.52,99.36,2,1,4,1,0,2,3,1,6,2.088340744359077,0.6573336426910581
Simpson College,1433,1280,Iowa,Town,NA,68.44,38.3,94.19,1,0,2,0,0,1,1,0,3,0.9558885763653511,0.19667593012512682
Simpson University,779,619,California,Small City,NA,91.94,76.09,99.13,2,1,3,1,0,1,3,1,4,2.220841141169827,0.2924209865636809
Skidmore College,2682,2636,New York,Suburb,private,98.01,89.9,99.91,3,2,5,1,1,2,4,3,7,1.0525562871871843,2.8605721206567813
Slippery Rock University of Pennsylvania,7613,7125,Pennsylvania,Town,NA,99.96,99.15,100.0,6,3,10,2,1,4,8,4,14,6.628570543657269,1.2856643262704308
Smith College,2526,2505,Massachusetts,Suburb,private,98.99,92.22,99.98,3,2,6,1,1,3,4,3,9,1.0777259417958942,3.5113321611191175
Soka University of America,409,412,California,Suburb,NA,71.23,50.24,90.65,1,0,2,0,0,1,1,0,3,1.0278273050042175,0.21557577438328754
Sonoma State University,8670,7887,California,Suburb,NA,100.0,100.0,100.0,22,13,42,9,5,18,31,18,60,31.65341018232631,0.06974088532656682
South CaroliNA State University,2523,2281,South CaroliNA,Town,NA,99.92,96.29,100.0,5,2,10,2,1,4,7,3,14,5.871420538612592,1.228595626907057
South College,1410,1410,Tennessee,Midsize City,NA,74.95,39.09,96.72,1,0,2,0,0,1,1,0,3,1.383642200334009,0.0
South Dakota State University,10886,8425,South Dakota,Town,NA,99.94,98.59,100.0,5,3,9,2,1,4,7,4,13,5.396276460323919,2.1046296792902037
South University - Columbia,806,556,South CaroliNA,Suburb,NA,92.63,69.14,99.49,2,1,4,1,0,2,3,1,6,2.603061030870049,0.0
South University - SavanNAh,499,396,Georgia,Midsize City,NA,66.17,41.64,89.78,1,0,2,0,0,1,1,0,3,0.05587229898241657,1.0257643655147823
South University - Tampa,543,424,Florida,Large City,private,96.53,85.01,99.87,2,1,5,1,1,2,3,2,7,3.3520660505226965,0.0
South University - West Palm Beach,699,535,Florida,Suburb,NA,98.62,91.06,99.98,3,2,6,1,1,3,4,3,9,4.259531445415581,0.008831758725536227
Southeast Missouri State University,10462,7779,Missouri,Small City,NA,99.78,94.32,100.0,4,2,10,2,1,4,6,3,14,5.013319293488807,1.0961493832194418
Southeastern LouisiaNA University,13317,8998,LouisiaNA,Small City,NA,100.0,100.0,100.0,22,10,47,8,4,19,30,14,66,29.400283951286394,1.1261043177109196
Southeastern Oklahoma State University,3122,2374,Oklahoma,Town,NA,99.89,95.76,100.0,5,2,10,2,1,5,7,3,15,1.975016754827853,4.851828835898036
Southeastern University,6241,4288,Florida,Midsize City,private,100.0,100.0,100.0,20,11,39,9,5,18,29,16,57,25.341125483233274,3.097124085185222
Southern Adventist University,2596,2173,Tennessee,Suburb,NA,99.56,93.79,100.0,4,2,8,2,1,3,6,3,11,0.6074287390118805,4.810296898986422
Southern Arkansas University Main Campus,3478,2924,Arkansas,Town,public,99.71,92.81,100.0,4,2,9,2,1,4,6,3,13,1.4083141938831358,4.4138187090007595
Southern Connecticut State University,7944,6814,Connecticut,Midsize City,NA,96.94,90.97,99.62,2,2,4,1,1,2,3,3,6,2.3670995649282736,1.1161107488393496
Southern Illinois University Carbondale,10990,9455,Illinois,Small City,NA,99.9,98.65,100.0,5,3,9,2,1,4,7,4,13,5.321336664427587,1.5667130671742568
Southern Illinois University Edwardsville,11408,9550,Illinois,Suburb,NA,99.82,98.21,100.0,4,3,8,2,1,3,6,4,11,5.617411838887051,0.6804171767474065
Southern Methodist University,6454,6240,Texas,Suburb,NA,100.0,100.0,100.0,20,10,42,9,4,19,29,14,61,21.622855325159513,7.259543455582622
Southern Nazarene University,1517,1483,Oklahoma,Suburb,NA,97.29,81.42,99.96,3,1,5,1,0,2,4,1,7,0.7986452829342476,2.801129863460501
Southern New Hampshire University,70662,19935,New Hampshire,Suburb,NA,100.0,100.0,100.0,60,31,110,25,12,47,85,43,157,10.526386455845469,74.29074986750555
Southern Oregon University,5522,3640,Oregon,Suburb,public,99.92,98.33,100.0,5,3,9,2,1,4,7,4,13,2.3604485057716253,4.726681157821042
Southern University and A & M College,5152,4530,LouisiaNA,Midsize City,NA,100.0,99.79,100.0,9,4,20,4,2,8,13,6,28,9.4731737374168,3.583651093229728
Southern University at New Orleans,2108,1520,LouisiaNA,Large City,NA,99.23,89.74,100.0,4,2,8,1,1,3,5,3,11,4.614556481823737,0.2523719768931713
Southern Utah University,8549,6279,Utah,Town,public,100.0,99.91,100.0,14,5,34,6,2,15,20,7,49,12.233714607108753,7.163788093777795
Southern Virginia University,908,853,Virginia,Town,NA,84.03,57.64,98.19,1,1,3,1,0,1,2,1,4,0.2678225189799409,1.5638140105416038
Southern Wesleyan University,1360,820,South CaroliNA,Suburb,NA,97.7,82.36,99.95,3,1,5,1,0,2,4,1,7,2.968006311872922,0.7958503678990152
Southwest Baptist University,2827,1835,Missouri,Town,private,93.68,72.51,99.78,2,1,4,1,0,2,3,1,6,1.130918189685252,1.6262174195831418
Southwest Minnesota State University,6711,1932,Minnesota,Town,public,89.73,72.13,98.58,2,1,3,1,0,1,3,1,4,1.072795493212661,1.2009555811498511
Southwestern Adventist University,802,652,Texas,Town,private,98.12,85.13,99.98,3,1,6,1,1,3,4,2,9,3.548191377766333,0.41515493125384495
Southwestern Assemblies of God University,1788,1492,Texas,Suburb,private,99.98,98.07,100.0,6,3,12,3,1,6,9,4,18,7.3075035476838295,0.9628402141030387
Southwestern Christian University,620,539,Oklahoma,Suburb,NA,55.0,30.42,82.8,1,0,1,0,0,1,1,0,2,0.4649589186966086,0.3323446910801847
Southwestern College - Winfield,1148,577,Kansas,Town,NA,76.76,49.78,95.67,1,0,2,0,0,1,1,0,3,0.10802738311570378,1.3477387864171844
Southwestern Oklahoma State University,4626,3713,Oklahoma,Town,public,99.62,91.88,100.0,4,2,9,2,1,4,6,3,13,3.572307320696348,1.9937182649369272
Southwestern University,1398,1367,Texas,Suburb,NA,99.98,98.44,100.0,6,3,13,3,1,6,9,4,19,8.58103864872472,0.17265756557321996
Spalding University,1250,916,Kentucky,Large City,NA,69.9,43.02,93.37,1,0,2,0,0,1,1,0,3,1.088599775286327,0.11146717349739571
Spelman College,2139,2086,Georgia,Large City,NA,98.06,86.2,99.97,3,1,6,1,1,2,4,2,8,0.42702399936561236,3.507361105769731
Spring Arbor University,1958,1380,Michigan,Suburb,NA,87.45,68.49,98.42,1,1,3,1,0,1,2,1,4,1.8249124498347686,0.24884925577022818
Spring Hill College,1376,1363,Alabama,Midsize City,NA,95.23,77.97,99.81,2,1,4,1,0,2,3,1,6,0.8931493198392646,2.143771734855417
Springfield College,2230,2188,Massachusetts,Midsize City,private,94.32,81.2,99.4,2,1,4,1,0,2,3,1,6,1.6165889126938415,1.249184512685886
St. Andrews University,641,567,North CaroliNA,Town,NA,61.18,37.99,86.03,1,0,1,0,0,1,1,0,2,0.12646223401170678,0.8183795896658108
St Catherine University,3157,2124,Minnesota,Large City,private,65.31,45.77,86.51,1,0,1,0,0,1,1,0,2,0.5415488755373209,0.5160944952774149
St. Francis College,2286,2097,New York,Large City,NA,94.49,83.96,99.13,2,1,3,1,1,1,3,2,4,2.6430584947804205,0.2540765856398315
St John's College MD,466,458,Maryland,Suburb,NA,57.73,36.53,81.52,1,0,1,0,0,1,1,0,2,0.09392214389061407,0.7655037949679286
St. John's College,319,309,New Mexico,Rural,NA,45.89,27.29,71.31,0,0,1,0,0,0,0,0,1,0.05501128444098297,0.5581186453342856
St John's University - New York,16760,11526,New York,Large City,NA,100.0,100.0,100.0,19,11,32,8,4,14,27,15,46,14.309607120207566,11.893771784201581
St Lawrence University,2411,2372,New York,Town,private,93.73,80.38,99.2,2,1,3,1,0,1,3,1,4,1.2846836364034944,1.4817582754605416
St Mary's College of Maryland,1574,1516,Maryland,Suburb,NA,83.06,64.78,95.58,1,1,2,1,0,1,2,1,3,1.4109193171123358,0.36354341742950624
St. Mary's University,2323,2228,Texas,Large City,NA,100.0,99.92,100.0,10,5,22,5,2,10,15,7,32,14.710351969242378,0.3178917586610849
St Olaf College,3039,3003,Minnesota,Town,NA,87.07,67.55,98.33,1,1,3,1,0,1,2,1,4,0.3042081802641447,1.7387394637284728
Stanford University,7064,7064,California,Suburb,NA,100.0,100.0,100.0,13,7,26,6,3,11,19,10,37,10.883956997633947,7.935496742002854
SUNY New Paltz,6733,6235,New York,Suburb,NA,99.98,99.52,100.0,6,4,10,2,2,4,8,6,14,7.83092052171002,0.6064436147869603
Stephen F Austin State University,10988,9567,Texas,Town,NA,100.0,100.0,100.0,51,25,109,23,10,50,74,35,159,73.4836563648728,0.3539748865784897
Stephens College,654,542,Missouri,Midsize City,NA,43.43,23.71,72.48,0,0,1,0,0,0,0,0,1,0.2542285849796484,0.31469007307509794
Sterling College Kansas,698,599,Kansas,Rural,private,66.99,42.55,89.89,1,0,2,0,0,1,1,0,3,0.06345297746116582,1.0420176184272292
Sterling College Vermont,155,120,Vermont,Rural,private,21.78,12.49,37.4,0,0,0,0,0,0,0,0,0,2.512152066515396e-05,0.24533316458057108
Stetson University,3068,3028,Florida,Suburb,private,100.0,99.99,100.0,12,7,23,5,3,10,17,10,33,16.136833620748302,0.7338080116645556
Stevens Institute of Technology,3125,3113,New Jersey,Suburb,NA,99.87,97.45,100.0,5,3,9,2,1,4,7,4,13,5.030157158090857,1.601118627073309
Stevenson University,3401,2926,Maryland,Rural,NA,97.64,89.22,99.85,3,2,5,1,1,2,4,3,7,3.0430774620558956,0.6994076379498487
Stillman College,675,552,Alabama,Midsize City,NA,63.68,36.86,88.55,1,0,2,0,0,1,1,0,3,0.6381768095011774,0.37337289344108204
Stonehill College,2494,2482,Massachusetts,Suburb,private,97.5,87.88,99.87,3,2,5,1,1,2,4,3,7,2.605491287858206,1.081426223515299
Stony Brook University,17369,16212,New York,Suburb,NA,100.0,100.0,100.0,16,10,26,7,4,11,23,14,37,18.981630593323143,3.3549535757913165
Stratford University,1979,471,Virginia,Suburb,NA,96.48,80.02,99.77,2,1,4,1,0,2,3,1,6,2.607549802846369,0.7359530995211959
Strayer University - District of Columbia,691,107,District of Columbia,Large City,NA,52.21,36.2,70.09,1,0,1,0,0,0,1,0,1,0.38634465761234443,0.35152632184875837
Suffolk University,5028,4762,Massachusetts,Large City,private,99.98,99.22,100.0,6,3,11,3,1,5,9,4,16,6.31831637305615,2.2115836612155744
Sul Ross State University,2292,1378,Texas,Town,NA,100.0,99.93,100.0,11,5,23,5,2,10,16,7,33,15.180265990482065,0.09199712686373154
Sullivan University,2596,1321,Kentucky,Large City,NA,90.66,67.12,99.51,2,1,4,1,0,2,3,1,6,1.8283664734090794,0.5415477360010801
Summit Christian College,32,17,Nebraska,Town,NA,0.57,0.29,1.24,0,0,0,0,0,0,0,0,0,0.0007549819174932925,0.0049475730468285335
University at Albany,13510,12740,New York,Small City,public,100.0,100.0,100.0,12,8,19,5,3,8,17,11,27,15.750270509788157,1.2424041598681532
Binghamton University,13739,13345,New York,Suburb,public,100.0,100.0,100.0,13,8,22,5,3,9,18,11,31,14.428741262397947,3.926964613048211
SUNY Fredonia,4393,4281,New York,Town,NA,99.56,96.84,99.98,4,2,6,2,1,3,6,3,9,5.314365291317324,0.10032574791121901
SUNY Geneseo,5558,5452,New York,Town,NA,99.89,98.73,100.0,5,3,8,2,1,3,7,4,11,6.681337458924483,0.1713140644645264
Purchase College,4062,3712,New York,Suburb,public,99.56,96.46,99.99,4,2,6,2,1,3,6,3,9,3.943708562611492,1.4860667401301126
The College at Brockport,7182,6419,New York,Town,NA,99.99,99.65,100.0,6,4,10,3,2,4,9,6,14,8.648893085615112,0.25824083944351034
Buffalo State,8527,7665,New York,Large City,NA,100.0,99.88,100.0,8,5,12,3,2,5,11,7,17,10.229569796945226,0.37668471428009603
SUNY Cortland,6345,6196,New York,Town,public,99.96,99.33,100.0,6,4,9,2,1,4,8,5,13,7.4538671026126275,0.44479700225452695
SUNY Old Westbury,4634,4056,New York,Suburb,public,99.64,97.26,99.99,4,3,6,2,1,3,6,4,9,5.604217431079489,0.028960158981811257
SUNY Oneonta,5940,5828,New York,Town,NA,99.93,99.05,100.0,5,3,8,2,1,4,7,4,12,7.203316947902959,0.10205350299123665
SUNY Oswego,7123,6836,New York,Town,NA,99.98,99.63,100.0,6,4,10,3,2,4,9,6,14,8.612047474628397,0.17970178698597317
SUNY Plattsburgh,5353,4894,New York,Town,public,99.84,98.34,100.0,5,3,7,2,1,3,7,4,10,6.25638474554436,0.1836188034067234
SUNY Potsdam,3323,3196,New York,Town,public,98.31,92.53,99.87,3,2,5,1,1,2,4,3,7,3.941252188545711,0.13865483945691792
SUNY College of Environmental Science and Forestry,1791,1737,New York,Midsize City,NA,90.86,77.12,98.21,2,1,3,1,0,1,3,1,4,1.8557906066975909,0.5347963890378667
SUNY Empire State College,9810,3772,New York,Suburb,NA,100.0,99.96,100.0,9,6,14,4,2,6,13,8,20,11.309146198856,0.9774523697431029
SUNY Polytechnic Institute,2179,1859,New York,Suburb,NA,93.13,81.91,98.67,2,1,3,1,0,1,3,1,4,2.676219544668465,0.0
SUNY Maritime College,1640,1581,New York,Large City,public,90.85,76.26,98.4,2,1,3,1,0,1,3,1,4,1.4811935616659793,0.9077563146999762
SusquehanNA University,2354,2283,Pennsylvania,Town,NA,96.56,85.5,99.78,2,1,4,1,1,2,3,2,6,1.142435660519732,2.2236302725873838
Swarthmore College,1581,1573,Pennsylvania,Suburb,NA,93.97,78.67,99.55,2,1,4,1,0,2,3,1,6,0.2138248562470087,2.590925757621266
Sweet Briar College,320,314,Virginia,Suburb,NA,42.13,23.4,66.13,0,0,1,0,0,0,0,0,1,0.2957206980403514,0.2505593770174584
Syracuse University,15248,14675,New York,Midsize City,NA,100.0,100.0,100.0,17,10,31,7,4,13,24,14,44,7.80881315511799,16.75603472378638
Tabor College,712,554,Kansas,Town,private,71.74,47.57,92.58,1,0,2,0,0,1,1,0,3,0.05506250110266455,1.2054630435395186
Talladega College,782,762,Alabama,Town,NA,73.71,48.26,93.71,1,0,2,0,0,1,1,0,3,0.6650160211157129,0.6689617310197364
Tarleton State University,11290,8429,Texas,Town,NA,100.0,100.0,100.0,53,25,113,23,11,52,76,36,165,75.82641612293733,0.22849450351105968
Taylor University,2111,1840,IndiaNA,Town,NA,85.24,66.87,97.13,1,1,3,1,0,1,2,1,4,0.5285247889301763,1.382784383676988
Temple University,29583,26643,Pennsylvania,Large City,NA,100.0,100.0,100.0,25,15,44,10,6,19,35,21,63,22.886387113638165,12.324046003002923
Tennessee State University,6504,5431,Tennessee,Large City,NA,99.91,94.33,100.0,5,2,12,2,1,5,7,3,17,4.623916346080745,2.3836692523194523
Tennessee Technological University,9365,8259,Tennessee,Town,NA,99.99,96.73,100.0,7,3,17,2,1,6,9,4,23,8.969141639044569,0.4115465748814938
Tennessee Wesleyan University,931,863,Tennessee,Town,NA,65.42,34.08,92.07,1,0,2,0,0,1,1,0,3,0.8252787875751074,0.2356736202386334
Texas A&M InterNAtioNAl University,6800,5191,Texas,Large City,public,100.0,100.0,100.0,32,15,68,14,6,31,46,21,99,45.98347060015025,0.06065218861423047
Texas A&M University - College Station,53069,46724,Texas,Midsize City,public,100.0,100.0,100.0,244,117,521,108,49,239,352,166,760,348.9894797740076,3.087880138817763
Texas A&M University - Commerce,8490,6068,Texas,Town,NA,100.0,100.0,100.0,39,19,84,17,8,39,56,27,123,56.369251504360726,0.3962837109517076
Texas A&M University - Corpus Christi,10174,8355,Texas,Large City,NA,100.0,100.0,100.0,47,23,101,21,10,46,68,33,147,68.18520551669198,0.20005891707562795
Texas A&M University - Kingsville,6782,5020,Texas,Town,NA,100.0,100.0,100.0,32,15,68,14,6,31,46,21,99,45.731487719195634,0.15799730658242866
Texas A&M University - TexarkaNA,1611,1166,Texas,Rural,NA,99.99,98.55,100.0,6,3,13,3,1,6,9,4,19,8.792159440875885,0.17442662282712446
Texas Christian University,9009,8738,Texas,Large City,NA,100.0,100.0,100.0,32,15,67,14,6,31,46,21,98,39.9426918053734,5.750484970152751
Texas College,993,940,Texas,Midsize City,NA,99.63,93.2,100.0,4,2,8,2,1,4,6,3,12,4.923881700815851,0.6687619471371988
Texas Lutheran University,1359,1305,Texas,Town,private,99.99,98.7,100.0,6,3,14,3,1,6,9,4,20,9.091814758767859,0.0671945087904707
Texas Southern University,7971,6695,Texas,Large City,NA,100.0,100.0,100.0,33,16,70,15,7,32,48,23,102,43.96760755251333,3.4940615228122245
Texas State University,34177,28019,Texas,Suburb,NA,100.0,100.0,100.0,160,77,341,71,32,157,231,109,498,229.99226683022422,0.5395733582417884
Texas Tech University,30737,27318,Texas,Large City,public,100.0,100.0,100.0,139,67,298,62,28,137,201,95,435,198.40587218515657,2.646702769169241
Texas Wesleyan University,1675,1497,Texas,Large City,NA,100.0,99.5,100.0,8,4,17,3,2,8,11,6,25,11.025953628797875,0.14151006621770504
Texas Woman's University,10311,6968,Texas,Midsize City,NA,100.0,100.0,100.0,48,23,103,21,10,47,69,33,150,69.19313704051045,0.18434401590306576
The College of Idaho,938,896,Idaho,Suburb,NA,69.99,35.85,95.57,1,0,2,0,0,1,1,0,3,0.8672465846678242,0.3353650824474461
The College of New Jersey,6956,6728,New Jersey,Suburb,NA,100.0,99.99,100.0,12,7,22,5,2,9,17,9,31,15.917512742791848,0.4664878695708908
The College of Saint Rose,2504,2426,New York,Small City,NA,95.35,85.67,99.32,2,1,3,1,1,1,3,2,4,2.8211456145495477,0.24466868557128751
The College of Saint Scholastica,2678,2179,Minnesota,Small City,NA,51.1,34.26,74.12,1,0,1,0,0,0,1,0,1,0.4319173013079422,0.28299548265668956
The College of Wooster,1979,1962,Ohio,Town,NA,91.05,73.26,99.06,2,1,3,1,0,1,3,1,4,0.49787123725216204,1.9121587292798357
The Evergreen State College,3615,3330,Washington,Suburb,NA,99.67,96.75,100.0,4,2,7,2,1,3,6,3,10,2.7175165452224364,2.9827577987316527
The King's College,555,542,New York,Large City,NA,76.45,53.51,94.65,1,1,2,0,0,1,1,1,3,0.0773757830721034,1.365312253005962
The Master's College and SemiNAry,1353,975,California,Suburb,NA,98.17,89.34,99.95,3,2,5,1,1,2,4,3,7,3.3220846822457744,0.6726716277914987
The New School,7124,6224,New York,Large City,private,100.0,99.98,100.0,11,6,20,4,2,9,15,8,29,2.0682669633876527,12.992471075210975
Stockton University,8276,7809,New Jersey,Suburb,NA,100.0,100.0,100.0,14,8,27,6,3,11,20,11,38,19.6258590758299,0.2581465461166613
The University of Alabama,33303,29923,Alabama,Midsize City,NA,100.0,100.0,100.0,45,22,93,18,8,39,63,30,132,28.41228762860966,34.851609958573384
The University of Findlay,3563,2499,Ohio,Town,private,94.06,79.0,99.48,2,1,4,1,0,2,3,1,6,1.9370840807611782,0.8844163413273639
The University of MontaNA,9322,7444,MontaNA,Small City,NA,100.0,89.71,100.0,8,2,61,5,1,44,13,3,105,8.294768104885275,4.010463545023983
The University of MontaNA - Western,1540,1230,MontaNA,Town,public,87.09,28.28,100.0,1,0,10,1,0,7,2,0,17,1.3694430331121346,0.6758720108738104
The University of Tampa,7970,7728,Florida,Large City,NA,100.0,100.0,100.0,16,9,31,7,4,14,23,13,45,15.908423963530366,7.320792181654769
The University of Tennessee - Knoxville,22315,20965,Tennessee,Midsize City,NA,100.0,99.99,100.0,17,7,41,6,2,16,23,9,57,19.62024266204126,3.856282062217163
The University of Tennessee - Chattanooga,10172,8962,Tennessee,Midsize City,NA,100.0,97.53,100.0,8,3,18,3,1,7,11,4,25,9.64624314133568,0.5213987952348398
The University of Tennessee - Martin,6327,4950,Tennessee,Town,NA,99.82,90.13,100.0,5,2,11,2,1,4,7,3,15,6.012465079040052,0.3165398801273497
The University of Texas at Arlington,33305,17819,Texas,Large City,public,100.0,100.0,100.0,155,75,331,69,31,152,224,106,483,222.62347014933522,1.1748693915975088
The University of Texas at Austin,40489,37740,Texas,Large City,NA,100.0,100.0,100.0,180,87,384,80,36,176,260,123,560,253.64460589928848,6.051182586484657
The University of Texas at Dallas,18474,15294,Texas,Midsize City,NA,100.0,100.0,100.0,85,41,181,38,17,83,123,58,264,120.91092076941166,1.340328713789065
The University of Texas at El Paso,21335,14025,Texas,Large City,NA,100.0,100.0,100.0,99,48,212,44,20,97,143,68,309,142.6291209684459,0.8953309179936467
The University of Texas at San Antonio,26437,21510,Texas,Large City,NA,100.0,100.0,100.0,123,59,263,55,25,121,178,84,384,177.2801722737724,0.6898153753043619
The University of Texas at Tyler,7440,4842,Texas,Midsize City,NA,100.0,100.0,100.0,34,17,74,15,7,34,49,24,108,49.51804128164876,0.22701631410406617
The University of Texas of the Permian Basin,6066,2192,Texas,Midsize City,public,100.0,100.0,100.0,28,14,60,12,6,28,40,20,88,40.33088164900619,0.20457817320594654
The University of Texas Rio Grande Valley,24216,18647,Texas,Small City,public,100.0,100.0,100.0,114,55,243,50,23,111,164,78,354,163.74120018356226,0.43369941522412
The University of Virginia's College at Wise,2093,1210,Virginia,Town,NA,97.92,82.81,99.92,3,1,5,1,1,2,4,2,7,3.760674537343337,0.10689981451992119
The University of West Florida,10000,6906,Florida,Small City,public,100.0,100.0,100.0,41,23,79,18,10,36,59,33,115,56.98512285888584,1.1980284620246826
Thiel College,764,751,Pennsylvania,Town,NA,55.73,38.02,77.19,1,0,1,0,0,0,1,0,1,0.4663418293387142,0.34789225647853217
Thomas AquiNAs College,364,369,California,Rural,private,57.67,37.23,83.75,1,0,1,0,0,1,1,0,2,0.5799882649666656,0.2781257969786568
Thomas College,1660,774,Maine,Rural,NA,67.85,42.98,88.55,1,0,2,0,0,1,1,0,3,0.39608613850445845,0.7377516047689332
Thomas More College,1878,1356,Kentucky,Suburb,NA,81.26,56.09,97.23,1,1,3,0,0,1,1,1,4,1.009410657194596,0.6640700750476558
Thomas More College of Liberal Arts,90,90,New Hampshire,Suburb,private,8.61,4.27,17.08,0,0,0,0,0,0,0,0,0,0.0,0.08994152464149059
Thomas University,1118,438,Georgia,Town,NA,93.66,75.46,99.77,2,1,4,1,0,2,3,1,6,0.61619164020608,2.135938956686654
Tiffin University,2243,1772,Ohio,Town,private,97.57,85.29,99.95,3,1,5,1,1,2,4,2,7,0.5901461276972377,3.120185458314679
Toccoa Falls College,1420,872,Georgia,Town,NA,83.99,56.08,98.63,1,1,3,1,0,1,2,1,4,0.6776511690867382,1.1517650282484024
Tougaloo College,794,766,Mississippi,Midsize City,private,93.8,75.15,99.54,2,1,4,1,0,2,3,1,6,2.561074454513532,0.21405934821722744
Touro College,6428,4232,New York,Large City,NA,99.99,99.62,100.0,6,4,11,3,2,5,9,6,16,7.116115668567732,2.0529938556745457
Towson University,19592,17106,Maryland,Small City,NA,100.0,100.0,100.0,17,10,30,7,4,12,24,14,42,14.647680129429544,9.52262411342255
Transylvania University,962,963,Kentucky,Large City,private,62.49,36.79,88.95,1,0,2,0,0,1,1,0,3,0.7708409090195077,0.2091326262238188
Trevecca Nazarene University,2216,1317,Tennessee,Large City,NA,95.37,74.81,99.89,2,1,5,1,0,2,3,1,7,1.3218198892552553,1.7458479590160219
Trident University InterNAtioNAl,4368,1862,California,Suburb,private,99.94,97.27,100.0,5,3,11,2,1,5,7,4,16,0.5432801469308007,6.876371644062215
Trine University,4099,1938,IndiaNA,Town,NA,97.3,88.19,99.86,3,2,5,1,1,2,4,3,7,1.6635648494785127,1.9459105784654664
Trine University - RegioNAl/Non - TraditioNAl Campuses,368,210,IndiaNA,Large City,NA,22.39,13.04,37.42,0,0,0,0,0,0,0,0,0,0.0,0.2534116394312526
Trinity Christian College,1109,907,Illinois,Suburb,private,55.44,38.33,78.14,1,0,1,0,0,0,1,0,1,0.37837765977852084,0.4293592949297917
Trinity College,2218,2117,Connecticut,Midsize City,NA,96.36,85.28,99.77,2,1,4,1,1,2,3,2,6,0.11563324857929654,3.192049400503988
Trinity InterNAtioNAl University - Florida,156,64,Florida,Suburb,NA,61.94,42.02,85.25,1,0,1,0,0,1,1,0,2,0.9630245007026531,0.0
Trinity InterNAtioNAl University - Illinois,936,592,Illinois,Suburb,NA,63.45,44.16,85.21,1,0,1,0,0,1,1,0,2,0.2388909801144051,0.7659600827082074
Trinity University,2389,2353,Texas,Large City,NA,100.0,99.75,100.0,9,4,18,4,2,8,13,6,26,11.291557206020308,1.236553941559422
Trinity Washington University,1530,1075,District of Columbia,Large City,NA,80.91,63.6,93.26,1,1,2,0,0,1,1,1,3,0.9270113432653739,0.727846008615163
Troy University,14006,9491,Alabama,Town,public,100.0,100.0,100.0,17,8,35,7,3,14,24,11,49,14.497647473784925,9.04219565541172
Truett McConnell University,2574,780,Georgia,Town,NA,87.78,50.27,99.78,2,1,4,1,0,2,3,1,6,1.9738885054788027,0.1271747876189161
Truman State University,5895,5134,Missouri,Town,NA,97.06,80.39,99.97,3,1,6,1,0,2,4,1,8,2.741792586888136,0.781851317374152
Tufts University,5543,5483,Massachusetts,Suburb,NA,100.0,99.66,100.0,7,4,13,3,2,6,10,6,19,2.350863730181154,7.746705114952734
Tulane University of LouisiaNA,7872,6716,LouisiaNA,Large City,private,100.0,99.99,100.0,12,6,24,5,3,10,17,9,34,2.397671120085693,14.707736655361176
Tusculum College,1485,1376,Tennessee,Town,NA,86.29,56.56,98.92,1,1,3,1,0,1,2,1,4,0.9548112488829721,1.0296771644131621
Tuskegee University,2830,2722,Alabama,Town,NA,99.35,92.0,100.0,4,2,7,1,1,3,5,3,10,1.1525950321131078,3.872582002934931
Union College Kentucky,1096,918,Kentucky,Town,private,70.37,43.03,93.7,1,0,2,0,0,1,1,0,3,0.848025239311448,0.3673560182553428
Union College Nebraska,779,707,Nebraska,Large City,private,65.06,40.83,89.15,1,0,2,0,0,1,1,0,3,0.006700464517752971,1.0427563235236703
Union College New York,2265,2176,New York,Small City,NA,95.83,84.71,99.63,2,1,4,1,1,2,3,2,6,1.1336166313579592,2.0413142796174197
Union Institute & University,814,434,Ohio,Large City,NA,94.7,80.71,99.69,2,1,4,1,0,2,3,1,6,0.1769749764506302,2.7516062949616544
Union University,2179,1599,Tennessee,Small City,NA,92.52,66.47,99.74,2,1,4,1,0,2,3,1,6,1.4650906419139542,1.1246384739196342
United States Air Force Academy,4279,4276,Colorado,Town,NA,100.0,99.41,100.0,7,4,14,3,1,6,10,5,20,0.1418996144244257,9.905221715951367
United States Coast Guard Academy,1047,1044,Connecticut,Small City,NA,90.0,70.22,98.96,2,1,3,1,0,1,3,1,4,0.011595534676475418,2.2862717024005903
United States Merchant Marine Academy,952,954,New York,Suburb,public,87.5,66.42,98.66,1,1,3,1,0,1,2,1,4,0.18545624196647004,1.8896401537381948
United States Military Academy,4487,4491,New York,Town,public,100.0,99.44,100.0,7,4,14,3,2,6,10,6,20,0.386878915360517,9.577531350897747
United States Naval Academy,4495,4495,Maryland,Suburb,NA,99.99,99.33,100.0,7,4,13,3,1,6,10,5,19,0.4174317506249514,9.100372571609295
Unity College,706,694,Maine,Rural,private,55.9,35.48,79.48,1,0,1,0,0,0,1,0,1,0.08028773077793078,0.7372696407508061
Polytechnic University of Puerto Rico - Orlando,124,53,Florida,Suburb,NA,53.6,35.16,78.16,1,0,1,0,0,0,1,0,1,0.765481013379032,0.0
University at Buffalo,21016,19401,New York,Suburb,NA,100.0,100.0,100.0,19,12,31,8,5,13,27,17,44,24.2394992811275,2.6299123853575788
University of Advancing Technology,775,508,ArizoNA,Midsize City,NA,82.66,59.46,97.25,1,1,2,1,0,1,2,1,3,0.2976397741072356,1.451011284810653
University of Akron Main Campus,16874,13563,Ohio,Midsize City,public,100.0,99.86,100.0,9,5,16,3,2,6,12,7,22,11.246518736932657,0.646486414085919
University of Alabama at Birmingham,13130,9677,Alabama,Midsize City,NA,100.0,99.99,100.0,15,7,30,6,3,12,21,10,42,17.707915396345754,2.5293016063708835
University of Alabama in Huntsville,7089,5903,Alabama,Midsize City,NA,100.0,99.13,100.0,7,3,15,3,1,6,10,4,21,8.774931130641189,1.5386399131026498
University of Alaska Anchorage,14954,6974,Alaska,Large City,NA,74.95,50.63,95.45,1,1,2,0,0,1,1,1,3,0.17289350049192062,1.2092098172334735
University of Alaska Fairbanks,6633,3022,Alaska,Suburb,public,67.17,43.99,89.77,1,0,2,0,0,1,1,0,3,0.07367607030047044,1.0381563660225888
University of Alaska Southeast,2060,629,Alaska,Town,NA,37.11,22.35,59.58,0,0,1,0,0,0,0,0,1,0.022436284445387603,0.44063728974783795
University of ArizoNA,34099,29325,ArizoNA,Large City,NA,100.0,100.0,100.0,68,39,120,27,16,49,95,55,169,65.14517604847093,30.142279205776873
University of Arkansas,23037,20464,Arkansas,Small City,NA,100.0,100.0,100.0,30,14,64,12,5,28,42,19,92,7.510302049006301,34.512359624811886
University of Arkansas at Little Rock,8794,4603,Arkansas,Midsize City,NA,99.51,87.5,100.0,4,2,9,1,1,3,5,3,12,4.53566250545043,0.7743604586085397
University of Arkansas at Pine Bluff,2517,2341,Arkansas,Small City,public,94.42,73.71,99.8,2,1,4,1,0,2,3,1,6,0.7380923787218844,2.142941435746911
University of Baltimore,2950,1716,Maryland,Large City,NA,95.38,84.08,99.5,2,1,4,1,1,2,3,2,6,2.9011506668434124,0.17175934063798082
University of Bridgeport,3124,2300,Connecticut,Midsize City,private,96.75,87.87,99.71,2,2,4,1,1,2,3,3,6,0.3353042110614142,3.0887168695624494
University of California - Berkeley,30577,29351,California,Midsize City,public,100.0,100.0,100.0,74,42,139,31,18,60,105,60,199,94.20037250363653,11.01070609934454
University of California - Davis,30067,29284,California,Suburb,NA,100.0,100.0,100.0,77,44,143,32,18,61,109,62,204,108.71476237501753,0.8210548544978398
University of California - Irvine,29310,28855,California,Large City,public,100.0,100.0,100.0,75,43,140,32,18,60,107,61,200,106.39848012695444,0.6587796260516807
University of California - Los Angeles,31001,30458,California,Large City,NA,100.0,100.0,100.0,78,44,145,33,19,62,111,63,207,105.7046966960766,4.804380601902946
University of California - Riverside,20077,19719,California,Large City,public,100.0,100.0,100.0,52,30,96,22,12,41,74,42,137,73.48598149599796,0.11103321098877077
University of California - San Diego,28582,27880,California,Large City,NA,100.0,100.0,100.0,73,42,136,31,17,58,104,59,194,101.50528799277366,2.106237627979899
University of California - Santa Barbara,22182,21777,California,Suburb,NA,100.0,100.0,100.0,56,32,105,24,13,45,80,45,150,78.474614737072,1.4788190510739103
University of California - Santa Cruz,17573,17082,California,Small City,NA,100.0,100.0,100.0,45,26,84,19,11,36,64,37,120,63.79503833452963,0.4406414638222179
University of Central Arkansas,9549,8070,Arkansas,Small City,NA,99.97,96.79,100.0,6,3,13,2,1,5,8,4,18,4.65814766312626,3.5116495560864127
University of Central Florida,56854,39962,Florida,Suburb,NA,100.0,100.0,100.0,234,132,456,102,57,207,336,189,663,330.5334669302702,5.2401558457955595
University of Central Missouri,9800,7701,Missouri,Town,NA,99.65,91.93,100.0,4,2,9,2,1,4,6,3,13,5.188315202880627,0.45900039522893454
University of Central Oklahoma,14340,10448,Oklahoma,Suburb,public,100.0,99.72,100.0,9,4,21,4,2,9,13,6,30,11.777265434235044,1.5159508686332024
University of Charleston,1833,1220,West Virginia,Small City,NA,78.44,55.9,94.83,1,1,2,0,0,1,1,1,3,0.07117427211897122,1.4604883028829523
University of Chicago,6305,6288,Illinois,Large City,private,100.0,99.77,100.0,8,4,15,3,2,7,11,6,22,0.6573510191067523,10.468801352472074
University of CincinNAti - Main Campus,26558,22622,Ohio,Large City,NA,100.0,100.0,100.0,15,8,28,6,3,11,21,11,39,16.274123029018458,4.475695336885454
University of Colorado at Colorado Springs,10804,8171,Colorado,Large City,public,99.84,94.69,100.0,5,2,11,2,1,5,7,3,16,4.086877322265507,2.341367069918128
University of Colorado Boulder,29057,26977,Colorado,Midsize City,NA,100.0,100.0,100.0,26,14,53,11,6,23,37,20,76,7.20614243697217,29.538390513844753
University of Colorado Denver/Anschutz Medical Campus,15589,8671,Colorado,Large City,NA,99.99,98.17,100.0,6,3,15,3,1,6,9,4,21,6.088209272886561,2.8566300699082823
University of Connecticut,19243,18555,Connecticut,Suburb,NA,100.0,99.98,100.0,10,6,17,4,3,7,14,9,24,4.164085341596506,10.080615189267073
University of Dallas,1456,1421,Texas,Midsize City,private,99.66,93.48,100.0,4,2,9,2,1,4,6,3,13,4.372243501969263,1.2927859366201082
University of Dayton,8498,8079,Ohio,Midsize City,NA,99.91,98.06,100.0,5,3,9,2,1,4,7,4,13,3.192435761965454,3.855244687528735
University of Delaware,19752,18195,Delaware,Suburb,NA,100.0,100.0,100.0,14,9,25,6,3,11,20,12,36,2.9992412535134783,17.343589420269723
University of Denver,5768,5494,Colorado,Large City,NA,99.92,97.29,100.0,5,3,11,2,1,5,7,4,16,1.1267755732930658,5.9949339820265335
University of Detroit Mercy,2839,2338,Michigan,Large City,private,95.55,82.36,99.8,2,1,4,1,1,2,3,2,6,2.8718698871515316,0.2378031848565979
University of Dubuque,1953,1709,Iowa,Small City,NA,84.08,61.56,97.87,1,1,3,1,0,1,2,1,4,0.49051174755321597,1.3446313755202264
University of Evansville,2346,2024,IndiaNA,Midsize City,NA,92.21,75.52,99.28,2,1,3,1,0,1,3,1,4,0.8968905509118142,1.6518224999714548
University of Florida,35251,31384,Florida,Midsize City,NA,100.0,100.0,100.0,147,83,286,64,36,130,211,119,416,208.33430031867394,2.4183119296852507
University of Georgia,28844,27142,Georgia,Midsize City,NA,100.0,100.0,100.0,21,8,56,8,3,23,29,11,79,20.35268216789486,8.595590034354757
University of Providence,930,469,MontaNA,Small City,private,73.1,26.8,99.99,1,0,6,0,0,4,1,0,10,0.7307055742456652,0.5810500323896026
University of Hartford,5073,4460,Connecticut,Midsize City,NA,99.7,96.89,100.0,4,2,7,2,1,3,6,3,10,0.5685032973327532,5.250725512766317
University of Hawaii at Hilo,2972,2340,Hawaii,Town,public,71.45,48.84,93.48,1,0,2,0,0,1,1,0,3,0.004288051272786745,1.2470632591072135
University of Hawaii at Manoa,12877,10702,Hawaii,Large City,NA,99.99,99.38,100.0,6,4,13,3,1,5,9,5,18,0.016689073759270392,9.19041379381136
University of Hawaii - West Oahu,3083,1611,Hawaii,Suburb,NA,5.66,3.45,9.53,0,0,0,0,0,0,0,0,0,0.005494008936967346,0.05273624448967312
University of Houston,37217,27159,Texas,Large City,public,100.0,100.0,100.0,172,83,368,76,35,169,248,118,537,247.2428786534145,1.5204751258381624
University of Houston - Downtown,12402,6320,Texas,Large City,public,100.0,100.0,100.0,58,28,124,26,12,57,84,40,181,83.4063335959775,0.2840391498308753
University of Houston - Victoria,3273,1722,Texas,Small City,public,100.0,100.0,100.0,15,7,33,7,3,15,22,10,48,22.290269442282547,0.0
University of Idaho,9889,7166,Idaho,Town,NA,100.0,99.42,100.0,8,4,20,4,1,10,12,5,30,7.0920520197962675,5.06465510627428
University of Illinois at Chicago,19446,17961,Illinois,Large City,public,100.0,99.91,100.0,8,5,13,3,2,5,11,7,18,10.218868972634317,0.5860907378523201
University of Illinois at Springfield,2932,1903,Illinois,Midsize City,public,80.45,65.43,94.2,1,1,2,0,0,1,1,1,3,1.5348879080281241,0.09656409712980535
University of Illinois at UrbaNA - Champaign,33955,32613,Illinois,Small City,NA,100.0,100.0,100.0,16,10,28,6,4,11,22,14,39,16.66571884538615,5.2134828322391265
University of IndiaNApolis,4486,3828,IndiaNA,Large City,NA,96.01,87.09,99.52,2,1,4,1,1,2,3,2,6,2.830636715416557,0.3894078296625535
University of Iowa,24506,21222,Iowa,Small City,public,100.0,99.98,100.0,13,6,28,5,2,11,18,8,39,9.38979631030442,8.249188048526452
University of Kansas,19344,17151,Kansas,Small City,public,100.0,99.67,100.0,8,4,16,3,2,7,11,6,23,2.45421433486162,8.95635135203252
University of Kentucky,22420,20657,Kentucky,Large City,NA,100.0,100.0,100.0,17,8,37,7,3,15,24,11,52,17.215112836802376,6.032599189092744
University of La Verne,5169,3759,California,Suburb,NA,100.0,100.0,100.0,13,7,24,5,3,10,18,10,34,18.020015143806084,0.36784398655537676
University of LouisiaNA at Lafayette,15665,12767,LouisiaNA,Midsize City,NA,100.0,100.0,100.0,26,12,57,10,5,23,36,17,80,34.249861918962075,2.345330022336019
University of LouisiaNA at Monroe,7946,5212,LouisiaNA,Small City,NA,100.0,99.99,100.0,14,6,29,5,2,12,19,8,41,16.781438018620506,2.1562154618624163
University of Louisville,15543,12025,Kentucky,Large City,NA,100.0,99.95,100.0,11,5,25,5,2,11,16,7,36,13.046156607137704,3.0128889415908304
University of Maine,9277,8204,Maine,Suburb,NA,99.09,89.49,99.99,3,2,6,1,1,3,4,3,9,2.5277253906585204,2.1720761139955265
University of Maine at Augusta,4013,1317,Maine,Town,public,74.06,43.51,93.33,1,0,2,0,0,1,1,0,3,1.3354525886062485,0.01356741698788161
University of Maine at Farmington,1810,1673,Maine,Town,public,58.09,32.53,82.14,1,0,1,0,0,1,1,0,2,0.5094925582282857,0.35946081975391064
University of Maine at Fort Kent,1762,582,Maine,Rural,NA,50.09,27.03,74.63,0,0,1,0,0,0,0,0,1,0.5573306644834695,0.13735563693023084
University of Maine at Machias,698,367,Maine,Rural,public,36.57,20.74,58.44,0,0,1,0,0,0,0,0,1,0.17897473319247068,0.2756929068314408
University of Maine at Presque Isle,1413,716,Maine,Rural,NA,41.31,20.88,65.28,0,0,1,0,0,0,0,0,1,0.4466005024522399,0.08607709296897223
University of Mary,2234,1794,North Dakota,Rural,NA,97.6,76.26,100.0,3,1,7,1,0,4,4,1,11,2.675577563518469,1.0496136966327243
University of Mary Hardin - Baylor,3329,3045,Texas,Suburb,NA,100.0,100.0,100.0,15,7,33,7,3,15,22,10,48,22.215355612809553,0.13728605024615298
University of Mary Washington,4399,3905,Virginia,Suburb,NA,99.96,97.49,100.0,5,3,10,2,1,4,7,4,14,6.717881517746851,1.1148284126813786
University of Maryland - Baltimore County,11238,9543,Maryland,Suburb,public,100.0,99.93,100.0,9,5,15,4,2,6,13,7,21,10.817743817445615,1.4032414763857066
University of Maryland - College Park,29870,27708,Maryland,Suburb,public,100.0,100.0,100.0,27,16,48,11,6,20,38,22,68,20.952986722619436,17.112582768617923
University of Maryland Eastern Shore,2860,2573,Maryland,Town,public,96.02,85.01,99.64,2,1,4,1,1,2,3,2,6,2.2708287233997355,0.9521128229547187
University of Maryland - University College,45609,9714,Maryland,Suburb,NA,100.0,100.0,100.0,43,24,79,18,10,34,61,34,113,32.00866663792127,28.9604800405465
University of Massachusetts Amherst,23386,21577,Massachusetts,Suburb,NA,100.0,100.0,100.0,30,17,54,12,7,23,42,24,77,34.11022344354368,8.24797797113001
University of Massachusetts - Boston,12658,9574,Massachusetts,Large City,NA,100.0,100.0,100.0,17,10,31,7,4,13,24,14,44,23.315199312258432,1.2950155359023305
University of Massachusetts - Dartmouth,6764,5790,Massachusetts,Suburb,NA,100.0,99.95,100.0,9,5,16,4,2,7,13,7,23,12.790593594940283,0.2312442186854652
University of Massachusetts - Lowell,14015,10495,Massachusetts,Suburb,NA,100.0,100.0,100.0,18,11,33,8,4,14,26,15,47,24.785722804269312,1.334596612090481
University of Memphis,17392,12400,Tennessee,Large City,NA,100.0,99.94,100.0,14,6,33,5,2,13,19,8,46,15.558614954819653,3.7280739078318303
University of Miami,10834,10216,Florida,Suburb,NA,100.0,100.0,100.0,26,15,51,11,6,23,37,21,74,27.520277077771972,10.039224086675155
University of Michigan - Ann Arbor,29819,28702,Michigan,Midsize City,NA,100.0,100.0,100.0,28,16,55,12,7,24,40,23,79,20.508744866657246,19.556116410945123
University of Michigan - Dearborn,7132,5137,Michigan,Small City,NA,99.95,98.62,100.0,5,3,11,2,1,5,7,4,16,7.6482769418782635,0.03621873369516128
University of Michigan - Flint,6432,3809,Michigan,Small City,public,99.9,97.92,100.0,5,3,10,2,1,4,7,4,14,6.833737599587627,0.12108634256824949
University of Minnesota - Crookston,2832,1195,Minnesota,Town,public,80.04,57.15,96.11,1,1,2,0,0,1,1,1,3,0.40723075888395094,1.2021250174604872
University of Minnesota - Duluth,10124,8906,Minnesota,Small City,NA,89.0,73.53,97.93,2,1,3,1,0,1,3,1,4,1.7603254188320092,0.44603254157265426
University of Minnesota - Morris,1627,1526,Minnesota,Town,NA,38.13,24.0,58.53,0,0,1,0,0,0,0,0,1,0.28010478451158627,0.19963694663577874
University of Minnesota - Twin Cities,35429,29991,Minnesota,Large City,NA,100.0,99.85,100.0,8,5,15,3,2,6,11,7,21,4.712797016296606,6.488408170454084
University of Mississippi,18734,17511,Mississippi,Town,NA,100.0,100.0,100.0,43,22,86,17,8,36,60,30,122,39.29826468536876,21.385491733442418
University of Missouri - Columbia,23800,22197,Missouri,Midsize City,NA,100.0,99.99,100.0,14,7,29,5,3,12,19,10,41,9.7404889240633,9.278593816956048
University of Missouri - Kansas City,11369,6760,Missouri,Large City,public,99.92,96.23,100.0,5,2,11,2,1,5,7,3,16,5.170644606166795,1.9670760912318523
University of Missouri - St Louis,13791,5492,Missouri,Suburb,public,99.98,97.85,100.0,6,3,14,2,1,5,8,4,19,7.286556057835976,1.18813497283681
University of Mobile,1442,1152,Alabama,Rural,NA,95.01,76.96,99.78,2,1,4,1,0,2,3,1,6,1.559656408266896,1.4340587533733429
University of Montevallo,2352,2101,Alabama,Suburb,NA,97.8,83.44,99.96,3,1,6,1,0,2,4,1,8,3.259473143854144,0.5513937340004552
University of Mount Union,2093,2046,Ohio,Town,NA,84.37,64.67,96.85,1,1,2,1,0,1,2,1,3,1.205771143054683,0.6483590960683386
University of Nebraska at Kearney,4846,4063,Nebraska,Town,NA,62.29,43.45,84.96,1,0,1,0,0,1,1,0,2,0.413258227087891,0.5607280638957878
University of Nebraska at Omaha,12620,9820,Nebraska,Large City,NA,83.12,66.48,96.03,1,1,2,1,0,1,2,1,3,1.1065203728261068,0.6722329944646446
University of Nebraska - Lincoln,20955,19534,Nebraska,Large City,public,99.89,97.6,100.0,5,3,9,2,1,4,7,4,13,1.621795531515279,5.195881500763894
University of Nevada - Las Vegas,25281,18958,Nevada,Midsize City,NA,100.0,100.0,100.0,99,36,265,43,14,123,142,50,388,135.83583112026108,6.539015924556055
University of Nevada - Reno,18354,15572,Nevada,Midsize City,NA,100.0,100.0,100.0,70,27,182,30,11,84,100,38,266,88.46522662770022,11.671299545583226
University of New England,4427,2361,Maine,Suburb,NA,98.1,86.78,99.94,3,1,5,1,1,2,4,2,7,0.5546544067908717,3.402665375960504
University of New Hampshire at Manchester,737,575,New Hampshire,Midsize City,NA,28.7,0.55,52.15,0,0,1,0,0,0,0,0,1,0.3295279434266989,0.008597309230233711
University of New Hampshire - Main Campus,13010,12677,New Hampshire,Suburb,NA,100.0,99.31,100.0,8,4,16,3,1,7,11,5,23,3.242464681690381,8.568925798227351
University of New Haven,5214,4831,Connecticut,Suburb,NA,99.82,97.51,100.0,4,3,8,2,1,3,6,4,11,0.618428516078689,5.697190222446613
University of New Mexico - Main Campus,20359,15093,New Mexico,Large City,public,100.0,100.0,100.0,28,11,70,11,4,29,39,15,99,31.05730827221245,7.734326479361466
University of New Orleans,6468,4737,LouisiaNA,Large City,NA,100.0,99.9,100.0,11,5,23,4,2,9,15,7,32,13.963440010376528,0.6858121177425004
University of North Alabama,6061,5141,Alabama,Small City,public,99.99,98.77,100.0,7,3,14,3,1,5,10,4,19,8.041326013177219,1.3951350946846897
University of North CaroliNA at Asheville,3820,3285,North CaroliNA,Small City,NA,93.54,74.78,99.63,2,1,4,1,0,2,3,1,6,1.6501529563551862,1.0875593802225574
University of North CaroliNA at Chapel Hill,18863,18303,North CaroliNA,Small City,public,100.0,99.97,100.0,11,6,23,4,2,9,15,8,32,7.98760045674752,7.658107004772755
University of North CaroliNA at Charlotte,23915,20597,North CaroliNA,Large City,public,100.0,99.94,100.0,11,5,22,4,2,9,15,7,31,11.093861079213209,3.712626257412387
University of North CaroliNA at Greensboro,16441,14136,North CaroliNA,Large City,NA,100.0,99.4,100.0,7,4,15,3,1,6,10,5,21,7.767443531140096,2.4834380610453706
University of North CaroliNA at Pembroke,5478,4483,North CaroliNA,Town,NA,95.79,79.17,99.86,2,1,5,1,0,2,3,1,7,2.6854024995603325,0.47990674427872027
University of North CaroliNA at Wilmington,14499,12346,North CaroliNA,Midsize City,NA,100.0,99.4,100.0,7,4,14,3,1,6,10,5,20,6.134186338843154,3.9557235856686908
University of North Dakota,10999,8525,North Dakota,Small City,public,100.0,98.93,100.0,7,3,17,3,1,8,10,4,25,7.328520608908982,3.2014461692951697
University of North Florida,14251,10223,Florida,Large City,NA,100.0,100.0,100.0,60,34,117,26,15,53,86,49,170,85.86968464598657,0.45311628209430516
University of North Texas,31444,25592,Texas,Midsize City,NA,100.0,100.0,100.0,145,70,309,64,29,142,209,99,451,207.20484197416636,1.4515328000092378
University of Northern Colorado,10103,8328,Colorado,Midsize City,NA,99.58,91.53,100.0,4,2,9,2,1,4,6,3,13,3.860343219712566,1.6113573098228355
University of Northern Iowa,9959,9100,Iowa,Small City,NA,99.94,95.2,100.0,5,2,13,2,1,6,7,3,19,7.157358527573868,0.3149892391718591
University of Notre Dame,8577,8557,IndiaNA,Suburb,private,100.0,99.97,100.0,10,6,20,4,2,9,14,8,29,0.392737787821633,14.355222728438774
University of Oklahoma Norman Campus,22028,19065,Oklahoma,Suburb,NA,100.0,100.0,100.0,37,18,81,16,7,36,53,25,117,11.95596549224048,41.60827251002736
University of Oregon,19336,17801,Oregon,Midsize City,NA,100.0,100.0,100.0,23,14,43,10,6,19,33,20,62,6.803918329680006,26.566843281515695
University of Pennsylvania,11719,10496,Pennsylvania,Large City,NA,100.0,100.0,100.0,16,9,31,7,4,13,23,13,44,2.1616674752971403,21.02575342973612
University of Phoenix - New Mexico,216,217,New Mexico,Large City,private,70.79,43.47,93.34,1,0,2,0,0,1,1,0,3,0.08079782402269374,1.1459983651006567
University of Phoenix - Hawaii,661,661,Hawaii,Large City,NA,2.99,1.8,5.08,0,0,0,0,0,0,0,0,0,0.0011496554238348197,0.029220222543746597
University of Phoenix - New Jersey,111,111,New Jersey,Large City,NA,21.02,12.35,35.18,0,0,0,0,0,0,0,0,0,0.20130329996217025,0.034389236920934846
University of Phoenix - Kentucky,18,18,Kentucky,Suburb,NA,1.7,0.81,3.75,0,0,0,0,0,0,0,0,0,0.01503590849842993,0.0020890307862852816
University of Phoenix - Utah,122,122,Utah,Suburb,NA,19.68,7.25,42.64,0,0,0,0,0,0,0,0,0,0.21897200441127757,0.0
University of Pittsburgh - Bradford,1337,1229,Pennsylvania,Town,NA,77.88,59.69,92.99,1,1,2,0,0,1,1,1,3,1.0609785724256335,0.44652624988315676
University of Pittsburgh - Greensburg,1524,1436,Pennsylvania,Suburb,NA,78.91,61.13,93.54,1,1,2,0,0,1,1,1,3,1.5120471977467043,0.04330509507465288
University of Pittsburgh - Johnstown,2785,2713,Pennsylvania,Suburb,NA,94.42,82.69,99.38,2,1,4,1,1,2,3,2,6,2.7807413448122893,0.1045149033825294
University of Pittsburgh - Pittsburgh Campus,19329,18390,Pennsylvania,Large City,public,100.0,100.0,100.0,16,10,29,7,4,12,23,14,41,13.575841944482699,9.542422523986591
University of Portland,3888,3792,Oregon,Large City,private,99.73,96.81,100.0,4,2,8,2,1,4,6,3,12,0.7846091106141307,5.1293139739972595
University of Puget Sound,2415,2390,Washington,Midsize City,NA,98.85,91.96,99.98,3,2,6,1,1,3,4,3,9,0.5800852625378662,3.8807473667631136
University of Redlands,3133,2518,California,Small City,private,99.99,99.51,100.0,7,4,13,3,2,5,10,6,18,7.965661613782686,1.4974313259546548
University of Rhode Island,15100,12629,Rhode Island,Suburb,NA,100.0,99.97,100.0,10,6,17,4,2,7,14,8,24,4.103463669325871,9.810417794623694
University of Richmond,3265,3035,Virginia,Midsize City,NA,99.5,94.1,100.0,4,2,7,2,1,3,6,3,10,1.184742670765433,4.10678017901054
University of Rio Grande,1755,1269,Ohio,Rural,NA,70.15,48.55,89.39,1,0,2,0,0,1,1,0,3,1.1610109350029671,0.04757181808056485
University of Rochester,6542,6250,New York,Midsize City,private,99.99,99.61,100.0,7,4,12,3,2,5,10,6,17,3.621923559994173,5.948921291432442
University of Saint Francis - Fort Wayne,1906,1523,IndiaNA,Large City,NA,73.71,57.02,89.12,1,1,2,0,0,1,1,1,3,1.1385217785254786,0.1968430080046371
University of Saint Mary,750,641,Kansas,Town,NA,67.48,41.94,91.34,1,0,2,0,0,1,1,0,3,0.062404167916353157,1.0578618151367494
University of San Diego,5776,5605,California,Large City,NA,100.0,99.99,100.0,12,7,23,5,3,10,17,10,33,12.40734389612234,4.8036221930535845
University of San Francisco,6847,6586,California,Large City,NA,100.0,100.0,100.0,15,9,29,6,4,12,21,13,41,18.691773703862413,2.7894913138591733
University of Science and Arts of Oklahoma,881,727,Oklahoma,Town,public,57.65,31.78,85.48,1,0,1,0,0,1,1,0,2,0.718187910846492,0.14037480482906906
University of Scranton,3809,3630,Pennsylvania,Small City,private,99.71,96.64,100.0,4,2,7,2,1,3,6,3,10,1.4967739937290607,4.350171105225908
University of Sioux Falls,1214,1036,South Dakota,Midsize City,private,64.03,41.0,87.84,1,0,1,0,0,1,1,0,2,0.4605719222041426,0.5608661521900025
University of South Alabama,10986,9090,Alabama,Midsize City,public,100.0,100.0,100.0,16,8,31,6,3,12,22,11,43,13.20936531628722,8.383847412801325
University of South CaroliNA - Aiken,3352,2716,South CaroliNA,Suburb,public,100.0,99.07,100.0,7,3,15,3,1,6,10,4,21,9.772782480661004,0.5319614617953748
University of South CaroliNA - Beaufort,2078,1797,South CaroliNA,Town,NA,99.79,93.82,100.0,4,2,9,2,1,4,6,3,13,5.842354100302629,0.30395586415026776
University of South CaroliNA - Columbia,26363,25243,South CaroliNA,Midsize City,NA,100.0,100.0,100.0,45,22,90,18,8,38,63,30,128,49.14488797363466,14.520933655937124
University of South CaroliNA - Upstate,5776,4583,South CaroliNA,Suburb,public,100.0,99.97,100.0,13,6,26,5,2,11,18,8,37,17.44309259023466,0.7406712415275661
University of South Dakota,7652,4908,South Dakota,Town,public,99.69,96.05,100.0,4,2,7,2,1,3,6,3,10,4.1185608051769425,1.646172163058385
University of South Florida - Main Campus,31773,24672,Florida,Large City,NA,100.0,100.0,100.0,131,74,255,57,32,116,188,106,371,184.75871975339555,2.7787715108391207
University of South Florida - St. Petersburg,4251,2845,Florida,Large City,NA,100.0,100.0,100.0,18,10,34,8,4,16,26,14,50,25.069503188163296,0.20963049602254039
University of Southern California,19174,18631,California,Large City,private,100.0,100.0,100.0,41,23,77,17,9,33,58,32,110,42.19231087042313,15.393188314413344
University of Southern IndiaNA,9689,6588,IndiaNA,Suburb,NA,99.9,98.73,100.0,5,3,8,2,1,3,7,4,11,6.2684850460467025,0.6202883786602035
University of Southern Maine,6110,3901,Maine,Small City,NA,93.46,70.96,99.51,2,1,4,1,0,2,3,1,6,1.7228408896097644,1.0036807899016902
University of Southern Mississippi,11809,10384,Mississippi,Small City,NA,100.0,100.0,100.0,31,16,60,12,6,25,43,22,85,37.89577153170658,5.697111527191883
University of St Francis,1600,1291,Illinois,Suburb,NA,69.21,51.36,88.77,1,1,2,0,0,1,1,1,3,0.7588930464484457,0.41786187117976725
University of St Thomas Minnesota,6197,5945,Minnesota,Large City,NA,84.02,65.16,96.85,1,1,2,1,0,1,2,1,3,0.9359504076497488,0.8968806454156628
University of St. Thomas - Houston,1815,1434,Texas,Large City,NA,100.0,99.64,100.0,8,4,18,4,2,8,12,6,26,11.679747049653091,0.16342311301929108
University of the Cumberlands,3317,1828,Kentucky,Town,NA,97.11,80.16,99.97,3,1,6,1,0,2,4,1,8,1.9997758302911808,1.5412305896148897
University of the District of Columbia,3858,1830,District of Columbia,Large City,public,99.26,94.53,99.98,3,2,6,1,1,2,4,3,8,2.852259581199515,2.0497342823903795
University of the IncarNAte Word,5996,4461,Texas,Large City,NA,100.0,100.0,100.0,28,13,59,12,6,27,40,19,86,39.31613977705382,0.45937117558654333
University of the Ozarks,756,747,Arkansas,Town,NA,76.57,48.31,95.86,1,0,2,0,0,1,1,0,3,0.26564962768654027,1.1815640037141963
University of the Pacific,3552,3452,California,Large City,private,100.0,99.91,100.0,9,5,16,4,2,7,13,7,23,11.801659948530569,0.5823904473267859
University of the Southwest,509,417,New Mexico,Rural,NA,75.94,47.78,95.97,1,0,2,0,0,1,1,0,3,0.4968206626076275,0.9248215514022677
University of the West,185,148,California,Suburb,NA,49.36,32.26,72.0,0,0,1,0,0,0,0,0,1,0.6791001836635009,0.0
University of Toledo,16191,13056,Ohio,Large City,public,100.0,99.87,100.0,9,5,16,3,2,6,12,7,22,9.934011713139267,2.079389530440401
University of Tulsa,3347,3203,Oklahoma,Large City,private,99.79,94.46,100.0,4,2,9,2,1,4,6,3,13,1.479568726708516,4.655625797503408
University of Utah,24637,18066,Utah,Midsize City,NA,100.0,100.0,100.0,33,13,79,14,5,35,47,18,114,35.15398097048592,11.123696101384253
University of Vermont,11341,10395,Vermont,Small City,NA,100.0,99.86,100.0,8,5,15,3,2,6,11,7,21,0.0070490986986422016,11.508083954733008
University of Virginia - Main Campus,16658,15766,Virginia,Suburb,public,100.0,100.0,100.0,22,11,40,10,4,18,32,15,58,22.461753900838517,8.935233017882995
University of Washington - Bothell Campus,5365,4641,Washington,Suburb,NA,99.93,99.1,100.0,5,3,8,2,1,4,7,4,12,6.89831123018003,0.31998908092451656
University of Washington - Seattle Campus,31328,28759,Washington,Large City,public,100.0,100.0,100.0,33,21,56,14,9,25,47,30,81,33.97940880199285,13.478121822544326
University of Washington - Tacoma Campus,4436,3945,Washington,Midsize City,NA,99.72,97.88,99.99,4,3,6,2,1,3,6,4,9,5.7172367316795105,0.15381638471422104
University of West Alabama,2111,1843,Alabama,Rural,NA,97.13,81.19,99.92,3,1,5,1,0,2,4,1,7,2.9001259216817523,0.6462213582655844
University of West Georgia,11230,8938,Georgia,Town,public,99.99,95.42,100.0,7,2,19,2,1,8,9,3,27,8.771950940239401,0.5514983857593888
University of Wisconsin - Eau Claire,10184,9476,Wisconsin,Small City,public,85.73,72.7,95.52,1,1,2,1,0,1,2,1,3,1.367427962508271,0.5793935608572794
University of Wisconsin - Green Bay,6812,4095,Wisconsin,Midsize City,public,75.98,61.68,89.74,1,1,2,0,0,1,1,1,3,1.175113391573413,0.2510945786027445
University of Wisconsin - La Crosse,9701,9094,Wisconsin,Small City,NA,86.81,73.92,96.42,1,1,2,1,0,1,2,1,3,1.4783153364250396,0.5472821248585789
University of Wisconsin - Madison,31358,28977,Wisconsin,Large City,NA,100.0,99.99,100.0,10,6,18,4,3,8,14,9,26,3.569255966370445,10.921407534170696
University of Wisconsin - Milwaukee,20356,17076,Wisconsin,Large City,NA,98.25,93.66,99.82,3,2,5,1,1,2,4,3,7,3.520948595555219,0.5217985869886472
University of Wisconsin - Oshkosh,12410,7994,Wisconsin,Small City,NA,90.97,80.76,97.61,2,1,3,1,0,1,3,1,4,2.2131729167051435,0.19106138171007692
University of Wisconsin - Parkside,4135,3275,Wisconsin,Suburb,NA,61.78,47.61,78.78,1,0,1,0,0,0,1,0,1,0.6830735426259034,0.2782816605486419
University of Wisconsin - Platteville,7614,6723,Wisconsin,Town,NA,89.22,75.13,98.19,2,1,3,1,0,1,3,1,4,1.0788646148733796,1.1478463540470227
University of Wisconsin - River Falls,5680,5014,Wisconsin,Town,NA,68.41,52.28,85.17,1,1,1,0,0,1,1,1,2,0.49021002429541793,0.6619593699749644
University of Wisconsin - Stevens Point,7896,7224,Wisconsin,Town,NA,81.3,67.24,93.29,1,1,2,0,0,1,1,1,3,1.3275377850926677,0.3485029005195828
University of Wisconsin - Stout,8129,6605,Wisconsin,Town,public,81.5,66.66,93.7,1,1,2,0,0,1,1,1,3,0.9504109242965288,0.7366693622174839
University of Wisconsin - Superior,2373,1829,Wisconsin,Suburb,NA,43.48,29.35,63.54,0,0,1,0,0,0,0,0,1,0.24318369626301248,0.3272068998239229
University of Wisconsin - Whitewater,11128,9830,Wisconsin,Town,NA,93.1,83.29,98.69,2,1,3,1,1,1,3,2,4,1.775478859924763,0.8969364356982741
University of Wyoming,9796,8281,Wyoming,Town,NA,97.48,82.27,99.99,3,1,6,1,0,3,4,1,9,0.017312415922388844,3.6588094766008656
Upper Iowa University,4275,2107,Iowa,Rural,private,98.58,88.15,99.99,3,2,7,1,1,3,4,3,10,1.6269147403317847,2.621471184908262
Ursinus College,1507,1489,Pennsylvania,Suburb,private,88.99,71.78,98.23,2,1,3,1,0,1,3,1,4,0.8227165897503953,1.3814175308266903
Ursuline College,620,455,Ohio,Suburb,private,36.07,21.86,56.24,0,0,1,0,0,0,0,0,1,0.39182397509886613,0.05537153444501717
Utah State University,24621,17188,Utah,Small City,public,100.0,100.0,100.0,31,11,75,13,4,34,44,15,109,34.0896334408475,9.294105546357862
Utah Valley University,36870,18404,Utah,Small City,NA,100.0,100.0,100.0,48,18,117,20,7,52,68,25,169,59.088338993636626,9.11946391294661
Utica College,3686,2901,New York,Small City,NA,99.01,94.29,99.96,3,2,5,1,1,2,4,3,7,3.693158407901824,0.9207511892472692
Valdosta State University,8774,7166,Georgia,Small City,NA,99.95,92.71,100.0,6,2,16,2,1,6,8,3,22,6.849145679544523,0.8145690025002039
Valley City State University,1373,834,North Dakota,Town,NA,89.04,60.37,99.46,2,1,4,1,0,2,3,1,6,1.708544809610243,0.49949944814853897
University of Valley Forge,700,589,Pennsylvania,Suburb,NA,61.47,41.04,82.6,1,0,1,0,0,1,1,0,2,0.29222730353757853,0.6606275848504626
Valparaiso University,3228,3153,IndiaNA,Suburb,NA,92.83,78.8,99.22,2,1,3,1,0,1,3,1,4,0.8551099351861087,1.7780500400109989
Vanderbilt University,6888,6805,Tennessee,Large City,NA,100.0,99.86,100.0,9,5,18,4,2,8,13,7,26,0.9302785857564826,11.969353388380352
Vanguard University of Southern California,1842,1524,California,Midsize City,NA,99.85,97.24,100.0,5,3,9,2,1,4,7,4,13,5.539255011612015,0.9478463726943522
Vassar College,2352,2334,New York,Suburb,private,98.44,90.43,99.96,3,2,5,1,1,2,4,3,7,0.7430531548987707,3.4106702842654175
Villanova University,6948,6525,Pennsylvania,Suburb,NA,100.0,99.86,100.0,8,5,15,3,2,6,11,7,21,1.1078163980797402,10.436952169875184
Virginia Commonwealth University,23666,20036,Virginia,Midsize City,NA,100.0,100.0,100.0,30,14,54,13,6,25,43,20,79,40.08596355260185,3.063373656364046
Virginia Military Institute,1724,1722,Virginia,Town,public,95.84,78.57,99.76,2,1,4,1,0,2,3,1,6,1.9268342337723525,1.2493725658576114
Virginia Tech,27189,26603,Virginia,Small City,public,100.0,100.0,100.0,33,16,60,14,6,27,47,22,87,35.445566435553566,12.083321469643098
Virginia State University,4299,3976,Virginia,Suburb,public,99.94,97.32,100.0,5,3,9,2,1,4,7,4,13,4.965875872753071,2.3853863126644383
Virginia Union University,1298,1201,Virginia,Midsize City,NA,88.02,66.48,97.88,1,1,3,1,0,1,2,1,4,1.1103475266043383,1.0095540518714012
Virginia Wesleyan University,1438,1354,Virginia,Large City,NA,91.36,68.83,98.89,2,1,3,1,0,1,3,1,4,1.939853384000544,0.5067725989356735
Viterbo University,1770,1394,Wisconsin,Small City,NA,44.82,28.39,68.65,0,0,1,0,0,0,0,0,1,0.21628527387726165,0.37781119922847795
Voorhees College,475,464,South CaroliNA,Town,private,69.61,41.77,91.53,1,0,2,0,0,1,1,0,3,0.9850292982820905,0.2043162488117026
Wabash College,865,864,IndiaNA,Town,NA,59.38,40.66,80.91,1,0,1,0,0,0,1,0,1,0.41293175208905736,0.4869750382004513
Wagner College,1797,1736,New York,Large City,NA,94.92,82.15,99.56,2,1,4,1,0,2,3,1,6,1.0341334816938264,1.9423887583522135
Wake Forest University,5099,5046,North CaroliNA,Midsize City,NA,99.99,99.13,100.0,6,3,12,3,1,5,9,4,17,0.5903277563380482,8.35573079295757
Walden University,7443,453,Minnesota,Large City,NA,100.0,99.99,100.0,14,7,28,6,3,12,20,10,40,0.01069102230960253,19.627734876255186
Waldorf University,2124,1482,Iowa,Town,private,99.55,94.11,100.0,4,2,8,2,1,3,6,3,11,0.3016190248929713,5.07845206629601
Walla Walla University,1650,1556,Washington,Suburb,NA,93.52,80.4,99.37,2,1,3,1,0,2,3,1,5,0.9276138207249662,1.8060702714581187
Walsh University,2012,1744,Ohio,Suburb,private,77.81,56.42,93.93,1,1,2,0,0,1,1,1,3,1.3324769627703092,0.1721933103211107
Warner Pacific College,404,396,Oregon,Large City,NA,32.36,20.78,52.36,0,0,1,0,0,0,0,0,1,0.16552934823082927,0.22503758121792572
Warner University,1003,869,Florida,Rural,NA,99.68,96.09,100.0,4,2,8,2,1,4,6,3,12,5.642335856680929,0.09122324969843253
Warren Wilson College,589,579,North CaroliNA,Suburb,private,57.87,36.02,82.5,1,0,1,0,0,1,1,0,2,0.054271242126481455,0.8087115169718883
Wartburg College,1525,1474,Iowa,Town,NA,67.73,39.3,93.37,1,0,2,0,0,1,1,0,3,0.8187890195958186,0.3113380489848654
Washburn University,5877,3944,Kansas,Midsize City,NA,72.87,48.19,90.85,1,0,2,0,0,1,1,0,3,0.9710228369057193,0.3330016204783311
Washington Adventist University,875,655,Maryland,Suburb,NA,74.99,54.26,92.26,1,1,2,0,0,1,1,1,3,0.4790029338421317,0.9050944738087792
Washington & Jefferson College,1411,1398,Pennsylvania,Suburb,NA,80.15,61.18,94.7,1,1,2,0,0,1,1,1,3,1.0110861059679983,0.6041137429425434
Washington and Lee University,1824,1823,Virginia,Town,private,96.65,82.64,99.88,2,1,5,1,1,2,3,2,7,0.5096067375034986,2.8797849366606276
Washington College,1489,1456,Maryland,Town,NA,84.78,66.22,96.52,1,1,2,1,0,1,2,1,3,0.8432121362624018,1.0378695587611977
Washington State University,25279,22166,Washington,Town,NA,100.0,100.0,100.0,24,15,39,10,7,18,34,22,57,29.94494193100877,4.256950875355321
Washington University in St Louis,7673,7074,Missouri,Suburb,NA,100.0,99.95,100.0,10,5,20,4,2,9,14,7,29,0.3659523577509737,13.939018592910745
Wayland Baptist University,3563,990,Texas,Town,NA,100.0,100.0,100.0,15,7,33,7,3,15,22,10,48,21.765872635971593,0.5483386357998782
Wayne State College,2756,2404,Nebraska,Town,public,42.43,26.37,67.01,0,0,1,0,0,0,0,0,1,0.22828765730203435,0.3235679587191581
Wayne State University,17300,12389,Michigan,Large City,public,100.0,100.0,100.0,13,7,26,5,3,11,18,10,37,18.38470172044626,0.3125565262218197
Waynesburg University,1374,1330,Pennsylvania,Town,private,75.74,57.34,91.78,1,1,2,0,0,1,1,1,3,1.1668727869479618,0.24869878767323958
Webber InterNAtioNAl University,626,584,Florida,Town,NA,97.63,87.9,99.94,3,1,5,1,1,2,4,2,7,3.6915939193601703,0.03985675594090131
Weber State University,27106,11311,Utah,Small City,NA,100.0,100.0,100.0,35,13,85,14,5,38,49,18,123,44.19285813618423,4.907367630184962
Webster University,3080,2297,Missouri,Suburb,private,96.46,80.21,99.93,2,1,5,1,0,2,3,1,7,1.1611292098734165,2.1743979580199295
Wellesley College,2513,2374,Massachusetts,Suburb,private,98.95,92.03,99.98,3,2,6,1,1,3,4,3,9,0.6020263960581461,3.9437310868443722
Wells College,486,481,New York,Rural,NA,48.85,32.75,69.12,0,0,1,0,0,0,0,0,1,0.4163554041498897,0.2533464701054007
Wentworth Institute of Technology,4263,3904,Massachusetts,Large City,private,99.87,97.66,100.0,5,3,8,2,1,4,7,4,12,5.511008845227357,1.1045260035388484
Wesley College,1447,1303,Delaware,Small City,private,85.32,66.79,96.86,1,1,2,1,0,1,2,1,3,0.14875733775721758,1.7682288418576693
Wesleyan College,565,431,Georgia,Midsize City,NA,54.26,28.96,85.23,1,0,1,0,0,1,1,0,2,0.3392246723932435,0.4416638502797397
Wesleyan University,2975,2896,Connecticut,Small City,private,99.51,94.94,100.0,4,2,7,2,1,3,6,3,10,0.06892901168793722,5.241358614228262
West Chester University of Pennsylvania,14450,13020,Pennsylvania,Suburb,NA,100.0,100.0,100.0,12,7,22,5,3,9,17,10,31,12.287801738994766,5.086430718953398
West Liberty University,2174,1869,West Virginia,Rural,NA,50.15,31.38,72.16,0,0,1,0,0,0,0,0,1,0.11076360889031386,0.58501237312863
West Texas A&M University,7393,5615,Texas,Town,public,100.0,100.0,100.0,33,16,70,14,7,32,47,23,102,46.092436170292785,0.813034205536426
West Virginia State University,3754,1786,West Virginia,Suburb,NA,74.37,51.91,92.49,1,1,2,0,0,1,1,1,3,0.2254933626302158,1.133789118407082
West Virginia University,22507,20712,West Virginia,Small City,public,100.0,100.0,100.0,13,7,23,5,3,10,18,10,33,0.7408758579030499,17.48897130909127
West Virginia University Institute of Technology,1621,1111,West Virginia,Small City,public,34.68,19.7,55.76,0,0,1,0,0,0,0,0,1,0.10564367644811837,0.3195474853989879
West Virginia Wesleyan College,1322,1289,West Virginia,Town,private,51.72,33.16,73.7,1,0,1,0,0,0,1,0,1,0.060645960336428356,0.6666055069756772
Western CaroliNA University,9408,8040,North CaroliNA,Town,NA,99.77,95.06,100.0,4,2,9,2,1,4,6,3,13,4.454337797173478,1.6327068649152825
Western Connecticut State University,5082,4089,Connecticut,Small City,NA,87.99,77.39,96.27,1,1,2,1,0,1,2,1,3,1.4942134823380409,0.6240547392431331
Western Governors University,72383,72385,Utah,Suburb,NA,100.0,100.0,100.0,111,56,230,47,23,101,158,79,331,11.860385288112477,146.01488951058758
Western Illinois University,7596,6668,Illinois,Town,NA,98.48,93.36,99.94,3,2,5,1,1,2,4,3,7,3.9168500967751116,0.2682266561260164
Western InterNAtioNAl University,593,597,ArizoNA,Midsize City,NA,76.93,53.74,94.42,1,1,2,0,0,1,1,1,3,0.48147610517346934,0.9821272285577447
Western Kentucky University,17655,12919,Kentucky,Small City,NA,100.0,99.98,100.0,13,6,30,5,2,12,18,8,42,14.558769002079753,3.8551587753884635
Western Michigan University,17938,15063,Michigan,Small City,NA,100.0,100.0,100.0,13,8,26,6,3,11,19,11,37,17.166658740957487,1.8210029031823896
Western New England University,2737,2613,Massachusetts,Midsize City,private,96.91,87.07,99.79,2,1,4,1,1,2,3,2,6,2.2284845939332687,1.245877065863258
Western New Mexico University,2170,1266,New Mexico,Town,public,98.88,83.41,100.0,3,1,8,1,0,3,4,1,11,3.078912826056266,1.410994313243778
Western Oregon University,4758,4065,Oregon,Town,public,97.32,89.9,99.77,3,2,4,1,1,2,4,3,6,2.7795688154920852,0.8386274526753863
Western Colorado University,2427,1832,Colorado,Town,NA,89.05,64.36,99.39,2,1,4,1,0,2,3,1,6,0.73307783000868,1.4752562582002202
Western Washington University,14961,13728,Washington,Small City,NA,100.0,100.0,100.0,14,9,23,6,4,10,20,13,33,17.654712055572492,1.8888044293436466
Westfield State University,5585,4800,Massachusetts,Suburb,NA,100.0,99.77,100.0,7,4,13,3,2,6,10,6,19,10.307481443329964,0.1839508304568468
Westminster College Missouri,765,760,Missouri,Town,NA,51.88,29.47,79.75,1,0,1,0,0,0,1,0,1,0.3300411450744763,0.4004165002007633
Westminster College Pennsylvania,1193,1170,Pennsylvania,Town,private,69.75,50.51,88.33,1,0,2,0,0,1,1,0,3,0.8410444345715675,0.3538832310211646
Westminster College Utah,2033,1906,Utah,Midsize City,NA,97.83,79.35,99.99,3,1,6,1,0,3,4,1,9,2.067670074440916,1.757061414199082
Westmont College,1295,1294,California,Suburb,private,98.17,89.2,99.96,3,2,5,1,1,2,4,3,7,3.3367679294601205,0.6579809432173902
Wheaton College Illinois,2386,2310,Illinois,Suburb,private,96.79,84.59,99.88,2,1,5,1,1,2,3,2,7,0.2795077910510825,3.153289983075531
Wheaton College Massachusetts,1686,1675,Massachusetts,Suburb,private,90.29,73.17,98.64,2,1,3,1,0,1,3,1,4,1.2001050780437796,1.129676356483863
Wheeling Jesuit University,721,670,West Virginia,Small City,NA,38.43,23.64,59.19,0,0,1,0,0,0,0,0,1,0.016369361470118,0.4681864691187173
Boston University Wheelock College of Education and Human Development,613,593,Massachusetts,Large City,NA,61.09,41.64,81.94,1,0,1,0,0,1,1,0,2,0.7342748174873126,0.2086828489371172
Whitman College,1512,1455,Washington,Small City,NA,92.54,77.62,99.21,2,1,3,1,0,1,3,1,4,0.736865063223776,1.8553131750878897
Whittier College,1684,1640,California,Suburb,NA,99.54,95.09,100.0,4,2,7,2,1,3,6,3,10,4.625222872518979,0.7364307841704677
Whitworth University,2252,2211,Washington,Suburb,private,96.63,86.23,99.88,2,1,5,1,1,2,3,2,7,1.7219648108669092,1.6652441964746592
Wichita State University,12403,8749,Kansas,Large City,NA,95.46,78.57,99.73,2,1,4,1,0,2,3,1,6,2.0577643269224355,1.0316632164055195
Widener University,3438,2919,Pennsylvania,Suburb,private,99.35,94.44,99.99,4,2,6,1,1,3,5,3,9,1.9254419198242545,3.103066064616793
Wilberforce University,613,489,Ohio,Rural,private,51.68,33.1,75.7,1,0,1,0,0,0,1,0,1,0.13083753122809239,0.5956811899258532
Wiley College,1325,1188,Texas,Town,NA,99.89,96.1,100.0,5,2,10,2,1,4,7,3,14,5.720692432483147,1.0289666367057153
Wilkes University,2489,2233,Pennsylvania,Small City,NA,95.49,84.0,99.61,2,1,4,1,1,2,3,2,6,1.9315512014313119,1.1658740181403597
Willamette University,1950,1901,Oregon,Midsize City,private,96.74,85.96,99.85,2,1,4,1,1,2,3,2,6,0.3595297443573612,3.0596663324732436
William Carey University,3099,1676,Mississippi,Small City,private,100.0,99.73,100.0,8,4,16,3,2,7,11,6,23,10.752447511409988,1.0744726960474629
William Jewell College,922,909,Missouri,Suburb,NA,49.81,26.84,78.74,0,0,1,0,0,0,0,0,1,0.3129405676094775,0.37540875151734804
William Paterson University of New Jersey,8839,7285,New Jersey,Suburb,NA,100.0,100.0,100.0,15,8,28,6,3,11,21,11,39,21.03983285749189,0.26272498466090444
William Penn University,1284,1068,Iowa,Town,NA,84.19,58.37,98.42,1,1,3,1,0,1,2,1,4,0.4569985225651081,1.3842346141185484
William Woods University,959,794,Missouri,Town,NA,55.35,33.44,81.61,1,0,1,0,0,0,1,0,1,0.3579720882673076,0.4477764821951125
Williams Baptist College,492,447,Arkansas,Rural,NA,31.38,14.46,56.99,0,0,1,0,0,0,0,0,1,0.2184583764607876,0.15763346777941217
Williams College,2073,2047,Massachusetts,Town,private,97.84,88.49,99.93,3,2,5,1,1,2,4,3,7,0.5566276842242531,3.274049694114055
Wilmington College,1168,1098,Ohio,Town,NA,58.81,38.86,80.81,1,0,1,0,0,0,1,0,1,0.7299357005356732,0.15649418900350748
Wilmington University,8441,3035,Delaware,Suburb,private,99.03,94.64,99.96,3,2,5,1,1,2,4,3,7,2.5026850697323435,2.132928411192498
Wilson College,827,565,Pennsylvania,Small City,NA,58.9,40.92,79.25,1,0,1,0,0,0,1,0,1,0.5915821022833907,0.29700976738604346
Wingate University,2588,2537,North CaroliNA,Suburb,NA,88.2,66.18,98.7,2,1,3,1,0,1,3,1,4,1.1161444135446186,1.0188375674750403
WinoNA State University,7463,6522,Minnesota,Town,public,81.44,65.03,94.45,1,1,2,0,0,1,1,1,3,0.8935750828589606,0.7902218526794795
Winston - Salem State University,4688,4072,North CaroliNA,Midsize City,NA,95.58,78.74,99.82,2,1,4,1,0,2,3,1,6,2.1232343499860242,0.9934630397004509
Winthrop University,5014,4488,South CaroliNA,Small City,public,100.0,99.91,100.0,11,5,22,4,2,9,15,7,31,14.891705227471212,0.5450348764106658
Wisconsin Lutheran College,992,921,Wisconsin,Large City,NA,47.01,31.69,69.08,0,0,1,0,0,0,0,0,1,0.1390666735589838,0.49481770895996946
Wittenberg University,1860,1775,Ohio,Small City,NA,78.87,57.5,94.94,1,1,2,0,0,1,1,1,3,0.9268806159632229,0.6263779680392711
Wofford College,1679,1663,South CaroliNA,Small City,private,98.41,85.01,99.98,3,1,6,1,1,3,4,2,9,3.2328338609192544,0.9038760463059383
Woodbury University,1023,923,California,Large City,private,97.13,86.86,99.87,2,1,5,1,1,2,3,2,7,3.446892283567715,0.09680099809408681
Worcester Polytechnic Institute,4435,4301,Massachusetts,Midsize City,NA,99.9,97.92,100.0,5,3,9,2,1,4,7,4,13,4.107596492449187,2.813350852082673
Worcester State University,5496,4153,Massachusetts,Midsize City,NA,100.0,99.78,100.0,8,4,13,3,2,6,11,6,19,10.429860579577849,0.18009303829955825
Wright State University - Main Campus,12120,9423,Ohio,Suburb,public,99.98,99.13,100.0,6,3,11,2,1,5,8,4,16,8.099531801604329,0.5152022439886031
Xavier University,4629,4370,Ohio,Large City,private,98.76,90.88,99.98,3,2,6,1,1,2,4,3,8,1.6912472457694467,2.698082165139967
Xavier University of LouisiaNA,2289,2155,LouisiaNA,Large City,NA,99.68,93.82,100.0,4,2,9,2,1,4,6,3,13,2.408970229982421,3.3399154665673056
Yale University,5751,5743,Connecticut,Midsize City,NA,100.0,99.83,100.0,8,5,15,3,2,7,11,7,22,0.13206025603763671,11.391553220215714
Yeshiva University,2755,2646,New York,Large City,NA,99.39,94.68,99.99,4,2,7,1,1,3,5,3,10,1.4001332174952044,3.6846084596378805
York College,431,398,Nebraska,Town,NA,34.69,18.78,62.51,0,0,1,0,0,0,0,0,1,0.013023438076759297,0.4119748210814408
York College of Pennsylvania,4169,3814,Pennsylvania,Suburb,NA,99.44,95.34,99.99,4,2,6,2,1,3,6,3,9,2.0343907751501114,3.148208923503288
Youngstown State University,11272,8834,Ohio,Small City,NA,99.98,99.03,100.0,6,3,11,2,1,4,8,4,15,6.95780218699287,1.378347344387423
