school,real_size,size,state,setting,status,meanprob,lowprob,highprob,meaNActive,lowactive,highactive,meanincub,lowincub,highincub,meantot,lowtot,hightot,instate,outstate
Abilene Christian University,3669,3508,Texas,Midsize City,private,100.0,99.91,100.0,12,5,30,6,2,17,18,7,47,17.598279975381974,0.4760660919850954
Adams State University,1956,1514,Colorado,Town,NA,61.54,34.78,91.33,1,0,2,0,0,1,1,0,3,0.36005217250340515,0.5944670465749256
Adelphi University,5269,4874,New York,Suburb,private,98.27,91.19,99.94,3,2,5,1,1,2,4,3,7,3.4117655521439123,0.6439591974934138
Adrian College,1673,1606,Michigan,Town,private,66.61,46.01,89.01,1,0,1,0,0,1,1,0,2,0.9120162311404185,0.1845253696388546
Agnes Scott College,923,913,Georgia,Suburb,private,52.23,26.42,86.72,0,0,1,0,0,1,0,0,2,0.19293643372768016,0.5447937578259581
Alabama A & M University,5032,4714,Alabama,Midsize City,public,95.88,74.49,99.94,2,1,5,1,0,2,3,1,7,1.8808827969502746,1.3057466358975185
Alabama State University,4212,3866,Alabama,Midsize City,NA,96.29,77.68,99.95,2,1,5,1,0,2,3,1,7,1.5472527829053246,1.7424851354619246
Alaska Pacific University,298,203,Alaska,Large City,private,20.27,10.4,39.74,0,0,0,0,0,0,0,0,0,6.231994413444522e-05,0.22596962682291968
Albany State University,6266,3927,Georgia,Small City,NA,91.69,58.89,99.98,2,1,6,1,0,3,3,1,9,1.849774187247887,0.6363143254040959
Albertus Magnus College,1130,1012,Connecticut,Midsize City,NA,35.13,26.08,50.76,0,0,0,0,0,0,0,0,0,0.2605856917456742,0.1720318586009943
Albion College,1565,1554,Michigan,Town,NA,65.15,44.92,87.99,1,0,1,0,0,1,1,0,2,0.9375416475944243,0.11621921351571905
Albright College,2019,1993,Pennsylvania,Small City,NA,81.17,61.94,95.79,1,1,2,1,0,1,2,1,3,0.8752809294346111,0.793957555082628
Alcorn State University,3169,2893,Mississippi,Rural,NA,99.54,90.29,100.0,4,2,8,2,1,4,6,3,12,4.527444419697461,0.84139950677608
Alderson Broaddus University,950,903,West Virginia,Town,private,18.96,9.39,34.77,0,0,0,0,0,0,0,0,0,0.015117690337296897,0.1949654193511855
Alfred University,1704,1600,New York,Town,NA,73.0,54.14,90.85,1,1,2,0,0,1,1,1,3,0.9728033509545718,0.3359700453259502
Alice Lloyd College,598,584,Kentucky,Rural,private,26.67,11.54,52.75,0,0,1,0,0,0,0,0,1,0.2600028530950644,0.05012099401908075
Allegheny College,1800,1752,Pennsylvania,Town,NA,76.51,57.57,93.42,1,1,2,0,0,1,1,1,3,0.6665049044629129,0.7812163972681921
Allen University,590,563,South CaroliNA,Midsize City,private,55.52,24.72,85.36,1,0,1,0,0,1,1,0,2,0.7464901200029979,0.06298322747343715
Alma College,1427,1386,Michigan,Town,NA,63.45,43.13,87.02,1,0,1,0,0,1,1,0,2,0.9375416475944243,0.06859423608056178
Alvernia University,2252,1670,Pennsylvania,Small City,NA,82.93,65.25,96.23,1,1,2,1,0,1,2,1,3,1.1227988971845626,0.6440413552722979
Alverno College,1312,1036,Wisconsin,Large City,NA,19.08,13.91,28.25,0,0,0,0,0,0,0,0,0,0.1621217118570771,0.04955332704071259
American InterContinental University - Atlanta,1905,932,Georgia,Midsize City,private,51.48,22.43,91.56,0,0,2,0,0,1,0,0,3,0.524613673731445,0.19821997080928297
American InterNAtioNAl College,1374,1254,Massachusetts,Midsize City,private,76.07,53.04,94.06,1,1,2,0,0,1,1,1,3,0.9929458876360503,0.4359980936363661
American Jewish University,68,63,California,Large City,NA,13.29,7.45,25.3,0,0,0,0,0,0,0,0,0,0.118164134869932,0.02426957862095191
American Public University System,37910,2914,West Virginia,Town,NA,100.0,100.0,100.0,36,16,90,18,8,47,54,24,137,0.01459337737762186,53.655801444839135
American University,8124,7764,District of Columbia,Large City,NA,99.99,99.1,100.0,6,3,14,3,2,7,9,5,21,0.09910558627828182,9.204034805746288
Amherst College,1832,1836,Massachusetts,Suburb,private,92.13,73.73,99.5,2,1,3,1,0,2,3,1,5,0.2853589612061991,2.2533161496771643
Amridge University,321,147,Alabama,Midsize City,NA,38.58,21.73,65.6,0,0,1,0,0,0,0,0,1,0.09357915028090055,0.3929067013720739
Anderson University IndiaNA,1565,1431,IndiaNA,Small City,NA,56.37,41.09,77.02,1,0,1,0,0,0,1,0,1,0.5085670452171355,0.3203686237021344
Anderson University South CaroliNA,2984,2550,South CaroliNA,Small City,private,98.7,78.95,100.0,3,1,7,1,0,3,4,1,10,3.7231965902628863,0.6127940028063263
Andrews University,1704,1344,Michigan,Town,NA,88.3,67.31,98.99,1,1,3,1,0,2,2,1,5,0.30906450192958207,1.8329688082072402
Angelo State University,8721,5332,Texas,Midsize City,NA,100.0,100.0,100.0,31,12,80,16,6,44,47,18,124,47.7508533213702,0.13137531096605945
AnNA Maria College,1121,866,Massachusetts,Rural,NA,71.57,47.86,91.74,1,0,2,0,0,1,1,0,3,1.1453094958818941,0.11170066539794327
Antioch University - Seattle,90,17,Washington,Large City,NA,10.85,5.89,21.19,0,0,0,0,0,0,0,0,0,0.003048163804396513,0.11168962994444039
Appalachian State University,17014,16071,North CaroliNA,Town,public,99.82,95.6,100.0,4,2,9,2,1,4,6,3,13,3.866793065949261,2.457242910683347
AquiNAs College Michigan,1553,1317,Michigan,Midsize City,NA,64.97,44.85,87.9,1,0,1,0,0,1,1,0,2,0.9830734715394073,0.06553162268321897
Arcadia University,2387,2177,Pennsylvania,Suburb,NA,85.09,66.32,98.09,1,1,3,1,0,1,2,1,4,1.0029858519258905,0.8989665139836345
ArizoNA Christian University,784,646,ArizoNA,Large City,NA,75.47,59.39,91.64,1,1,2,0,0,1,1,1,3,1.1409446318596206,0.2630489721443889
ArizoNA State University - Tempe,42429,38814,ArizoNA,Midsize City,NA,100.0,100.0,100.0,48,30,88,24,15,44,72,45,132,49.931247689044255,22.273386586519358
Arkansas Baptist College,597,496,Arkansas,Midsize City,NA,45.34,23.52,76.03,0,0,1,0,0,0,0,0,1,0.04950168392337449,0.5533940960559396
Arkansas State University - Main Campus,9608,6894,Arkansas,Small City,public,89.04,45.97,99.77,2,0,4,1,0,2,3,0,6,1.2302244578522112,0.9791955171921953
Arkansas Tech University,10780,6729,Arkansas,Town,public,89.63,43.66,99.82,2,0,4,1,0,2,3,0,6,1.4839026525667798,0.7803967977840724
Armstrong State University,6283,4513,Georgia,Midsize City,public,89.88,53.84,99.97,2,1,6,1,0,3,3,1,9,1.865258652234057,0.42434231128445477
Asbury University,1731,1325,Kentucky,Town,NA,76.62,48.75,96.55,1,0,2,0,0,1,1,0,3,0.4578997615236963,0.993415090960322
Ashford University,31543,31545,California,Large City,private,100.0,100.0,100.0,30,14,74,15,7,39,45,21,113,3.5283810672161695,41.59696999675687
Ashland University,4812,3380,Ohio,Town,NA,82.24,59.21,97.08,1,1,2,1,0,1,2,1,3,1.3983388465466817,0.32898476988583447
Assumption College,2085,1937,Massachusetts,Midsize City,private,88.29,67.37,98.61,1,1,3,1,0,1,2,1,4,1.5946530185052303,0.5488578774675794
Point University,1925,1119,Georgia,Town,NA,58.8,27.87,94.19,1,0,2,0,0,1,1,0,3,0.5376206243198278,0.348372147748615
Auburn University,23968,21762,Alabama,Small City,public,100.0,100.0,100.0,17,8,40,8,4,20,25,12,60,7.798456269061135,17.281132147300085
Auburn University at Montgomery,4312,3239,Alabama,Midsize City,NA,93.2,66.06,99.81,2,1,4,1,0,2,3,1,6,2.347034837479978,0.33972069622360795
Augsburg University,2428,2033,Minnesota,Large City,NA,41.08,27.1,64.08,0,0,1,0,0,0,0,0,1,0.2383668161686342,0.2901209545173759
AugustaNA College,2650,2637,Illinois,Small City,NA,63.22,49.93,82.48,1,0,1,0,0,1,1,0,2,0.8148901886165226,0.18482158538825055
AugustaNA University,1746,1679,South Dakota,Midsize City,NA,38.91,22.75,62.86,0,0,1,0,0,0,0,0,1,0.2548184707779129,0.23773626085352584
Aurora University,3935,3461,Illinois,Suburb,private,82.79,69.36,95.66,1,1,2,1,0,1,2,1,3,1.2075829605446573,0.5511949995983925
Austin College,1218,1204,Texas,Small City,NA,99.8,90.89,100.0,4,2,10,2,1,6,6,3,16,6.090641661837355,0.10661803171959128
Austin Peay State University,9591,7065,Tennessee,Midsize City,NA,93.22,44.38,99.98,2,0,6,1,0,3,3,0,9,2.2261118408680853,0.4644347470838018
Ave Maria University,1071,1035,Florida,Rural,NA,94.56,77.52,99.96,2,1,5,1,0,3,3,1,8,2.24901448395515,0.655495230640707
Averett University,929,890,Virginia,Town,NA,73.07,41.36,93.81,1,0,2,0,0,1,1,0,3,0.7243530244295139,0.5859075676439196
Averett University - Non - TraditioNAl Programs,344,87,Virginia,Town,NA,39.21,13.98,65.69,0,0,1,0,0,0,0,0,1,0.4973601604865325,0.0
Avila University,1274,1077,Missouri,Large City,NA,55.04,30.85,85.43,1,0,1,0,0,1,1,0,2,0.20297686669650014,0.595237834757699
Azusa Pacific University,5674,5075,California,Suburb,private,100.0,99.85,100.0,8,4,16,4,2,8,12,6,24,10.02977176775983,1.4441268114386012
Bacone College,936,864,Oklahoma,Town,private,78.45,48.15,97.64,1,0,2,1,0,1,2,0,3,0.2691161364133783,1.2625501747161751
Baker University,1774,1062,Kansas,Town,NA,61.33,33.39,90.82,1,0,2,0,0,1,1,0,3,0.05696818735298211,0.8916638143181129
Baldwin Wallace University,3191,2958,Ohio,Suburb,NA,75.19,51.91,94.29,1,0,2,0,0,1,1,0,3,0.8378735907270288,0.5552585665769977
Ball State University,17000,15203,IndiaNA,Small City,NA,99.96,99.48,100.0,5,3,8,3,2,4,8,5,12,6.604783931796632,1.1250835175496066
Bard College,1941,1862,New York,Town,NA,87.36,68.04,98.41,1,1,3,1,0,1,2,1,4,0.4157654652687711,1.6503713597028762
BarNArd College,2549,2514,New York,Large City,NA,95.4,80.82,99.81,2,1,4,1,1,2,3,2,6,0.6609792520029935,2.4156862974531075
Barry University,3504,2991,Florida,Suburb,NA,100.0,99.81,100.0,8,4,16,4,2,8,12,6,24,10.316537394242399,1.1971884431672066
Barton College,888,830,North CaroliNA,Town,private,30.51,15.56,54.02,0,0,1,0,0,0,0,0,1,0.184133003140441,0.1796503628146131
Bates College,1788,1787,Maine,Small City,NA,79.68,55.34,97.13,1,1,2,1,0,1,2,1,3,0.031943934714617275,1.5601036309202672
Bay Path University,1946,1367,Massachusetts,Suburb,NA,84.42,62.6,97.37,1,1,2,1,0,1,2,1,3,1.5856144993720023,0.27260315027774584
Baylor University,14311,14100,Texas,Midsize City,private,100.0,100.0,100.0,44,17,111,23,9,60,67,26,171,63.64553517196037,2.5645423161453
Beacon College,349,344,Florida,Suburb,private,47.18,29.0,73.4,0,0,1,0,0,0,0,0,1,0.4619345101899582,0.17526282570801055
Becker College,1885,1530,Massachusetts,Midsize City,private,84.97,62.18,97.74,1,1,3,1,0,1,2,1,4,1.5920705844671652,0.3019184297293376
Belhaven University,2479,1248,Mississippi,Midsize City,private,98.84,87.35,100.0,3,1,7,1,1,3,4,2,10,1.3244792832340222,3.1250031598390056
Bellarmine University,2539,2410,Kentucky,Large City,NA,72.29,44.25,94.86,1,0,2,0,0,1,1,0,3,0.885799193844116,0.39712800002227994
Bellevue University,5743,4919,Nebraska,Suburb,NA,89.57,67.65,99.35,2,1,3,1,0,2,3,1,5,0.34451890169224103,1.9130437742360478
Belmont Abbey College,1552,1381,North CaroliNA,Suburb,private,66.2,41.08,90.32,1,0,2,0,0,1,1,0,3,0.22732469523511237,0.8563285760038657
Belmont University,6496,6161,Tennessee,Large City,NA,99.93,95.37,100.0,5,2,12,2,1,6,7,3,18,0.47888145397558984,6.70926805543203
Beloit College,1407,1346,Wisconsin,Small City,NA,55.95,36.61,80.97,1,0,1,0,0,1,1,0,2,0.03824610432699162,0.7805914088621206
Bemidji State University,4819,3333,Minnesota,Town,NA,56.84,38.5,88.04,1,0,1,0,0,1,1,0,2,0.5046494401581648,0.33504335575424204
Benedict College,2089,2077,South CaroliNA,Midsize City,NA,91.3,62.66,99.64,2,1,4,1,0,2,3,1,6,1.5839780025683448,0.855921948759742
Benedictine College,2080,1821,Kansas,Town,NA,74.42,47.34,97.0,1,0,2,0,0,1,1,0,3,0.02977656564086936,1.3314093830832359
Benedictine University,2883,2473,Illinois,Suburb,private,68.2,55.65,85.15,1,1,1,0,0,1,1,1,2,0.945904861182886,0.19934138811121926
Bennett College,490,400,North CaroliNA,Large City,private,27.39,15.43,46.98,0,0,0,0,0,0,0,0,0,0.04445460706819975,0.2754404862666843
Bennington College,775,724,Vermont,Town,NA,59.96,38.63,84.65,1,0,1,0,0,1,1,0,2,6.631057212804859e-06,0.9142039099858402
Bentley University,4270,4171,Massachusetts,Small City,private,98.8,90.21,99.99,3,2,6,1,1,3,4,3,9,2.4210319106860783,2.000376534762968
Berea College,1668,1615,Kentucky,Town,NA,63.72,34.65,90.9,1,0,2,0,0,1,1,0,3,0.4121097853713267,0.6010907058129765
Berry College,1976,1945,Georgia,Suburb,private,74.21,44.03,97.66,1,0,3,0,0,1,1,0,4,0.4431653879041899,0.9101766023548689
Bethany College Kansas,777,710,Kansas,Town,NA,45.0,20.53,78.83,0,0,1,0,0,1,0,0,2,0.025998570668071243,0.5703631063354035
Bethany College West Virginia,598,594,West Virginia,Rural,private,34.57,20.83,56.65,0,0,1,0,0,0,0,0,1,0.0030366458914512554,0.42069261378094647
Bethany Lutheran College,651,522,Minnesota,Small City,NA,15.65,8.76,30.75,0,0,0,0,0,0,0,0,0,0.05514796320536279,0.11480832086616766
Bethel College - Mishawaka,1330,1044,IndiaNA,Small City,NA,51.38,35.86,81.42,0,0,1,0,0,1,0,0,2,0.42731928756154813,0.29329635582850166
Bethel College - North Newton,502,489,Kansas,Town,NA,19.67,8.13,43.11,0,0,0,0,0,0,0,0,0,0.017995186580959444,0.20061907528972836
Bethel University Minnesota,2898,2407,Minnesota,Suburb,NA,48.07,29.99,87.52,0,0,1,0,0,1,0,0,2,0.24919131307877773,0.4056507524325045
Bethel University Tennessee,4830,3454,Tennessee,Town,NA,94.71,66.22,100.0,2,1,7,1,0,4,3,1,11,1.0222843333587515,1.9128320168512218
Bethune - Cookman University,3988,3755,Florida,Small City,private,100.0,99.94,100.0,9,5,20,5,2,10,14,7,30,12.588881903964719,1.2447808817533772
Biola University,4047,3882,California,Suburb,private,99.98,99.06,100.0,6,3,12,3,2,6,9,5,18,7.255277881013825,1.119378490819979
Birmingham Southern College,1287,1272,Alabama,Midsize City,NA,70.77,40.92,94.84,1,0,2,0,0,1,1,0,3,0.41965308386838635,0.8084693242904897
Black Hills State University,3951,2195,South Dakota,Town,NA,81.99,48.13,99.98,1,0,5,1,0,3,2,0,8,1.079379369862939,0.6333105733164617
Blackburn College,557,546,Illinois,Town,private,20.74,14.18,35.06,0,0,0,0,0,0,0,0,0,0.17913534318725283,0.05317146347311402
Bloomfield College,1839,1700,New Jersey,Suburb,NA,87.24,63.3,98.73,1,1,3,1,0,1,2,1,4,2.052641469199204,0.005123870170565841
Bloomsburg University of Pennsylvania,8578,7863,Pennsylvania,Small City,public,99.86,98.27,100.0,4,3,8,2,1,4,6,4,12,5.314820594468524,1.2335827088460252
Blue Mountain College,590,531,Mississippi,Rural,NA,56.0,29.06,84.83,1,0,1,0,0,1,1,0,2,0.7154389480072972,0.10479569045386052
Bluefield College,949,829,Virginia,Town,NA,70.81,34.42,93.16,1,0,2,0,0,1,1,0,3,0.983153805612913,0.24712299357320466
Bluefield State College,1380,1099,West Virginia,Town,NA,18.12,6.14,35.64,0,0,0,0,0,0,0,0,0,0.02770120136949778,0.17206601158263496
Bluffton University,735,660,Ohio,Town,NA,24.45,14.06,42.97,0,0,0,0,0,0,0,0,0,0.18671714849534912,0.09360655120730041
Boise State University,20744,12477,Idaho,Midsize City,public,100.0,99.77,100.0,15,4,52,8,2,28,23,6,80,12.823109127730532,10.116317376948924
Boston College,9924,9681,Massachusetts,Small City,private,100.0,99.76,100.0,8,4,15,4,2,8,12,6,23,3.337795994199207,7.991976789078137
Boston University,18086,16840,Massachusetts,Large City,private,100.0,100.0,100.0,15,8,30,7,4,15,22,12,45,5.206187020739343,16.881527777958343
Bowdoin College,1819,1813,Maine,Town,private,86.09,62.61,99.17,1,1,3,1,0,2,2,1,5,0.0348635416508995,1.9350574595904806
Bowie State University,5185,4389,Maryland,Suburb,NA,96.85,86.9,99.84,2,1,4,1,1,2,3,2,6,2.972996073722242,0.48432435836481513
Bowling Green State University - Main Campus,14679,13104,Ohio,Town,public,99.63,94.46,100.0,4,2,8,2,1,4,6,3,12,3.990726012462781,1.5938971904287258
Bradley University,4645,4512,Illinois,Midsize City,NA,84.1,71.96,95.73,1,1,2,1,0,1,2,1,3,1.3926894818381519,0.44547210324646
Brandeis University,3630,3620,Massachusetts,Small City,NA,98.51,89.26,99.99,3,1,6,1,1,3,4,2,9,1.1104466363680146,3.0938602253542418
BreNAu University,1737,1080,Georgia,Small City,NA,46.51,18.57,89.13,0,0,2,0,0,1,0,0,3,0.49829008325495566,0.12732002096179104
Brescia University,1177,715,Kentucky,Small City,NA,44.61,22.57,75.65,0,0,1,0,0,0,0,0,1,0.4926369848117009,0.09804380474091948
Brevard College,673,656,North CaroliNA,Town,NA,47.41,25.83,76.61,0,0,1,0,0,0,0,0,1,0.09118246108875062,0.5505015929444251
Brewton - Parker College,782,438,Georgia,Rural,NA,54.4,31.86,86.34,1,0,1,0,0,1,1,0,2,0.19448488022629717,0.589318831077906
Briar Cliff University,943,720,Iowa,Small City,NA,52.26,28.78,83.58,0,0,1,0,0,1,0,0,2,0.13338235431495926,0.6048165192541108
Bridgewater College,1880,1876,Virginia,Suburb,private,91.08,55.1,99.41,2,1,3,1,0,2,3,1,5,2.1672758156084657,0.24804464219656153
Bridgewater State University,9562,7858,Massachusetts,Suburb,NA,100.0,99.8,100.0,8,4,16,4,2,8,12,6,24,11.933427689899059,0.23444204810065622
Brigham Young University - Hawaii,3138,2702,Hawaii,Town,private,98.76,84.87,100.0,3,1,8,1,1,4,4,2,12,2.8172993536602986e-05,4.384256847037162
Brigham Young University - Idaho,51883,17230,Idaho,Town,NA,100.0,100.0,100.0,49,20,155,25,10,85,74,30,240,9.038618280404592,65.1405334396882
Brigham Young University - Provo,31232,28156,Utah,Midsize City,NA,100.0,100.0,100.0,30,12,88,15,6,47,45,18,135,10.047754485348845,35.24825339812958
Brown University,6986,6666,Rhode Island,Midsize City,NA,99.99,99.22,100.0,6,3,13,3,2,6,9,5,19,0.0967944454454798,9.050840355398352
Bryan College - Dayton,1238,833,Tennessee,Town,NA,57.65,28.74,89.0,1,0,1,0,0,1,1,0,2,0.18326047444660123,0.6747259870255395
Bryant University,3476,3418,Rhode Island,Suburb,private,95.61,81.24,99.79,2,1,4,1,1,2,3,2,6,0.0837827331069071,3.039232804093074
Bryn Athyn College of the New Church,329,313,Pennsylvania,Suburb,private,22.27,14.16,37.01,0,0,0,0,0,0,0,0,0,0.16357709173040275,0.08826152075883634
Bryn Mawr College,1340,1325,Pennsylvania,Suburb,NA,83.47,60.42,97.7,1,1,2,1,0,1,2,1,3,0.134879356339104,1.6625755526663983
Bucknell University,3608,3585,Pennsylvania,Town,private,97.08,85.39,99.94,2,1,5,1,1,2,3,2,7,0.6227408579911824,2.909092406221725
BueNA Vista University,1805,1522,Iowa,Town,private,52.14,27.26,86.19,0,0,1,0,0,1,0,0,2,0.44973793826710623,0.2865708852650436
Butler University,4288,4182,IndiaNA,Large City,NA,89.25,75.11,98.3,1,1,3,1,0,1,2,1,4,0.9978102994242933,1.2312330600521975
Cabrini University,1687,1479,Pennsylvania,Suburb,private,74.6,54.61,92.63,1,1,2,0,0,1,1,1,3,0.6492862632281337,0.7206875979357198
Caldwell University,1605,1440,New Jersey,Suburb,NA,82.31,57.69,97.34,1,1,2,1,0,1,2,1,3,1.5820577262605218,0.14895341317819802
California Baptist University,7421,6367,California,Large City,NA,100.0,99.99,100.0,11,6,23,6,3,12,17,9,35,16.19557632527288,0.8540715022625054
California Institute of Technology,962,961,California,Midsize City,NA,80.66,57.43,97.06,1,1,2,1,0,1,2,1,3,0.7609770285623622,0.8797784465779128
California Lutheran University,2968,2858,California,Midsize City,private,99.87,97.54,100.0,4,2,9,2,1,4,6,3,13,5.816038718298054,0.8193666620476695
California State University Maritime Academy,1050,1007,California,Midsize City,NA,88.39,71.03,98.5,1,1,3,1,0,1,2,1,4,2.074962208316006,0.07596085740725991
California Polytechnic State University - San Luis Obispo,21348,20584,California,Suburb,NA,100.0,100.0,100.0,32,18,65,16,9,33,48,27,98,45.124519824129635,2.9847009124953874
California State Polytechnic University - PomoNA,24318,21668,California,Suburb,NA,100.0,100.0,100.0,38,22,75,19,11,38,57,33,113,57.07091385947976,0.37414241229709805
California State University - Bakersfield,8816,7502,California,Large City,NA,100.0,100.0,100.0,14,8,27,7,4,14,21,12,41,20.605461838618744,0.23368248300175687
California State University - Channel Islands,7054,5858,California,Suburb,NA,100.0,99.99,100.0,11,6,22,6,3,11,17,9,33,16.670596147450006,0.0
California State University - Chico,16709,15446,California,Small City,NA,100.0,100.0,100.0,26,15,51,13,7,26,39,22,77,38.73892997575851,0.36001399831612185
California State University - Dominguez Hills,13279,10084,California,Small City,NA,100.0,100.0,100.0,21,12,41,10,6,20,31,18,61,31.22841756342563,0.08597172886712058
California State University - East Bay,13473,11539,California,Midsize City,NA,100.0,100.0,100.0,21,12,41,10,6,21,31,18,62,31.33003871941377,0.15937343273928375
California State University - Fresno,22260,19432,California,Large City,NA,100.0,100.0,100.0,35,20,69,17,10,34,52,30,103,52.19782493744376,0.31771716488532165
California State University - Fullerton,35161,28475,California,Suburb,public,100.0,100.0,100.0,55,32,108,27,16,54,82,48,162,82.75507021480819,0.23240822001188657
California State University - Long Beach,31564,27507,California,Large City,public,100.0,100.0,100.0,50,28,97,25,14,48,75,42,145,73.76277955120635,0.38945323322261777
California State University - Los Angeles,24820,21004,California,Large City,public,100.0,100.0,100.0,39,23,77,19,11,38,58,34,115,58.32581697179844,0.29857677748653444
California State University - Monterey Bay,6762,6109,California,Suburb,NA,100.0,99.99,100.0,11,6,21,5,3,11,16,9,32,15.67565413184518,0.2128995264084988
California State University - Northridge,35836,29739,California,Large City,NA,100.0,100.0,100.0,56,32,110,28,16,55,84,48,165,84.14468044087859,0.24288698897438446
California State University - Sacramento,28449,23491,California,Large City,public,100.0,100.0,100.0,45,26,88,22,13,44,67,39,132,66.67529474170783,0.3839518812295384
California State University - San BerNArdino,18324,16381,California,Midsize City,public,100.0,100.0,100.0,29,17,56,14,8,28,43,25,84,43.11572953134079,0.08662926499323803
California State University - San Marcos,14616,11634,California,Suburb,NA,100.0,100.0,100.0,23,13,45,11,7,23,34,20,68,34.39994294333461,0.1506694802899336
California State University - Stanislaus,9058,7621,California,Suburb,NA,100.0,100.0,100.0,14,8,28,7,4,14,21,12,42,21.32153649593053,0.059962145098366906
California University of Pennsylvania,5553,4534,Pennsylvania,Suburb,public,98.29,92.36,99.95,3,2,5,1,1,3,4,3,8,3.71779161994275,0.3487696455341517
Calumet College of Saint Joseph,624,427,IndiaNA,Suburb,private,22.78,16.82,33.15,0,0,0,0,0,0,0,0,0,0.20553486801521537,0.052878894586183854
Calvin College,3737,3524,Michigan,Midsize City,NA,94.37,79.94,99.77,2,1,4,1,1,2,3,2,6,1.468056384165515,1.4072674023303076
Cambridge College,750,221,Massachusetts,Large City,private,61.9,38.8,85.46,1,0,1,0,0,1,1,0,2,0.963247896198301,0.0010960491766379566
Cameron University,4149,2814,Oklahoma,Small City,NA,94.33,69.13,99.92,2,1,5,1,0,2,3,1,7,1.9015894336292105,0.9657454874068853
Campbell University,4382,3634,North CaroliNA,Town,NA,87.44,62.26,98.93,1,1,3,1,0,2,2,1,5,0.9340519144216062,1.1383133064994062
Campbellsville University,3704,2128,Kentucky,Town,private,88.69,60.92,99.45,1,1,4,1,0,2,2,1,6,1.6673867178242183,0.5108485208898593
Canisius College,2397,2303,New York,Large City,private,83.55,66.54,96.06,1,1,2,1,0,1,2,1,3,1.6506181763751389,0.15318597983084348
Capella University,9208,1382,Minnesota,Large City,NA,99.99,98.66,100.0,6,3,14,3,1,7,9,4,21,0.034410505966982564,9.269407601299482
Capital University,2703,2493,Ohio,Suburb,NA,63.28,40.03,87.42,1,0,1,0,0,1,1,0,2,0.7628729209952836,0.2384623835332339
CardiNAl Stritch University,1542,901,Wisconsin,Suburb,NA,24.27,17.24,37.06,0,0,0,0,0,0,0,0,0,0.17439179310873992,0.10351976366543522
Carleton College,2068,2055,Minnesota,Town,NA,85.15,61.94,99.36,1,1,3,1,0,2,2,1,5,0.05127393273225879,1.8532149120127466
Carlos Albizu University - Miami,376,291,Florida,Suburb,NA,82.77,61.89,97.47,1,1,2,1,0,1,2,1,3,1.7544179376911542,0.0
Carlow University,1365,1075,Pennsylvania,Large City,NA,62.12,46.25,81.96,1,0,1,0,0,1,1,0,2,0.9032612214411274,0.06720054483346505
Carnegie Mellon University,6530,6298,Pennsylvania,Large City,NA,99.98,98.69,100.0,6,3,12,3,1,6,9,4,18,0.9226321928302541,7.4038408417093216
Carroll College,1360,1287,MontaNA,Town,NA,98.72,27.34,100.0,3,0,35,2,0,23,5,0,58,3.6384157752544004,0.7055323397830768
Carroll University,2983,2737,Wisconsin,Small City,NA,44.64,35.03,59.72,0,0,1,0,0,0,0,0,1,0.2850835899322515,0.3061027142395494
Carson - Newman University,1688,1608,Tennessee,Suburb,NA,62.97,31.04,92.38,1,0,2,0,0,1,1,0,3,0.2934130220055356,0.6989156769572754
Carthage College,2740,2596,Wisconsin,Suburb,NA,55.9,44.07,74.0,1,0,1,0,0,0,1,0,1,0.11264978851260671,0.7058729933459338
Case Western Reserve University,5147,4978,Ohio,Large City,private,98.38,88.02,99.99,3,1,6,1,1,3,4,2,9,0.6533531145669191,3.464568620939863
Castleton University,1857,1590,Vermont,Town,NA,42.12,25.85,65.32,0,0,1,0,0,0,0,0,1,0.00044386639218212527,0.5460190187986224
Catawba College,1322,1268,North CaroliNA,Suburb,NA,47.08,26.33,74.65,0,0,1,0,0,0,0,0,1,0.28415586904389045,0.3517181279722132
Catholic University of America,3308,3194,District of Columbia,Large City,NA,96.7,82.95,99.9,2,1,5,1,1,2,3,2,7,0.015948025378114315,3.3908636570574555
Cazenovia College,897,713,New York,Town,NA,51.63,33.57,81.3,0,0,1,0,0,1,0,0,2,0.5036032396213284,0.2221785478971659
Cedar Crest College,1432,931,Pennsylvania,Midsize City,NA,65.13,47.69,85.24,1,0,1,0,0,1,1,0,2,0.7117038377042084,0.3414943852040836
Cedarville University,3536,3109,Ohio,Town,private,87.86,66.54,98.76,1,1,3,1,0,1,2,1,4,0.38410384833328964,1.72288900602279
CenteNAry University,1366,1125,New Jersey,Suburb,private,78.44,53.36,96.04,1,1,2,0,0,1,1,1,3,1.2705761059344418,0.26269514742071864
CenteNAry College of LouisiaNA,536,524,LouisiaNA,Midsize City,NA,68.47,37.33,94.51,1,0,2,0,0,1,1,0,3,0.35730597620157256,0.7945537507700353
Central Baptist College,745,599,Arkansas,Small City,private,33.06,13.22,64.75,0,0,1,0,0,0,0,0,1,0.09096831190556356,0.3096773563912684
Central Christian College of Kansas,869,730,Kansas,Town,NA,74.82,43.21,96.88,1,0,2,0,0,1,1,0,3,0.015211400811529255,1.3605149428957322
Central College,1232,1198,Iowa,Town,NA,45.41,23.13,79.97,0,0,1,0,0,1,0,0,2,0.3409800185949087,0.2637966011509212
Central Connecticut State University,9550,7605,Connecticut,Suburb,NA,94.85,89.46,98.79,2,1,3,1,1,1,3,2,4,2.495429962910468,0.4696261484696994
Central Methodist University - College of Liberal Arts & Sciences,1058,1034,Missouri,Town,NA,34.69,18.25,63.59,0,0,1,0,0,0,0,0,1,0.23446492477590947,0.1910770544537892
Central Michigan University,17801,15585,Michigan,Town,NA,100.0,99.9,100.0,8,5,17,4,2,8,12,7,25,11.76721698529661,0.437470916123632
Central Penn College,1197,316,Pennsylvania,Suburb,NA,58.39,42.32,79.07,1,0,1,0,0,1,1,0,2,0.7002247435476889,0.17624081234819367
Central State University,1788,1710,Ohio,Rural,public,56.96,37.56,81.63,1,0,1,0,0,1,1,0,2,0.2871364552491503,0.5554228374575519
Central Washington University,12080,10446,Washington,Town,NA,100.0,99.91,100.0,8,5,16,4,2,8,12,7,24,11.827891615659937,0.5231143150938748
Centre College,1447,1449,Kentucky,Town,NA,62.0,33.46,92.75,1,0,2,0,0,1,1,0,3,0.41632035789108485,0.5504929999311102
Chadron State College,2151,1616,Nebraska,Town,NA,36.2,21.66,72.21,0,0,1,0,0,0,0,0,1,0.10346883955093114,0.34559969427818504
ChamiNAde University of Honolulu,1813,1524,Hawaii,Large City,NA,74.37,50.71,94.59,1,0,2,0,0,1,1,0,3,7.420107908081929e-05,1.3591116135587182
Champlain College,3933,2603,Vermont,Small City,NA,93.18,75.36,99.69,2,1,4,1,0,2,3,1,6,0.00027684663863460285,2.6830740996827
Chapman University,7023,6515,California,Midsize City,NA,100.0,99.96,100.0,10,5,19,5,3,10,15,8,29,11.168874027905973,3.06785386239254
Charleston Southern University,3062,2804,South CaroliNA,Midsize City,private,99.04,82.52,100.0,3,1,7,1,1,4,4,2,11,3.6429951724113243,1.003323384811993
Chatham University,1207,951,Pennsylvania,Large City,NA,64.78,44.85,86.76,1,0,1,0,0,1,1,0,2,0.5710849342868447,0.4715898841193324
Chestnut Hill College,1363,1118,Pennsylvania,Large City,NA,69.65,49.93,89.74,1,0,2,0,0,1,1,0,3,0.5431046422803284,0.6485995884455193
Cheyney University of Pennsylvania,718,671,Pennsylvania,Suburb,public,41.49,28.03,62.17,0,0,1,0,0,0,0,0,1,0.36876589977818863,0.16706236899474394
Chicago State University,2032,1297,Illinois,Large City,NA,53.59,42.51,71.39,1,0,1,0,0,0,1,0,1,0.6863342364468471,0.08107958999062387
Chowan University,1500,1440,North CaroliNA,Town,private,76.43,43.56,95.37,1,0,2,0,0,1,1,0,3,0.1672099424951604,1.2766170607306355
Christian Brothers University,1789,1426,Tennessee,Large City,NA,57.31,23.39,90.88,1,0,2,0,0,1,1,0,3,0.3684835778029385,0.4818331155109313
Christopher Newport University,4951,4867,Virginia,Midsize City,NA,99.91,88.48,100.0,5,1,10,2,1,5,7,2,15,6.806894289449404,0.1764798063385897
Citadel Military College of South CaroliNA,2837,2559,South CaroliNA,Midsize City,NA,98.62,82.54,100.0,3,1,7,1,1,3,4,2,10,2.3181294429018715,1.9610350635892007
City University of Seattle,929,235,Washington,Large City,NA,61.15,41.27,80.69,1,0,1,0,0,1,1,0,2,0.8646624658471441,0.08034780732692905
Claflin University,2040,1955,South CaroliNA,Town,private,93.86,64.56,99.85,2,1,4,1,0,2,3,1,6,2.2626053843892517,0.5252711549202476
Claremont McKenNA College,1341,1337,California,Suburb,NA,90.55,71.48,99.63,2,1,4,1,0,2,3,1,6,1.47705168587415,0.8792103270829217
Clarion University of Pennsylvania,4319,3483,Pennsylvania,Town,public,95.72,86.42,99.7,2,1,4,1,1,2,3,2,6,2.9128201422168205,0.23770398281234056
Clark Atlanta University,3305,3187,Georgia,Large City,NA,98.5,86.24,99.99,3,1,6,1,1,3,4,2,9,0.2663327977621267,3.9246680026778913
Clark University,2240,2199,Massachusetts,Midsize City,private,88.2,67.21,98.68,1,1,3,1,0,1,2,1,4,1.1052817682918843,1.0302415003680239
Clarke University,765,708,Iowa,Small City,NA,32.28,17.42,70.46,0,0,1,0,0,0,0,0,1,0.12449019736062863,0.2648982019428007
Clarkson University,3086,3021,New York,Town,private,88.92,72.22,98.31,1,1,3,1,0,1,2,1,4,1.5942556044989147,0.6048103703855334
Clayton State University,6553,3743,Georgia,Suburb,NA,90.07,54.69,99.98,2,1,6,1,0,3,3,1,9,1.9668367425433333,0.34230690211008824
Clemson University,19409,18642,South CaroliNA,Suburb,public,100.0,99.99,100.0,18,7,40,8,3,20,26,10,60,18.08696206048586,7.798936043625497
Cleveland State University,12077,9268,Ohio,Large City,NA,98.32,87.86,99.98,3,1,6,1,1,3,4,2,9,3.6486727488326456,0.4344136350974432
Coastal CaroliNA University,9899,9021,South CaroliNA,Small City,NA,100.0,98.99,100.0,8,3,17,4,1,8,12,4,25,7.202704257053719,4.213732074090339
Coe College,1393,1369,Iowa,Midsize City,private,49.08,27.38,81.27,0,0,1,0,0,1,0,0,2,0.2506904249047824,0.4235236408655037
Cogswell College,606,436,California,Large City,NA,72.86,52.77,92.21,1,1,2,0,0,1,1,1,3,1.2619929604108737,0.04059321498318932
Coker College,1025,909,South CaroliNA,Town,private,82.91,49.34,98.36,1,0,3,1,0,1,2,0,4,1.2677993360381492,0.4966914738089462
Colby College,1923,1917,Maine,Town,NA,80.64,57.58,96.25,1,1,2,1,0,1,2,1,3,0.03623747432679702,1.6043532711452881
Colby - Sawyer College,983,920,New Hampshire,Rural,NA,44.93,24.56,70.45,0,0,1,0,0,0,0,0,1,0.05966986958919852,0.5364662921352515
Colgate University,2882,2854,New York,Town,private,94.03,78.69,99.63,2,1,4,1,1,2,3,2,6,0.5914410139738857,2.2250995412245937
College of Charleston,9901,9083,South CaroliNA,Midsize City,public,100.0,99.29,100.0,8,3,19,4,2,9,12,5,28,7.6654047446588836,4.867671187253495
College of Mount Saint Vincent,1693,1613,New York,Large City,NA,72.49,54.08,90.24,1,1,2,0,0,1,1,1,3,1.1060239753892838,0.18398250275842867
Mount St. Joseph University,1315,1000,Ohio,Suburb,NA,42.72,25.37,68.26,0,0,1,0,0,0,0,0,1,0.3326389536219665,0.22429593867574396
Notre Dame of Maryland University,817,528,Maryland,Large City,NA,45.62,29.34,68.79,0,0,1,0,0,0,0,0,1,0.4394581532554493,0.16924464582690593
College of Our Lady of the Elms,1174,973,Massachusetts,Suburb,private,71.47,48.12,91.56,1,0,2,0,0,1,1,0,3,1.142727061843829,0.1106456618477917
College of Saint Benedict,1940,1916,Minnesota,Suburb,NA,33.78,21.27,56.07,0,0,1,0,0,0,0,0,1,0.18333279503600977,0.2286070798925119
College of Saint Elizabeth,757,587,New Jersey,Suburb,NA,57.06,33.75,83.34,1,0,1,0,0,1,1,0,2,0.8403281123905038,0.004543880462020894
College of Saint Mary,833,761,Nebraska,Large City,NA,16.41,9.41,32.76,0,0,0,0,0,0,0,0,0,0.051653584744566404,0.12742924251128723
Northeast Catholic College,69,70,New Hampshire,Rural,NA,3.78,1.68,7.72,0,0,0,0,0,0,0,0,0,0.005188684312104218,0.0332925707907949
College of the Atlantic,352,330,Maine,Town,private,23.72,13.13,42.16,0,0,0,0,0,0,0,0,0,0.014082809927949552,0.2564710089518669
College of the Holy Cross,2852,2827,Massachusetts,Midsize City,private,94.32,77.98,99.67,2,1,4,1,1,2,3,2,6,1.3996792486313114,1.4658585433606512
College of the Ozarks,1510,1477,Missouri,Town,private,31.1,16.53,57.73,0,0,1,0,0,0,0,0,1,0.3010742784054292,0.07130447505339259
College of William and Mary,6287,6199,Virginia,Suburb,NA,99.98,95.59,100.0,6,2,12,3,1,6,9,3,18,5.830969555936586,2.6257522713997927
Colorado Christian University,6541,1840,Colorado,Midsize City,NA,99.84,93.67,100.0,4,2,12,2,1,6,6,3,18,0.7150429087160277,5.687495519042352
Colorado College,2106,2091,Colorado,Large City,private,86.41,62.69,98.83,1,1,3,1,0,1,2,1,4,0.10007839938593051,1.8928748713606485
Colorado School of Mines,4790,4584,Colorado,Suburb,public,99.19,86.2,100.0,3,1,9,2,1,5,5,2,14,0.7290768911586524,4.074414062603059
Colorado State University - Fort Collins,25523,22154,Colorado,Midsize City,public,100.0,99.55,100.0,8,4,23,4,2,12,12,6,35,4.797551407804159,7.291282677247768
Colorado State University - Pueblo,4627,3292,Colorado,Midsize City,NA,85.35,59.23,99.13,1,1,3,1,0,2,2,1,5,0.9338349956494068,0.985530229117675
Colorado Technical University - Colorado Springs,22305,14445,Colorado,Large City,NA,99.56,91.55,100.0,4,2,9,2,1,5,6,3,14,4.9935670314290155,0.42122681374318627
Columbia College Chicago,7029,6436,Illinois,Large City,NA,98.65,91.72,99.98,3,2,6,1,1,3,4,3,9,1.3333289465466898,2.9657646138826816
Columbia College Missouri,12747,5163,Missouri,Midsize City,private,100.0,99.78,100.0,8,4,18,4,2,9,12,6,27,1.7192479711357493,10.497324521049759
Columbia College South CaroliNA,1383,804,South CaroliNA,Midsize City,NA,87.15,51.94,99.2,1,1,3,1,0,2,2,1,5,1.8261245910817139,0.224085211368577
Columbia InterNAtioNAl University,497,454,South CaroliNA,Midsize City,NA,52.44,25.54,82.08,1,0,1,0,0,1,1,0,2,0.4457348030596413,0.29659538445066386
Columbia Southern University,15049,8567,Alabama,Town,private,100.0,100.0,100.0,16,7,42,8,4,23,24,11,65,0.5266006841894155,23.835889736171364
Columbia University in the City of New York,8157,7592,New York,Large City,NA,100.0,99.72,100.0,8,4,16,4,2,8,12,6,24,1.4654268687818306,9.804148909452508
Columbus State University,6798,4693,Georgia,Midsize City,NA,91.66,58.96,99.98,2,1,6,1,0,3,3,1,9,1.9033504361000357,0.5802856065749478
Concord University,1853,1696,West Virginia,Town,public,45.56,19.51,72.87,0,0,1,0,0,0,0,0,1,0.031065542860745938,0.5765236001021026
Concordia College at Moorhead,2032,1997,Minnesota,Suburb,NA,73.17,24.91,100.0,1,0,7,0,0,4,1,0,11,0.16077226463381591,1.1526681246457264
Concordia College - New York,1131,1024,New York,Suburb,NA,60.91,42.3,82.67,1,0,1,0,0,1,1,0,2,0.6668351036264973,0.27174206686245683
Concordia University - Ann Arbor,906,780,Michigan,Midsize City,NA,49.44,31.42,75.34,0,0,1,0,0,0,0,0,1,0.5180969664042772,0.16348388704475575
Concordia University - Chicago,1458,1299,Illinois,Suburb,private,60.36,42.43,88.64,1,0,1,0,0,1,1,0,2,0.34984078787157613,0.5743596951474443
Concordia University - Irvine,1851,1645,California,Large City,private,98.21,89.18,99.97,3,1,5,1,1,3,4,2,8,3.5094748056369807,0.5073944481959566
Concordia University - Portland,1378,1124,Oregon,Large City,NA,70.05,45.24,96.61,1,0,2,0,0,1,1,0,3,0.3904703828063161,0.8142498460394716
Concordia University - Saint Paul,2867,1417,Minnesota,Large City,NA,51.21,33.56,76.17,0,0,1,0,0,0,0,0,1,0.22902356620408929,0.4880346936663298
Concordia University - Nebraska,1682,1231,Nebraska,Town,NA,62.62,36.22,90.52,1,0,2,0,0,1,1,0,3,0.0645871896884328,0.9175751575352946
Concordia University - Texas,1725,1347,Texas,Large City,NA,99.99,96.98,100.0,6,2,15,3,1,8,9,3,23,8.902135299157159,0.1615827220297356
Concordia University - Wisconsin,3713,2616,Wisconsin,Suburb,NA,78.22,58.77,95.25,1,1,2,1,0,1,2,1,3,0.336252439407271,1.1859143992899432
Connecticut College,1815,1766,Connecticut,Small City,private,82.73,60.49,97.11,1,1,2,1,0,1,2,1,3,0.0857658480719201,1.6685606782344595
Converse College,920,860,South CaroliNA,Small City,NA,74.41,39.8,96.02,1,0,2,0,0,1,1,0,3,1.0225680776074124,0.3389184756684637
Cooper Union for the Advancement of Science and Art,864,859,New York,Large City,NA,67.45,45.07,90.04,1,0,2,0,0,1,1,0,3,0.3162159876692062,0.8046972016870648
Coppin State University,2509,1854,Maryland,Large City,NA,83.21,64.16,96.66,1,1,2,1,0,1,2,1,3,1.3430412394173183,0.44053954854605765
Corban University,1021,936,Oregon,Midsize City,private,66.33,39.67,97.79,1,0,2,0,0,1,1,0,3,0.23045002698781256,0.8569078508474699
Cornell College,1006,1002,Iowa,Town,private,62.81,36.86,92.42,1,0,2,0,0,1,1,0,3,0.0475388391019983,0.9399465901745777
Cornell University,14907,14898,New York,Small City,NA,100.0,99.99,100.0,12,6,25,6,3,13,18,9,38,3.9204926619358065,14.138048524349115
Cornerstone University,1757,1260,Michigan,Midsize City,NA,68.85,48.15,90.65,1,0,2,0,0,1,1,0,3,0.9389213998351813,0.2267925173638499
CoveNAnt College,1033,983,Georgia,Rural,private,67.06,40.83,94.31,1,0,2,0,0,1,1,0,3,0.0789707714294678,1.0299267067405842
Creighton University,4256,4011,Nebraska,Large City,NA,87.21,63.47,99.34,1,1,3,1,0,2,2,1,5,0.09522366639921631,1.9583566950516493
Crown College,1055,698,Minnesota,Rural,NA,40.64,14.92,98.9,0,0,3,0,0,2,0,0,5,0.07793637775303336,0.4427210683140005
Culver - Stockton College,1092,969,Missouri,Rural,NA,41.07,24.7,68.33,0,0,1,0,0,0,0,0,1,0.13636751306698042,0.3917512452699486
Cumberland University,1974,1578,Tennessee,Town,NA,44.58,13.77,84.19,0,0,1,0,0,1,0,0,2,0.4153413430228861,0.17462499424623898
CUNY BerNArd M Baruch College,15253,11598,New York,Large City,NA,100.0,99.9,100.0,8,5,13,4,2,7,12,7,20,11.060971735345776,0.15910212261260206
CUNY Brooklyn College,14691,10786,New York,Large City,NA,100.0,99.87,100.0,7,4,13,4,2,6,11,6,19,10.459282981030757,0.48516173347354036
CUNY City College,13211,10225,New York,Large City,public,99.99,99.74,100.0,7,4,12,3,2,6,10,6,18,9.59700882946982,0.11968905865453423
College of Staten Island CUNY,12509,9710,New York,Large City,public,99.99,99.64,100.0,6,4,11,3,2,5,9,6,16,9.152696087536468,0.005602187415936692
CUNY Graduate School and University Center,2066,418,New York,Large City,NA,77.97,60.46,93.12,1,1,2,0,0,1,1,1,3,1.5122736817698612,0.0
CUNY Hunter College,16846,12612,New York,Large City,NA,100.0,99.95,100.0,8,5,15,4,3,7,12,8,22,11.975948551518247,0.6270482666171335
CUNY John Jay College of CrimiNAl Justice,12916,10276,New York,Large City,public,99.99,99.7,100.0,6,4,11,3,2,6,9,6,17,9.439632817088155,0.022408749663746768
CUNY Lehman College,11978,7216,New York,Large City,NA,99.98,99.54,100.0,6,4,10,3,2,5,9,6,15,8.753766195685271,0.02128831218055943
CUNY Queens College,16680,12149,New York,Large City,NA,100.0,99.94,100.0,8,5,14,4,2,7,12,7,21,12.209450635005462,0.0
CUNY York College,8393,5056,New York,Large City,NA,99.79,97.69,100.0,4,3,7,2,1,4,6,4,11,6.143520334508444,0.0
Curry College,2561,2059,Massachusetts,Suburb,private,93.02,75.12,99.48,2,1,3,1,0,2,3,1,5,2.1343817324608465,0.5253069351379887
Daemen College,1799,1560,New York,Suburb,NA,75.35,56.61,94.19,1,1,2,0,0,1,1,1,3,1.2494923401651272,0.1502134792426249
Dakota State University,2963,1397,South Dakota,Town,public,73.98,48.86,96.46,1,0,2,0,0,1,1,0,3,0.8227613336134306,0.5226085059458477
Dakota Wesleyan University,793,668,South Dakota,Town,NA,37.94,20.86,63.38,0,0,1,0,0,0,0,0,1,0.21162889945962257,0.2648577464953168
Dallas Baptist University,3159,2423,Texas,Large City,NA,100.0,99.82,100.0,11,4,27,6,2,15,17,6,42,16.056133960456062,0.21806217085322954
Dartmouth College,4415,4360,New Hampshire,Town,NA,99.64,94.28,100.0,4,2,8,2,1,4,6,3,12,0.02294994984199943,5.588610400218177
Davenport University,5597,2621,Michigan,Suburb,NA,97.8,88.43,99.95,3,1,5,1,1,3,4,2,8,3.7653438650260247,0.04782289286956936
Davidson College,1812,1810,North CaroliNA,Suburb,private,87.1,62.74,98.91,1,1,3,1,0,2,2,1,5,0.10002286590344944,1.9448132775595823
Davis & Elkins College,839,785,West Virginia,Town,NA,32.86,14.21,69.08,0,0,1,0,0,0,0,0,1,0.012430586418962332,0.3855296373466552
Defiance College,583,525,Ohio,Town,NA,31.0,18.16,53.29,0,0,1,0,0,0,0,0,1,0.12928985744551905,0.24141025907161237
Delaware State University,4054,3571,Delaware,Small City,NA,92.89,78.62,99.23,2,1,3,1,1,2,3,2,5,0.4069594314722892,2.236042490444797
Delaware Valley University,1991,1756,Pennsylvania,Suburb,private,81.68,61.91,96.19,1,1,2,1,0,1,2,1,3,0.7698167518715884,0.9263788402381463
Delta State University,3034,2198,Mississippi,Town,NA,99.42,89.15,100.0,4,2,8,2,1,4,6,3,12,4.309143817613183,0.8375437260299836
Denison University,2344,2319,Ohio,Suburb,NA,80.59,58.5,97.34,1,1,2,1,0,1,2,1,3,0.2039767168436587,1.4339923834724009
DePaul University,14822,12886,Illinois,Large City,NA,99.96,99.15,100.0,5,3,10,3,2,5,8,5,15,3.6554147383328237,4.05785499653606
DePauw University,2156,2140,IndiaNA,Town,NA,72.96,54.2,91.85,1,1,2,0,0,1,1,1,3,0.39306347622567894,0.9137612230965895
DeSales University,2350,1811,Pennsylvania,Suburb,private,85.66,68.29,97.37,1,1,2,1,0,1,2,1,3,1.0819046242519619,0.8592169881499148
Dickinson College,2386,2346,Pennsylvania,Small City,private,89.55,70.17,99.16,2,1,3,1,0,2,3,1,5,0.3544170320825393,1.9018135796742637
Dickinson State University,1426,922,North Dakota,Town,public,93.03,35.13,100.0,2,0,13,1,0,8,3,0,21,1.1054393378274459,1.5531839197322357
DigiPen Institute of Technology,1024,964,Washington,Small City,NA,67.67,43.76,90.35,1,0,2,0,0,1,1,0,3,0.48973831790637307,0.6381826439633924
Dillard University,1292,1200,LouisiaNA,Large City,NA,85.1,57.1,98.91,1,1,3,1,0,2,2,1,5,0.8554925944483366,1.0459867540307506
Doane University,1066,1062,Nebraska,Town,NA,25.17,13.97,47.43,0,0,0,0,0,0,0,0,0,0.07258985774745012,0.21688528345680463
Dominican College of Blauvelt,1420,1271,New York,Suburb,private,70.63,50.29,90.43,1,0,2,0,0,1,1,0,3,0.7934678949847674,0.43093715900031776
Dominican University,2171,2014,Illinois,Suburb,NA,54.64,43.77,72.08,1,0,1,0,0,0,1,0,1,0.7000328215141076,0.09041671553885264
Dominican University of California,1304,1135,California,Small City,private,94.55,80.77,99.77,2,1,4,1,1,2,3,2,6,2.7414079289824227,0.16547723329856648
Dordt College,1445,1341,Iowa,Town,NA,75.22,44.38,99.82,1,0,4,0,0,2,1,0,6,0.18263122360048267,1.2105688337462506
Drake University,3100,2955,Iowa,Midsize City,NA,66.74,43.82,91.97,1,0,2,0,0,1,1,0,3,0.3225116926128374,0.7776970702846464
Drew University,1534,1507,New Jersey,Suburb,private,82.59,58.21,97.49,1,1,2,1,0,1,2,1,3,1.0834630462421562,0.6633774014817563
Drexel University,15528,13572,Pennsylvania,Large City,private,100.0,99.98,100.0,10,6,20,5,3,10,15,9,30,4.933858157149033,10.258094124675841
Drury University,3277,2478,Missouri,Midsize City,NA,66.22,40.21,92.34,1,0,2,0,0,1,1,0,3,0.7174432925477726,0.3670129385529357
Duke University,6699,6669,North CaroliNA,Large City,NA,100.0,99.32,100.0,7,3,14,3,2,7,10,5,21,0.2270721122404067,9.783927310932896
Duquesne University,5941,5826,Pennsylvania,Large City,NA,98.74,93.03,99.97,3,2,5,1,1,3,4,3,8,3.113704289955912,1.2613445194154476
D'Youville College,1734,1295,New York,Large City,private,71.8,53.87,89.44,1,1,2,0,0,1,1,1,3,1.2085013788006005,0.056936881298625425
Earlham College,1061,1051,IndiaNA,Town,private,56.84,36.05,86.74,1,0,1,0,0,1,1,0,2,0.11242932951259643,0.7269136871486824
East CaroliNA University,23267,19999,North CaroliNA,Small City,public,99.98,98.32,100.0,6,3,12,3,1,6,9,4,18,5.075907861605353,3.3936561606838627
East Central University,3082,2551,Oklahoma,Town,NA,89.19,59.73,99.6,1,1,4,1,0,2,2,1,6,1.4349568668206922,0.7873466411874765
East Stroudsburg University of Pennsylvania,6051,5552,Pennsylvania,Small City,public,99.27,94.59,99.99,3,2,6,2,1,3,5,3,9,2.9831295939255025,1.9336833199622834
East Tennessee State University,11319,9641,Tennessee,Small City,NA,97.73,60.32,100.0,3,1,8,1,0,3,4,1,11,2.427526632729745,1.3551157200075656
East Texas Baptist University,1421,1216,Texas,Town,NA,99.94,94.3,100.0,5,2,12,3,1,7,8,3,19,7.293181514631568,0.10444308614280756
Eastern Connecticut State University,5069,4210,Connecticut,Town,public,80.41,70.51,91.23,1,1,2,1,0,1,2,1,3,1.2878577825495992,0.34199391210643576
Eastern Illinois University,5569,4319,Illinois,Town,NA,87.49,77.99,96.59,1,1,2,1,1,1,2,2,3,1.9135869601650066,0.16452952690803663
Eastern Kentucky University,14138,10744,Kentucky,Town,NA,99.94,95.72,100.0,5,2,12,2,1,6,7,3,18,6.3863858693431395,0.9814611023973777
Eastern Mennonite University,1102,942,Virginia,Small City,NA,71.5,39.09,92.64,1,0,2,0,0,1,1,0,3,0.8429098068710711,0.4112049060436054
Eastern Michigan University,17218,12410,Michigan,Suburb,NA,100.0,99.85,100.0,8,4,16,4,2,8,12,6,24,10.315717628020181,1.3237845945837154
Eastern Nazarene College,694,571,Massachusetts,Suburb,private,52.21,31.85,77.18,0,0,1,0,0,0,0,0,1,0.46742056088979217,0.2703154121777875
Eastern New Mexico University - Main Campus,4600,2590,New Mexico,Town,NA,99.83,89.0,100.0,4,1,13,2,1,6,6,2,19,2.503660810707082,3.8565712739912894
Eastern Oregon University,2736,1668,Oregon,Town,public,87.88,58.73,99.97,1,1,5,1,0,3,2,1,8,1.0248552885592832,1.0832154658771276
Eastern University,1882,1462,Pennsylvania,Suburb,NA,79.46,58.82,95.47,1,1,2,1,0,1,2,1,3,0.6751142250803025,0.9067638426191927
Eastern Washington University,11474,10060,Washington,Town,NA,100.0,99.87,100.0,8,4,15,4,2,8,12,6,23,10.899217709920464,1.0199389749906214
Eckerd College,2036,1915,Florida,Large City,private,95.54,80.43,99.9,2,1,5,1,1,2,3,2,7,1.7264219067705509,1.3787104761390918
Edgewood College,1566,1361,Wisconsin,Large City,NA,21.59,16.4,30.17,0,0,0,0,0,0,0,0,0,0.1884893332702249,0.05474688453171999
Edinboro University of Pennsylvania,4294,3888,Pennsylvania,Town,public,95.36,85.67,99.57,2,1,4,1,1,2,3,2,6,2.6488009766168723,0.4206527480965611
Edward Waters College,3443,853,Florida,Large City,private,100.0,99.93,100.0,9,5,19,5,2,10,14,7,29,12.812850151329547,0.6863841471198803
Elizabeth City State University,1365,1179,North CaroliNA,Town,NA,36.78,20.09,61.14,0,0,1,0,0,0,0,0,1,0.3091615855197528,0.14919667168899606
Elizabethtown College,1674,1636,Pennsylvania,Suburb,private,72.56,53.84,90.89,1,1,2,0,0,1,1,1,3,0.7317922524781175,0.560943353561555
Elmhurst College,2874,2732,Illinois,Suburb,private,75.4,60.6,91.88,1,1,2,0,0,1,1,1,3,0.8651183338631445,0.5362285416611682
Elmira College,936,833,New York,Small City,NA,50.08,32.65,73.14,0,0,1,0,0,0,0,0,1,0.3381754312573455,0.35623995407009185
Elon University,6049,5885,North CaroliNA,Suburb,NA,99.52,93.11,100.0,4,2,7,2,1,4,6,3,11,0.38695714788910235,4.955237685734156
Embry Riddle AeroNAutical University - DaytoNA Beach,5733,5378,Florida,Small City,NA,100.0,99.8,100.0,8,4,17,4,2,9,12,6,26,7.6755784773988,4.17636386141707
Embry Riddle AeroNAutical University - Prescott,2607,2471,ArizoNA,Rural,NA,98.66,89.43,100.0,3,1,7,1,1,4,4,2,11,0.7916400445672136,3.513143999599917
Emerson College,3814,3748,Massachusetts,Large City,NA,99.2,91.76,100.0,3,2,7,2,1,4,5,3,11,0.9038519133228026,3.919978026148159
Emmanuel College Georgia,954,822,Georgia,Town,NA,49.77,24.94,84.49,0,0,1,0,0,1,0,0,2,0.21306623820970136,0.4747153470500084
Emmanuel College Massachusetts,1947,1804,Massachusetts,Large City,NA,87.13,65.18,98.36,1,1,3,1,0,1,2,1,4,1.6243510099429794,0.4244758098013951
Emory and Henry College,999,966,Virginia,Rural,NA,66.27,30.76,90.99,1,0,2,0,0,1,1,0,3,0.8125477040506722,0.2732863970534112
Emory University,6938,6794,Georgia,Large City,NA,99.99,99.1,100.0,6,3,15,3,2,8,9,5,23,0.5710670686899554,9.144630375363485
Emporia State University,3605,3340,Kansas,Town,NA,58.69,27.79,89.64,1,0,1,0,0,1,1,0,2,0.1632988616531817,0.7189143718021629
Endicott College,3348,2946,Massachusetts,Suburb,NA,94.03,77.05,99.61,2,1,4,1,0,2,3,1,6,2.033666804976306,0.7830044061697267
Erskine College,573,568,South CaroliNA,Rural,NA,55.71,25.34,85.41,1,0,1,0,0,1,1,0,2,0.6770850468622233,0.13649258885534338
Eureka College,615,593,Illinois,Town,private,19.47,14.87,28.97,0,0,0,0,0,0,0,0,0,0.21074746257323862,0.005799811078014665
Evangel University,1632,1461,Missouri,Midsize City,NA,78.04,49.78,97.97,1,0,3,1,0,1,2,0,4,0.13539864974146013,1.3776616883372514
Everglades University,2101,2099,Florida,Small City,NA,99.96,98.67,100.0,5,3,11,3,1,6,8,4,17,7.3069640702775205,0.6279459843936007
Fairfield University,4118,3879,Connecticut,Suburb,private,96.56,84.64,99.85,2,1,4,1,1,2,3,2,6,0.3140180891067746,3.052960425207247
Fairleigh Dickinson University - Florham Campus,2747,2640,New Jersey,Suburb,NA,95.11,77.78,99.82,2,1,4,1,0,2,3,1,6,2.5041777749237015,0.5119938094897943
Fairleigh Dickinson University - Metropolitan Campus,5471,2374,New Jersey,Suburb,NA,99.76,95.03,100.0,4,2,9,2,1,4,6,3,13,5.26605617098049,0.7788114093944919
Fairmont State University,3661,3108,West Virginia,Town,public,33.84,16.41,60.24,0,0,1,0,0,0,0,0,1,0.07399366643413958,0.33865793327997074
Farmingdale State College,9552,7407,New York,Suburb,NA,99.91,98.61,100.0,5,3,8,2,1,4,7,4,12,6.9596796545342885,0.020705020147363196
Faulkner University,2673,1744,Alabama,Midsize City,NA,91.8,64.5,99.75,2,1,4,1,0,2,3,1,6,1.2182726645265067,1.279898054284048
Fayetteville State University,5394,3905,North CaroliNA,Midsize City,NA,79.44,55.02,96.34,1,1,2,1,0,1,2,1,3,1.286657775030736,0.2948136975752822
Felician University,1626,1430,New Jersey,Suburb,NA,83.89,59.34,97.87,1,1,3,1,0,1,2,1,4,1.708667161860691,0.1160186216597208
Ferris State University,12513,8469,Michigan,Town,public,99.98,99.22,100.0,6,3,12,3,2,6,9,5,18,8.148126857790835,0.4044536888227824
Ferrum College,1137,1118,Virginia,Rural,NA,77.09,38.21,95.74,1,0,2,0,0,1,1,0,3,1.3142453077972618,0.15806666211459103
Finlandia University,399,336,Michigan,Town,NA,29.94,16.64,59.89,0,0,1,0,0,0,0,0,1,0.21869073015999446,0.13682848992779237
Fisk University,663,639,Tennessee,Large City,NA,47.26,24.68,78.85,0,0,1,0,0,1,0,0,2,0.05887886729208072,0.5798483513688083
Fitchburg State University,4119,3386,Massachusetts,Suburb,public,99.32,92.1,100.0,3,2,7,2,1,3,5,3,10,4.89371250213346,0.09787455506232465
Five Towns College,626,591,New York,Suburb,NA,37.36,24.48,57.04,0,0,1,0,0,0,0,0,1,0.40258979911588755,0.06495305637575088
Flagler College - St Augustine,2681,2591,Florida,Suburb,NA,99.97,98.8,100.0,5,3,11,3,1,6,8,4,17,7.190313941441672,0.9630073104326322
Florida Agricultural and Mechanical University,8027,6875,Florida,Midsize City,NA,100.0,100.0,100.0,21,11,44,11,6,22,32,17,66,30.319701487013617,1.3480617627937586
Florida Atlantic University,25033,16325,Florida,Small City,public,100.0,100.0,100.0,72,40,150,37,20,77,109,60,227,107.19213638983747,1.6401768357772912
Florida Gulf Coast University,13857,10973,Florida,Suburb,NA,100.0,100.0,100.0,40,22,83,20,11,42,60,33,125,59.3002594949917,0.91637890750495
Florida Institute of Technology,3634,3269,Florida,Small City,private,99.99,99.47,100.0,6,3,14,3,2,7,9,5,21,7.8575526783827225,1.914066192573288
Florida InterNAtioNAl University,47621,26655,Florida,Suburb,public,100.0,100.0,100.0,143,79,298,72,39,152,215,118,450,213.53039383659652,1.8499154775854585
Florida Memorial University,1173,1129,Florida,Suburb,private,99.13,92.59,100.0,3,2,7,2,1,3,5,3,10,4.619345101899582,0.11861557479678479
Florida Southern College,2615,2356,Florida,Midsize City,NA,99.97,98.84,100.0,5,3,11,3,1,6,8,4,17,7.4562762351874055,0.7105736561687738
Florida State University,33009,29286,Florida,Midsize City,NA,100.0,100.0,100.0,95,52,199,48,26,102,143,78,301,141.31463207689973,2.4893173737639995
Fontbonne University,892,765,Missouri,Suburb,NA,29.11,15.85,54.83,0,0,1,0,0,0,0,0,1,0.1809352260409136,0.1627764901325945
Fordham University,9595,9132,New York,Large City,NA,99.99,99.51,100.0,7,4,13,3,2,7,10,6,20,3.0142996231985903,6.717634420424007
Fort Hays State University,12499,5889,Kansas,Town,NA,92.38,66.17,99.78,2,1,4,1,0,2,3,1,6,0.4865162736680942,2.0849929095724327
Fort Lewis College,3303,2921,Colorado,Town,public,85.88,60.53,99.34,1,1,3,1,0,2,2,1,5,0.49118938549186586,1.4645858518175077
Fort Valley State University,2345,2115,Georgia,Town,NA,62.42,30.28,96.21,1,0,2,0,0,1,1,0,3,0.6695482660019976,0.3084536159582752
Framingham State University,4128,3558,Massachusetts,Small City,public,99.44,92.92,100.0,3,2,7,2,1,4,5,3,11,5.120966697483193,0.06741104188963624
Francis Marion University,3462,3006,South CaroliNA,Suburb,public,99.48,83.17,100.0,4,1,8,2,1,4,6,2,12,5.108213383161011,0.1374126653657679
Franciscan University of Steubenville,2201,2011,Ohio,Small City,NA,89.58,67.53,99.24,2,1,3,1,0,2,3,1,5,0.12081697843816708,2.137974305044332
Franklin and Marshall College,2281,2263,Pennsylvania,Small City,NA,86.6,67.56,97.98,1,1,3,1,0,1,2,1,4,0.4570114361064322,1.5516038033418424
Franklin College,1017,962,IndiaNA,Suburb,private,39.42,28.33,57.11,0,0,1,0,0,0,0,0,1,0.4154615067145165,0.08544171691169813
Franklin Pierce University,1712,1563,New Hampshire,Rural,NA,73.99,49.09,93.22,1,0,2,0,0,1,1,0,3,0.06825115518229395,1.2776588762713728
Welch College,344,222,Tennessee,Rural,private,14.15,6.09,31.65,0,0,0,0,0,0,0,0,0,0.037289949284984455,0.11519719428664595
Freed - Hardeman University,1469,1261,Tennessee,Town,NA,58.97,28.5,89.92,1,0,2,0,0,1,1,0,3,0.21490786561609462,0.6748731996394298
Fresno Pacific University,2803,2342,California,Large City,private,99.86,97.67,100.0,4,3,9,2,1,4,6,4,13,6.48248443896447,0.0738150632567142
Friends University,1149,906,Kansas,Large City,NA,48.35,23.8,80.55,0,0,1,0,0,1,0,0,2,0.044689703691388236,0.6144780899717828
Frostburg State University,4726,3849,Maryland,Suburb,public,95.55,84.27,99.67,2,1,4,1,1,2,3,2,6,2.858100810611142,0.25238949398605687
Full Sail University,16908,16908,Florida,Suburb,NA,100.0,100.0,100.0,23,12,51,12,6,26,35,18,77,19.55056159288813,15.097820973815256
Furman University,2732,2658,South CaroliNA,Suburb,NA,97.31,78.77,99.98,2,1,6,1,1,3,3,2,9,1.179886243393168,2.4290714311895814
Gallaudet University,1125,1074,District of Columbia,Large City,NA,79.78,54.55,97.02,1,1,2,1,0,1,2,1,3,0.0136697360383837,1.58206913360793
Gannon University,3074,2530,Pennsylvania,Small City,private,88.5,74.34,97.89,1,1,3,1,0,1,2,1,4,1.6077906252975112,0.5539541720571972
Gardner - Webb University,2218,1781,North CaroliNA,Town,NA,78.59,52.1,96.64,1,0,2,1,0,1,2,0,3,0.3816529050002831,1.1579708308025127
Geneva College,1412,1247,Pennsylvania,Suburb,NA,67.52,49.52,87.42,1,0,1,0,0,1,1,0,2,0.708116620780296,0.4157698624983542
George Fox University,2700,2494,Oregon,Town,private,90.3,71.12,99.7,2,1,4,1,0,2,3,1,6,0.8135662750513563,1.517392556415033
George Mason University,25006,20221,Virginia,Suburb,NA,100.0,100.0,100.0,23,8,48,12,4,25,35,12,73,28.492664775314232,5.7293150754619155
George Washington University,11996,10893,District of Columbia,Large City,NA,100.0,99.94,100.0,9,5,20,5,2,10,14,7,30,0.07803140988577362,14.108717356397076
Georgetown College,1059,976,Kentucky,Town,private,44.19,22.02,75.4,0,0,1,0,0,0,0,0,1,0.4710578006479405,0.11180220443903288
Georgetown University,7465,6987,District of Columbia,Large City,private,99.99,99.15,100.0,6,3,13,3,2,7,9,5,20,0.0632225291775246,9.152792815280632
Georgia College & State University,5987,5442,Georgia,Town,NA,84.5,44.16,99.92,1,0,5,1,0,2,2,0,7,1.8494644979481636,0.014476196288697177
Georgia Gwinnett College,12290,8289,Georgia,Suburb,public,98.08,71.77,100.0,3,1,10,1,0,5,4,1,15,3.7661315739363057,0.18506151602599125
Georgia Institute of Technology - Main Campus,15576,13974,Georgia,Large City,NA,100.0,99.58,100.0,8,4,22,4,2,11,12,6,33,3.3390700296177327,9.102488447646637
Georgia Southern University,17763,15755,Georgia,Town,NA,99.87,90.34,100.0,5,2,16,2,1,8,7,3,24,5.290112617875172,1.3848056715757382
Georgia Southwestern State University,2604,1779,Georgia,Town,public,57.15,24.01,95.85,1,0,2,0,0,1,1,0,3,0.7918755393927418,0.05539392313272129
Georgia State University,25771,19882,Georgia,Large City,NA,99.99,94.72,100.0,6,2,22,3,1,10,9,3,32,7.694850030227398,1.1466328376550392
Georgian Court University,1612,1343,New Jersey,Small City,private,82.33,57.64,97.36,1,1,2,1,0,1,2,1,3,1.608948225857018,0.12315119529181859
Gettysburg College,2411,2404,Pennsylvania,Small City,NA,85.29,65.71,97.5,1,1,2,1,0,1,2,1,3,0.4763824074955589,1.4394220045372785
Glenville State College,1655,1037,West Virginia,Town,NA,19.96,8.29,38.01,0,0,0,0,0,0,0,0,0,0.032136015153415805,0.19036312619909257
Goddard College,189,173,Vermont,Rural,NA,17.06,9.1,30.99,0,0,0,0,0,0,0,0,0,0.0,0.18688193241669515
Gonzaga University,5194,5106,Washington,Midsize City,private,99.88,96.15,100.0,4,2,15,2,1,9,6,3,24,2.496446155800744,4.260822307246657
Gordon College,1593,1528,Massachusetts,Suburb,NA,77.58,53.72,95.21,1,1,2,0,0,1,1,1,3,0.6636855477827436,0.8300828813339305
Goshen College,888,816,IndiaNA,Small City,private,39.89,26.44,61.29,0,0,1,0,0,0,0,0,1,0.2301287838460958,0.27847196098383464
Goucher College,1534,1447,Maryland,Small City,NA,79.78,57.18,96.16,1,1,2,1,0,1,2,1,3,0.18500084738227923,1.4117356779295835
Grace Bible College,873,822,Michigan,Small City,NA,50.03,31.43,76.26,0,0,1,0,0,0,0,0,1,0.4849829126261076,0.2082133272620764
Grace College and Theological SemiNAry,1761,1439,IndiaNA,Town,private,61.49,45.0,81.99,1,0,1,0,0,1,1,0,2,0.412826444304065,0.540928493221737
Graceland University - Lamoni,1405,1061,Iowa,Rural,private,89.25,63.14,99.48,1,1,3,1,0,2,2,1,5,0.12312217321380854,2.1028750057335452
Grambling State University,4075,3734,LouisiaNA,Town,NA,99.92,95.32,100.0,5,2,11,2,1,6,7,3,17,2.2683825117711263,4.794758678404659
Grand Canyon University,49564,15998,ArizoNA,Large City,NA,100.0,100.0,100.0,56,29,125,28,15,65,84,44,190,26.822730645302865,57.457181915534136
Grand Valley State University,21935,19373,Michigan,Suburb,NA,100.0,99.98,100.0,10,6,20,5,3,10,15,9,30,14.44531608460607,0.530462938299463
Grand View University,1787,1574,Iowa,Midsize City,NA,79.62,46.63,98.62,1,0,3,1,0,1,2,0,4,0.49727677736910453,1.0902672258580084
Granite State College,1758,807,New Hampshire,Town,NA,29.18,0.0,59.59,0,0,1,0,0,0,0,0,1,0.3450475067549305,1.2018791198208808e-05
Grantham University,7817,3296,Kansas,Suburb,NA,100.0,99.49,100.0,8,4,20,4,2,11,12,6,31,0.01033977571502642,12.355708002540274
Greensboro College,944,772,North CaroliNA,Large City,NA,60.49,36.94,86.06,1,0,1,0,0,1,1,0,2,0.13184832323636517,0.7952696954215194
Greenville University,988,887,Illinois,Town,NA,38.66,25.62,61.74,0,0,1,0,0,0,0,0,1,0.21777237799234658,0.27056963753898994
Grinnell College,1717,1662,Iowa,Town,private,81.48,57.44,98.26,1,1,3,1,0,1,2,1,4,0.09883974460775186,1.5852126440526395
Grove City College,2376,2315,Pennsylvania,Town,NA,83.45,62.73,97.72,1,1,2,1,0,1,2,1,3,0.7332271392476825,1.0645075435487976
Guilford College,1669,1429,North CaroliNA,Large City,NA,69.64,43.54,91.92,1,0,2,0,0,1,1,0,3,0.20459222571160113,0.9863382356680315
Gustavus Adolphus College,2184,2150,Minnesota,Town,private,44.93,25.69,85.32,0,0,1,0,0,1,0,0,2,0.20612120958368035,0.38970103735057643
Gwynedd Mercy University,2081,1934,Pennsylvania,Suburb,private,79.49,62.19,94.38,1,1,2,1,0,1,2,1,3,1.226110744593238,0.3576222084628815
Hamilton College,1894,1886,New York,Suburb,private,86.14,66.01,98.08,1,1,3,1,0,1,2,1,4,0.43772490885691046,1.5361960522486733
Hamline University,2166,2082,Minnesota,Large City,NA,46.26,29.5,71.85,0,0,1,0,0,0,0,0,1,0.19620824925544364,0.4241955923708337
Hampden - Sydney College,1044,1039,Virginia,Rural,NA,72.85,35.24,94.3,1,0,2,0,0,1,1,0,3,1.0308656814735397,0.27170667163283385
Hampshire College,1264,1268,Massachusetts,Suburb,private,75.33,51.11,95.75,1,0,2,0,0,1,1,0,3,0.2905238292823294,1.1075354668933424
Hampton University,3796,3651,Virginia,Midsize City,NA,98.76,86.66,99.99,3,1,6,1,1,3,4,2,9,1.3590655548178503,3.0298398406883846
Hannibal - LaGrange University,913,706,Missouri,Town,NA,31.53,18.6,55.58,0,0,1,0,0,0,0,0,1,0.14484506716528292,0.2335773206634029
Hanover College,1096,1081,IndiaNA,Town,NA,47.18,30.85,71.2,0,0,1,0,0,0,0,0,1,0.2920527504917056,0.34562381546419424
Hardin - Simmons University,1741,1585,Texas,Midsize City,NA,99.99,97.29,100.0,6,2,16,3,1,8,9,3,24,9.21947220475563,0.09084278720821252
Harding University,4187,3945,Arkansas,Town,NA,99.8,91.85,100.0,4,2,10,2,1,5,6,3,15,0.15654010771130888,6.035473353796389
Harris - Stowe State University,1441,1163,Missouri,Large City,NA,31.05,18.09,55.75,0,0,1,0,0,0,0,0,1,0.3088251850095915,0.06286319650433222
Harrisburg University of Science and Technology,509,463,Pennsylvania,Small City,NA,30.57,20.8,47.38,0,0,0,0,0,0,0,0,0,0.32141463638254575,0.04336716622079976
Hartwick College,1198,1180,New York,Town,private,59.41,41.34,80.71,1,0,1,0,0,1,1,0,2,0.6719589737970632,0.2293727283229961
Harvard University,9964,7147,Massachusetts,Midsize City,NA,100.0,99.91,100.0,9,5,21,5,2,11,14,7,32,1.9174572732633741,12.072457635199626
Harvey Mudd College,867,844,California,Suburb,NA,75.29,52.61,94.46,1,0,2,0,0,1,1,0,3,0.8649614672479022,0.5312980588870154
Hastings College,1156,1073,Nebraska,Town,NA,25.95,15.12,47.65,0,0,0,0,0,0,0,0,0,0.06426384956483613,0.23582422297397285
Haverford College,1293,1294,Pennsylvania,Suburb,private,72.01,50.2,92.0,1,0,2,0,0,1,1,0,3,0.12627003572171439,1.1459583460958986
Hawaii Pacific University,3565,2411,Hawaii,Large City,NA,91.43,71.14,99.67,2,1,4,1,0,2,3,1,6,0.000136328018074523,2.4531300319531453
Heidelberg University,1049,1031,Ohio,Town,NA,51.52,30.74,79.16,0,0,1,0,0,1,0,0,2,0.25763828389022125,0.4652864768298196
Henderson State University,2838,2565,Arkansas,Town,public,86.53,50.79,99.49,1,0,3,1,0,2,2,0,5,0.3525380794195105,1.6475696980788612
Hendrix College,1240,1228,Arkansas,Small City,NA,82.17,49.58,98.73,1,0,3,1,0,1,2,0,4,0.0856594356587089,1.634543846110386
Heritage University,812,734,Washington,Rural,private,56.2,37.98,75.31,1,0,1,0,0,0,1,0,1,0.8250363363899895,0.0
Herzing University - Atlanta,593,365,Georgia,Large City,NA,16.78,5.56,50.87,0,0,0,0,0,0,0,0,0,0.18364575473597805,0.0
High Point University,4467,4418,North CaroliNA,Midsize City,NA,96.68,82.79,99.9,2,1,5,1,1,2,3,2,7,0.26723280839860986,3.136671247624603
Hilbert College,744,680,New York,Suburb,private,41.77,28.18,61.71,0,0,1,0,0,0,0,0,1,0.5270266461153437,0.013602857023073869
Hiram College,1209,853,Ohio,Town,NA,47.23,28.39,73.86,0,0,1,0,0,0,0,0,1,0.32353845394740327,0.3149784154173486
Hobart and William Smith Colleges,2239,2220,New York,Town,private,84.6,64.96,97.19,1,1,2,1,0,1,2,1,3,0.6836706770440708,1.186247108118534
Hodges University,1076,573,Florida,Suburb,NA,99.15,92.63,100.0,3,2,7,2,1,3,5,3,10,4.68933517920109,0.06366386448802377
Hofstra University,6863,6494,New York,Suburb,NA,99.8,96.96,100.0,4,2,8,2,1,4,6,3,12,2.7119912831352058,3.4811295463597802
Hollins University,647,632,Virginia,Suburb,NA,63.36,30.92,94.07,1,0,2,0,0,1,1,0,3,0.46121479998605774,0.5413808168943971
Holy Cross College,555,526,IndiaNA,Suburb,NA,29.17,19.32,46.7,0,0,0,0,0,0,0,0,0,0.13219229759098253,0.212451378208745
Holy Family University,2095,1630,Pennsylvania,Large City,private,79.63,62.27,94.47,1,1,2,1,0,1,2,1,3,1.2160665372062835,0.37432350581182633
Holy Names University,591,543,California,Large City,private,71.58,51.11,91.82,1,0,2,0,0,1,1,0,3,1.2265437199498943,0.030047687625533743
Hood College,1132,1048,Maryland,Small City,NA,58.99,38.43,86.86,1,0,1,0,0,1,1,0,2,0.5303357624958671,0.3604393935174567
Hope College,3150,3019,Michigan,Small City,private,88.5,70.67,98.7,1,1,3,1,0,1,2,1,4,1.4701260125266504,0.6912663165922082
Hope InterNAtioNAl University,866,579,California,Suburb,NA,83.49,64.2,97.2,1,1,2,1,0,1,2,1,3,1.6802939978504332,0.11851503103232898
Houghton College,1036,971,New York,Rural,private,58.03,38.35,81.71,1,0,1,0,0,1,1,0,2,0.4450447233862902,0.4225534751384929
Houston Baptist University,2320,2098,Texas,Large City,NA,100.0,99.25,100.0,8,3,21,4,2,12,12,5,33,12.587697255406088,0.0774578264255199
Howard Payne University,980,860,Texas,Town,private,99.5,87.04,100.0,3,1,9,2,1,5,5,2,14,5.238842599441455,0.04032611351356001
Howard University,6354,6090,District of Columbia,Large City,NA,99.98,98.26,100.0,6,3,12,3,1,6,9,4,18,0.039300491110353136,8.29926625443164
Humboldt State University,7860,7270,California,Town,NA,100.0,99.99,100.0,12,7,24,6,3,12,18,10,36,16.533525751000887,0.7033240977268052
Humphreys University - Stockton and Modesto Campuses,324,208,California,Large City,NA,53.54,35.68,77.72,1,0,1,0,0,0,1,0,1,0.7657035939571594,0.0
Huntingdon College,1101,878,Alabama,Midsize City,private,72.13,45.58,94.18,1,0,2,0,0,1,1,0,3,0.4899827558186284,0.7857718925533747
Huntington University,1075,859,IndiaNA,Town,NA,43.54,30.1,64.13,0,0,1,0,0,0,0,0,1,0.30742394788600585,0.2639729788900026
Huston - Tillotson University,1052,1003,Texas,Large City,NA,99.68,89.07,100.0,4,1,10,2,1,5,6,2,15,5.678660415972671,0.03631530574549503
Idaho State University,10565,6279,Idaho,Small City,public,100.0,74.49,100.0,7,1,26,3,0,14,10,1,40,8.72861681309738,1.1718216722448525
Illinois College,956,950,Illinois,Town,NA,35.91,24.98,56.5,0,0,1,0,0,0,0,0,1,0.2876702864124707,0.156947511761415
Illinois Institute of Technology,2895,2631,Illinois,Large City,NA,80.05,62.19,95.55,1,1,2,1,0,1,2,1,3,0.7428848055706662,0.8675358624655919
Illinois State University,18336,17165,Illinois,Suburb,NA,99.86,99.21,100.0,4,3,7,2,2,3,6,5,10,6.367734581650405,0.19949316612679474
Illinois Wesleyan University,1650,1646,Illinois,Small City,NA,46.67,35.32,66.29,0,0,1,0,0,0,0,0,1,0.504388927091951,0.12402151033644725
Immaculata University,1481,885,Pennsylvania,Suburb,NA,68.22,49.68,88.06,1,0,1,0,0,1,1,0,2,0.7188782715520331,0.42682978697127044
IndiaNA State University,11578,9369,IndiaNA,Small City,public,99.45,97.29,99.98,3,2,6,2,1,3,5,3,9,4.459843129689128,0.7342653104194404
IndiaNA University - Bloomington,33427,32212,IndiaNA,Small City,public,100.0,100.0,100.0,12,8,22,6,4,11,18,12,33,10.10019421926052,8.213414471044128
IndiaNA University - East,3292,1887,IndiaNA,Rural,public,74.85,60.99,89.27,1,1,1,0,0,1,1,1,2,1.215642125354949,0.16437067826723387
IndiaNA University - Kokomo,2877,2215,IndiaNA,Small City,NA,71.62,58.87,85.85,1,1,1,0,0,1,1,1,2,1.256485592716947,0.002849263232947397
IndiaNA University - Northwest,3700,2608,IndiaNA,Small City,NA,80.29,68.21,91.95,1,1,2,1,0,1,2,1,3,1.617928320017208,0.005619932335286363
IndiaNA University of Pennsylvania - Main Campus,10255,9526,Pennsylvania,Town,NA,99.95,99.15,100.0,5,3,9,3,2,5,8,5,14,6.719574741872597,0.8969304858207993
IndiaNA University - Purdue University - Fort Wayne,9952,5913,IndiaNA,Large City,public,98.82,95.5,99.91,3,2,5,1,1,2,4,3,7,4.236302001869161,0.2019364123622693
IndiaNA University - Purdue University - IndiaNApolis,21615,17521,IndiaNA,Large City,NA,99.99,99.89,100.0,7,5,11,3,2,5,10,7,16,9.15376763684003,0.696747369980553
IndiaNA University - South Bend,4877,3767,IndiaNA,Midsize City,NA,88.37,77.9,96.56,1,1,2,1,1,1,2,2,3,2.098388032856194,0.052875881059354916
IndiaNA University - Southeast,4824,3218,IndiaNA,Suburb,NA,89.05,75.17,98.04,1,1,3,1,0,1,2,1,4,1.637691288095594,0.5733469564027958
IndiaNA Wesleyan University,2803,2634,IndiaNA,Town,private,73.47,56.18,90.92,1,1,2,0,0,1,1,1,3,0.7154194444375765,0.6109244108824693
Institute of American Indian and Alaska Native Culture and Arts Development,612,264,New Mexico,Rural,NA,48.2,21.62,97.77,0,0,2,0,0,1,0,0,3,0.1781555176450115,0.4788619616554542
IoNA College,3177,2949,New York,Suburb,private,91.63,76.98,98.96,2,1,3,1,0,2,3,1,5,1.745043783804138,0.7346893975216751
Iowa State University,30573,28743,Iowa,Small City,public,100.0,99.5,100.0,8,4,21,4,2,11,12,6,32,7.030276090508468,4.862179898069947
Iowa Wesleyan University,625,550,Iowa,Town,private,28.95,15.76,55.35,0,0,1,0,0,0,0,0,1,0.07011123752452987,0.27125050388496014
Ithaca College,6062,5936,New York,Suburb,NA,99.46,94.47,100.0,4,2,7,2,1,3,6,3,10,1.8599648719154003,3.365224155228387
Jackson State University,6498,5935,Mississippi,Midsize City,NA,100.0,98.9,100.0,7,3,16,3,1,8,10,4,24,7.809291286325807,2.5149892262744884
Jacksonville State University,7492,5523,Alabama,Small City,NA,98.78,82.41,100.0,3,1,7,1,1,3,4,2,10,3.4258106320225337,0.9743125611384927
Jacksonville University,2878,2180,Florida,Large City,NA,99.99,99.5,100.0,6,4,14,3,2,7,9,6,21,8.884073812138185,0.86665291115392
James Madison University,19972,18905,Virginia,Small City,NA,100.0,99.99,100.0,17,6,35,9,3,18,26,9,53,20.302126085906654,5.128030169541406
University of Jamestown,916,871,North Dakota,Town,NA,68.46,26.19,99.86,1,0,4,0,0,2,1,0,6,0.513886905289808,0.6383997107761823
Jarvis Christian College,908,835,Texas,Rural,NA,99.02,83.29,100.0,3,1,8,2,1,4,5,2,12,4.5540629610447505,0.06035020594709148
John Brown University,1972,1489,Arkansas,Town,NA,92.28,64.49,99.84,2,1,4,1,0,2,3,1,6,0.09269010960724615,2.4627912498386464
John Carroll University,3079,2987,Ohio,Suburb,private,76.94,55.87,94.29,1,1,2,0,0,1,1,1,3,0.6429973735579334,0.8235784738848564
Johns Hopkins University,6106,5668,Maryland,Large City,NA,99.93,97.73,100.0,5,3,10,2,1,5,7,4,15,0.46801968758815204,6.728968404063671
Johnson & Wales University - Providence,7717,7267,Rhode Island,Midsize City,private,99.88,97.29,100.0,4,2,9,2,1,5,6,3,14,0.28562295377354696,6.440704496055502
Johnson C Smith University,1395,1329,North CaroliNA,Large City,NA,66.69,38.83,91.07,1,0,2,0,0,1,1,0,3,0.14195164302459237,0.9563859446431437
Johnson State College,1377,882,Vermont,Rural,NA,31.09,17.88,52.03,0,0,0,0,0,0,0,0,0,0.00037424029144767423,0.37166265281378763
Judson College,313,230,Alabama,Rural,NA,22.89,10.04,56.13,0,0,1,0,0,0,0,0,1,0.14356552869181638,0.11619000566585028
Judson University,1078,761,Illinois,Midsize City,private,35.3,25.29,53.74,0,0,1,0,0,0,0,0,1,0.3034763461054636,0.1317989668166494
Juniata College,1487,1400,Pennsylvania,Town,NA,70.95,51.54,90.35,1,0,2,0,0,1,1,0,3,0.663635130923783,0.5718246573438044
Kalamazoo College,1434,1427,Michigan,Small City,NA,67.2,46.52,89.46,1,0,2,0,0,1,1,0,3,0.6843571114155031,0.4297861699238538
Kansas State University,18484,16770,Kansas,Small City,NA,99.12,85.61,100.0,3,1,8,2,1,4,5,2,12,0.7647954296907764,3.9592194881689915
Kansas Wesleyan University,693,631,Kansas,Town,NA,68.6,37.36,94.72,1,0,2,0,0,1,1,0,3,0.01953621084617973,1.1358110377333597
Kaplan University - Davenport Campus,25486,3127,Iowa,Midsize City,NA,100.0,100.0,100.0,25,12,61,13,6,32,38,18,93,0.2541104852718326,37.28935826297852
Kean University,11985,9516,New Jersey,Suburb,NA,100.0,99.85,100.0,9,4,19,4,2,9,13,6,28,12.918644181150011,0.3690761275343674
Keene State College,3778,3624,New Hampshire,Town,NA,83.7,55.89,97.51,1,1,2,1,0,1,2,1,3,0.3426527293801132,1.4706669052239667
Kent State University at Kent,23179,19108,Ohio,Suburb,public,99.99,99.07,100.0,6,3,12,3,2,6,9,5,18,6.281541447783871,2.567838466719228
Kentucky Christian University,589,439,Kentucky,Town,NA,33.98,18.43,59.94,0,0,1,0,0,0,0,0,1,0.15789646949092978,0.2569226872754423
Kentucky State University,1762,1122,Kentucky,Town,public,63.49,41.22,88.1,1,0,1,0,0,1,1,0,2,0.32158247619652697,0.6854355924590759
Kentucky Wesleyan College,716,673,Kentucky,Small City,private,36.51,19.16,64.6,0,0,1,0,0,0,0,0,1,0.256318602140276,0.19767588408962677
Kenyon College,1678,1661,Ohio,Town,NA,78.37,55.02,95.87,1,1,2,1,0,1,2,1,3,0.07908020406861845,1.4503604446653617
Kettering University,1891,1807,Michigan,Small City,NA,77.24,55.32,95.34,1,1,2,0,0,1,1,1,3,0.8754527967603564,0.6035153342001545
Keuka College,1645,1312,New York,Town,private,69.54,51.37,87.98,1,0,1,0,0,1,1,0,2,1.1016320866716558,0.0865632795062164
Keystone College,1454,1065,Pennsylvania,Suburb,private,65.72,48.81,85.15,1,0,1,0,0,1,1,0,2,0.867389052202004,0.20285295873595016
King University,1798,1608,Tennessee,Small City,NA,73.09,35.7,95.94,1,0,2,0,0,1,1,0,3,0.2620109594497592,1.0495325567601776
King's College,2198,2025,Pennsylvania,Small City,NA,83.04,65.14,96.38,1,1,2,1,0,1,2,1,3,1.0230742666997996,0.7500805535944647
Knox College,1354,1334,Illinois,Town,private,51.61,34.6,76.71,0,0,1,0,0,0,0,0,1,0.2637855739875037,0.4616620687595026
Kutztown University of Pennsylvania,7489,7053,Pennsylvania,Town,NA,99.66,97.07,100.0,4,2,7,2,1,3,6,3,10,4.645445916466481,1.0484706323144284
Kuyper College,182,146,Michigan,Suburb,NA,11.35,6.53,21.7,0,0,0,0,0,0,0,0,0,0.11038017926056504,0.010064938437779914
La Roche College,1379,1163,Pennsylvania,Suburb,NA,61.65,45.92,81.39,1,0,1,0,0,1,1,0,2,0.8716937125106988,0.08636442310771103
La Salle University,3822,3322,Pennsylvania,Large City,NA,95.61,83.89,99.73,2,1,4,1,1,2,3,2,6,1.660881435771414,1.4636496983704412
La Sierra University,2027,1830,California,Large City,private,99.03,92.91,99.99,3,2,6,2,1,3,5,3,9,4.478420711570423,0.14751998656070284
Lafayette College,2590,2551,Pennsylvania,Suburb,NA,91.47,73.31,99.47,2,1,3,1,0,2,3,1,5,0.38598454101296786,2.0736301306054243
LaGrange College,940,888,Georgia,Town,NA,46.92,24.44,83.09,0,0,1,0,0,1,0,0,2,0.24899019697761612,0.3834727237541881
Lake Erie College,959,724,Ohio,Suburb,private,44.63,26.47,71.83,0,0,1,0,0,0,0,0,1,0.20868387184774315,0.381762556150248
Lake Forest College,1505,1487,Illinois,Suburb,NA,63.83,45.53,86.0,1,0,1,0,0,1,1,0,2,0.2911827441220247,0.7247925909245784
Lake Superior State University,1962,1706,Michigan,Town,public,75.97,54.88,94.55,1,1,2,0,0,1,1,1,3,1.2514352823666561,0.1736421498677078
Lakeland University,1997,779,Wisconsin,Rural,private,37.65,25.56,58.74,0,0,1,0,0,0,0,0,1,0.21577068413828376,0.2562923710283446
Lamar University,9270,5967,Texas,Midsize City,NA,100.0,100.0,100.0,33,13,85,17,7,46,50,20,131,50.52337575975685,0.1685906655909415
Lander University,2785,2600,South CaroliNA,Town,NA,98.67,77.48,100.0,3,1,7,1,0,3,4,1,10,4.062510281173339,0.25197259803864186
Lane College,1416,1370,Tennessee,Small City,NA,44.57,19.32,79.89,0,0,1,0,0,1,0,0,2,0.22962758243911482,0.3598282682007455
Langston University,2028,1822,Oklahoma,Rural,NA,91.11,66.14,99.78,2,1,4,1,0,2,3,1,6,0.5653907820060883,1.8506417037919463
Lasell College,1733,1669,Massachusetts,Small City,NA,80.48,56.87,96.11,1,1,2,1,0,1,2,1,3,1.33382718066065,0.2986950307538299
Lawrence Technological University,2191,1672,Michigan,Small City,NA,79.12,58.52,95.8,1,1,2,1,0,1,2,1,3,1.391480134803498,0.17408610963756577
Lawrence University,1471,1434,Wisconsin,Small City,private,50.21,33.1,74.2,0,0,1,0,0,0,0,0,1,0.06161147181686021,0.6352161139033763
Le Moyne College,2793,2410,New York,Suburb,NA,88.34,72.44,97.94,1,1,3,1,0,1,2,1,4,1.8475211872154547,0.3002006026872466
Le Moyne - Owen College,867,770,Tennessee,Large City,private,25.52,7.67,58.99,0,0,1,0,0,0,0,0,1,0.19356427622271538,0.10082058803084315
Lebanon Valley College,1756,1624,Pennsylvania,Suburb,private,73.86,56.02,91.28,1,1,2,0,0,1,1,1,3,0.9247845229846015,0.4164779637765588
Lee University,4856,3854,Tennessee,Small City,NA,95.85,73.01,99.98,2,1,6,1,0,3,3,1,9,0.5583679248198988,2.6190680335322885
Lees - McRae College,920,891,North CaroliNA,Rural,NA,57.47,34.14,84.64,1,0,1,0,0,1,1,0,2,0.12528116537401748,0.7284873908298523
Lehigh University,5065,5013,Pennsylvania,Small City,NA,99.26,92.84,100.0,3,2,7,2,1,4,5,3,11,0.8501704109672248,4.048877862772445
Lenoir - Rhyne University,1698,1441,North CaroliNA,Small City,private,61.62,38.36,87.01,1,0,1,0,0,1,1,0,2,0.32456914819679933,0.6320868748120874
Lesley University,2097,1645,Massachusetts,Midsize City,private,86.56,64.23,98.34,1,1,3,1,0,1,2,1,4,1.176298704338676,0.8286971833527168
LeTourneau University,2606,1301,Texas,Small City,NA,100.0,98.78,100.0,7,3,19,4,1,10,11,4,29,10.349636973816859,0.8119076461629385
Lewis & Clark College,2113,2067,Oregon,Large City,NA,94.29,77.89,99.87,2,1,4,1,1,2,3,2,6,0.16157395150606182,2.697414886702638
Lewis - Clark State College,3746,2215,Idaho,Small City,NA,97.19,49.92,100.0,2,0,9,1,0,5,3,0,14,2.7273063562526265,0.8424583557111037
Lewis University,4502,3687,Illinois,Suburb,private,81.75,70.55,93.78,1,1,2,1,0,1,2,1,3,1.479447187264135,0.2212628735353316
Liberty University,45756,26892,Virginia,Small City,NA,100.0,100.0,100.0,38,16,86,19,8,44,57,24,130,17.951231838955778,39.14605858474729
Life University,760,624,Georgia,Small City,NA,42.64,22.15,83.69,0,0,1,0,0,1,0,0,2,0.14276676717248885,0.41228807998259487
Limestone College,2599,1943,South CaroliNA,Town,private,97.34,75.17,99.98,2,1,6,1,0,3,3,1,9,2.7114248573662607,0.9125331146703143
Lincoln Memorial University,1923,1355,Tennessee,Town,NA,62.74,27.75,95.52,1,0,2,0,0,1,1,0,3,0.3444413736586722,0.6416756454565263
Lincoln University California,107,72,California,Large City,private,22.37,13.56,39.09,0,0,0,0,0,0,0,0,0,0.2528712486216545,0.0
Lincoln University Missouri,2513,1804,Missouri,Small City,NA,65.22,40.62,91.33,1,0,2,0,0,1,1,0,3,0.4333241223389484,0.6218813491488139
Lincoln University of Pennsylvania,2002,1826,Pennsylvania,Suburb,NA,79.88,60.75,95.08,1,1,2,1,0,1,2,1,3,0.5431046422803284,1.0595738053713883
Lindenwood University,6931,6215,Missouri,Small City,private,96.96,81.14,99.99,2,1,6,1,1,3,3,2,9,1.185162062942691,2.304781561555915
Lindsey Wilson College,2071,1919,Kentucky,Town,NA,67.95,38.4,93.54,1,0,2,0,0,1,1,0,3,0.9626421423297018,0.1748763390958777
Linfield College - McMinnville Campus,1536,1505,Oregon,Town,NA,74.58,49.91,98.34,1,0,3,0,0,1,1,0,4,0.4427747709541118,0.9257571467483228
Lipscomb University,2994,2723,Tennessee,Large City,NA,81.93,47.48,98.89,1,0,3,1,0,1,2,0,4,0.4832973690224959,1.2253728274822597
Livingstone College,1153,1140,North CaroliNA,Suburb,private,55.25,33.24,81.26,1,0,1,0,0,1,1,0,2,0.17680809629397629,0.6265422919486547
Lock Haven University,3471,3176,Pennsylvania,Town,public,92.33,80.24,98.95,2,1,3,1,1,2,3,2,5,2.275730416529989,0.29162266206763227
LIU Brooklyn,3947,3396,New York,Large City,NA,96.41,85.45,99.86,2,1,4,1,1,2,3,2,6,2.318185261454574,1.006329874254667
LIU Post,6317,2845,New York,Suburb,private,99.34,94.92,99.99,3,2,6,2,1,3,5,3,9,4.135695209099572,0.8817273121273713
Longwood University,4469,3959,Virginia,Town,NA,99.83,85.97,100.0,4,1,9,2,1,5,6,2,14,6.253147366582131,0.13611705195490822
Loras College,1395,1335,Iowa,Small City,NA,39.17,25.94,64.62,0,0,1,0,0,0,0,0,1,0.16074283725136115,0.3361127025968472
LouisiaNA College,985,866,LouisiaNA,Suburb,NA,71.14,41.32,94.99,1,0,2,0,0,1,1,0,3,0.9371625318658389,0.3043556164007382
LouisiaNA State University - Alexandria,3372,1844,LouisiaNA,Rural,public,97.32,79.45,99.98,2,1,6,1,1,3,3,2,9,3.3198829560214684,0.29564772219272517
LouisiaNA State University and Agricultural & Mechanical College,25448,22060,LouisiaNA,Midsize City,NA,100.0,100.0,100.0,29,12,70,14,6,36,43,18,106,19.03317891514891,24.063529457235482
LouisiaNA State University - Shreveport,2641,1641,LouisiaNA,Midsize City,public,96.33,75.87,99.96,2,1,5,1,0,3,3,1,8,2.4368267576947247,0.8637110914050681
LouisiaNA Tech University,11323,8090,LouisiaNA,Town,NA,100.0,99.78,100.0,10,4,24,5,2,12,15,6,36,10.329205334878603,4.08652052275346
Lourdes University,1046,827,Ohio,Suburb,NA,34.1,19.43,57.94,0,0,1,0,0,0,0,0,1,0.2849397829139109,0.13184502255345487
Loyola Marymount University,6395,6164,California,Large City,NA,100.0,99.93,100.0,9,5,19,4,2,10,13,7,29,10.717487032702833,2.5384128320780177
Loyola University Maryland,3927,3886,Maryland,Large City,private,96.99,84.98,99.93,2,1,5,1,1,2,3,2,7,0.4303703923314075,3.0715271189035955
Loyola University Chicago,11426,10681,Illinois,Large City,private,99.78,97.59,100.0,4,2,8,2,1,4,6,3,12,2.36669400469747,3.736277858876808
Loyola University New Orleans,2607,2446,LouisiaNA,Large City,private,97.79,83.06,99.98,3,1,6,1,1,3,4,2,9,1.1433791238450322,2.6649542162361417
Lubbock Christian University,1482,1276,Texas,Large City,NA,99.95,94.67,100.0,5,2,13,3,1,7,8,3,20,7.460200938630765,0.10724183165153889
Luther College,2046,2014,Iowa,Town,NA,44.05,25.93,73.98,0,0,1,0,0,0,0,0,1,0.2089656884267695,0.37139758721823307
Lycoming College,1222,1199,Pennsylvania,Small City,private,62.31,43.93,83.84,1,0,1,0,0,1,1,0,2,0.5266034444303316,0.44872396911944623
University of Lynchburg,2051,1928,Virginia,Small City,private,91.88,59.47,99.51,2,1,3,1,0,2,3,1,5,1.9113666632651045,0.597892157623735
Lyndon State College,1069,871,Vermont,Town,NA,22.72,12.12,40.57,0,0,0,0,0,0,0,0,0,0.000279747726165205,0.25730018685352257
Lynn University,2205,1826,Florida,Small City,NA,99.1,91.63,100.0,3,2,7,2,1,4,5,3,11,3.2195435558694054,1.4835368584338373
Lyon College,670,652,Arkansas,Town,NA,36.85,15.22,70.14,0,0,1,0,0,0,0,0,1,0.078198312284751,0.3805466093245272
Macalester College,2138,2093,Minnesota,Large City,NA,82.67,59.89,98.27,1,1,3,1,0,1,2,1,4,0.03817059436734821,1.7124504987628302
MadonNA University,2455,1358,Michigan,Small City,NA,81.79,61.68,96.8,1,1,2,1,0,1,2,1,3,1.6688103351956676,0.034017964707461386
Maharishi University of MaNAgement,325,261,Iowa,Town,NA,24.51,13.05,47.02,0,0,0,0,0,0,0,0,0,0.036936651964142565,0.24388142078898845
Maine Maritime Academy,1021,989,Maine,Rural,NA,27.57,11.13,53.88,0,0,1,0,0,0,0,0,1,0.13498888540693108,0.18728122917295506
Malone University,1334,1099,Ohio,Small City,NA,46.05,27.05,73.07,0,0,1,0,0,0,0,0,1,0.35491948730796613,0.2618538149736392
Manchester University,1264,1244,IndiaNA,Town,NA,46.05,33.34,71.61,0,0,1,0,0,0,0,0,1,0.500661857985781,0.11610500636493391
Manhattan College,3666,3479,New York,Large City,NA,95.28,82.59,99.7,2,1,4,1,1,2,3,2,6,1.8614288348212762,1.1893139445606855
Manhattanville College,1731,1633,New York,Suburb,NA,80.71,60.2,96.1,1,1,2,1,0,1,2,1,3,0.7122179537086519,0.931548877980784
Mansfield University of Pennsylvania,1827,1655,Pennsylvania,Town,NA,73.12,56.9,89.95,1,1,2,0,0,1,1,1,3,1.095536048562829,0.21790873442449707
MaraNAtha Baptist University,933,591,Wisconsin,Town,NA,46.23,25.78,82.96,0,0,1,0,0,1,0,0,2,0.032372129259706214,0.5872780491670064
Marian University IndiaNA,2301,1961,IndiaNA,Large City,NA,67.36,52.84,84.51,1,0,1,0,0,1,1,0,2,0.8954820424850942,0.22368139661091727
Marian University Wisconsin,1508,1254,Wisconsin,Small City,NA,20.91,16.12,28.87,0,0,0,0,0,0,0,0,0,0.1723032686403718,0.06227363726513994
Marietta College,1063,960,Ohio,Town,NA,44.64,26.5,71.07,0,0,1,0,0,0,0,0,1,0.21715675085509512,0.3735606728207877
Marist College,5697,5085,New York,Suburb,private,99.25,93.62,99.99,3,2,7,2,1,3,5,3,10,2.1783768039434204,2.7081838309763646
Marquette University,8334,8026,Wisconsin,Large City,NA,95.71,86.88,99.64,2,1,4,1,1,2,3,2,6,0.3681024375498852,2.7786859054941266
Mars Hill University,1265,1199,North CaroliNA,Suburb,private,58.16,33.64,85.71,1,0,1,0,0,1,1,0,2,0.20838097063218633,0.6619445042952553
Marshall University,9492,7846,West Virginia,Small City,NA,87.27,61.21,98.83,1,1,3,1,0,1,2,1,4,0.15414801014446083,1.9048809156052626
Martin Luther College,896,743,Minnesota,Town,private,38.21,23.51,62.45,0,0,1,0,0,0,0,0,1,0.012419685928480462,0.4683651023919241
Martin Methodist College,979,810,Tennessee,Town,NA,27.41,7.4,62.67,0,0,1,0,0,0,0,0,1,0.21736115175326468,0.10286712668978071
Martin University,263,159,IndiaNA,Large City,NA,10.91,7.83,16.41,0,0,0,0,0,0,0,0,0,0.11550356899145649,0.0
Mary Baldwin University,1133,720,Virginia,Small City,private,76.26,40.81,95.37,1,0,2,0,0,1,1,0,3,1.0366489391536156,0.40023956932533555
Marymount Manhattan College,2149,1915,New York,Large City,private,91.41,72.96,99.32,2,1,3,1,0,2,3,1,5,0.548986089703483,1.9026369722364371
Marymount University,2306,2069,Virginia,Midsize City,NA,93.29,64.68,99.65,2,1,4,1,0,2,3,1,6,1.7942556952435662,0.9047605723346607
Maryville College,1184,1158,Tennessee,Suburb,NA,60.21,32.32,93.06,1,0,2,0,0,1,1,0,3,0.20951063611432055,0.710526783038457
Maryville University of Saint Louis,3184,2375,Missouri,Suburb,private,71.85,48.28,94.03,1,0,2,0,0,1,1,0,3,0.5808335636494121,0.6858210951619594
Marywood University,1957,1756,Pennsylvania,Small City,NA,79.42,61.33,94.61,1,1,2,1,0,1,2,1,3,0.9319589568324261,0.6479363331788294
Massachusetts College of Liberal Arts,1407,1201,Massachusetts,Town,public,80.23,57.04,95.91,1,1,2,1,0,1,2,1,3,1.425503589011963,0.19454434601190437
Massachusetts Institute of Technology,4551,4510,Massachusetts,Midsize City,private,99.93,97.36,100.0,5,2,10,2,1,5,7,3,15,0.6301139052878967,6.614938505360943
Massachusetts Maritime Academy,1687,1607,Massachusetts,Suburb,NA,87.05,64.6,98.41,1,1,3,1,0,1,2,1,4,1.6282246610000772,0.41444842286270145
Mayville State University,1097,600,North Dakota,Rural,NA,72.35,28.17,99.04,1,0,3,0,0,2,1,0,5,0.9462250069693946,0.33816269561709494
McDaniel College,1588,1543,Maryland,Suburb,private,65.76,47.02,86.34,1,0,1,0,0,1,1,0,2,0.981478179796513,0.08983186325667368
McKendree University,2103,1692,Illinois,Suburb,NA,57.81,45.13,77.15,1,0,1,0,0,0,1,0,1,0.6483996931836642,0.2140823358697201
McMurry University,1106,956,Texas,Midsize City,private,99.75,89.94,100.0,4,2,10,2,1,6,6,3,16,5.912487609571546,0.05593825394073101
McNeese State University,6924,5567,LouisiaNA,Small City,NA,99.99,97.7,100.0,6,3,14,3,1,7,9,4,21,6.601993565987342,2.207835184831246
McPherson College,723,673,Kansas,Town,private,58.53,29.61,89.54,1,0,1,0,0,1,1,0,2,0.017498081979275482,0.8607697784002117
Medaille College,1526,1426,New York,Large City,NA,67.39,49.5,86.34,1,0,1,0,0,1,1,0,2,1.0899203834246483,0.030257048001863594
Menlo College,746,728,California,Suburb,private,80.5,59.11,97.75,1,1,2,1,0,1,2,1,3,1.3801570952808058,0.2523738920378952
Mercer University,4746,4135,Georgia,Midsize City,NA,91.91,63.79,99.97,2,1,5,1,0,3,3,1,8,1.223582423207166,1.2886213841489467
Mercy College,6862,5055,New York,Suburb,private,99.42,95.56,99.99,3,2,6,2,1,3,5,3,9,4.595379561544622,0.5487419003671616
Mercyhurst University,2452,2373,Pennsylvania,Small City,NA,82.75,65.75,96.0,1,1,2,1,0,1,2,1,3,1.010160285773715,0.7460182998360129
Meredith College,1682,1600,North CaroliNA,Large City,NA,45.58,25.76,71.95,0,0,1,0,0,0,0,0,1,0.37685382810087514,0.23133358851137997
Merrimack College,3535,3323,Massachusetts,Suburb,NA,97.79,85.5,99.95,3,1,5,1,1,3,4,2,8,3.2164215944101446,0.5929420245659148
Colorado Mesa University,9461,7145,Colorado,Small City,public,96.9,79.09,99.99,2,1,6,1,1,3,3,2,9,1.8734216234474304,1.5978774840497831
Messiah College,2760,2637,Pennsylvania,Suburb,private,88.35,71.48,98.18,1,1,3,1,0,1,2,1,4,1.118494236875868,1.0303927522766054
Methodist University,1938,1755,North CaroliNA,Midsize City,NA,82.31,57.27,97.57,1,1,2,1,0,1,2,1,3,0.2924911078691779,1.4374288482337558
Metropolitan College of New York,777,681,New York,Large City,NA,43.65,29.54,63.92,0,0,1,0,0,0,0,0,1,0.5599658114975526,0.01344524979824806
Metropolitan State University of Denver,19668,12759,Colorado,Large City,public,99.21,88.63,100.0,3,1,8,2,1,4,5,2,12,4.454984197032548,0.3820909553282322
Metropolitan State University,7317,2878,Minnesota,Large City,NA,56.56,44.51,73.71,1,0,1,0,0,0,1,0,1,0.833714146226528,0.0
Miami University - Oxford,17153,16619,Ohio,Town,NA,99.95,98.2,100.0,5,3,11,2,1,5,7,4,16,3.6803675925268142,3.910320040425066
Michigan State University,38997,35404,Michigan,Small City,NA,100.0,100.0,100.0,19,11,39,9,5,19,28,16,58,23.96146728910753,4.660605812559198
Michigan Technological University,5886,5492,Michigan,Town,NA,96.98,86.43,99.91,2,1,5,1,1,2,3,2,7,3.15687312685216,0.3416357010480747
Mid - America Christian University,1622,1170,Oklahoma,Large City,private,87.23,56.45,99.74,1,1,4,1,0,2,2,1,6,0.4646574025045669,1.5897320000609942
Mid - Atlantic Christian University,192,166,North CaroliNA,Town,private,9.83,4.22,19.24,0,0,0,0,0,0,0,0,0,0.029047044391153246,0.0743344099374369
MidAmerica Nazarene University,1311,998,Kansas,Suburb,NA,49.21,25.59,87.41,0,0,1,0,0,1,0,0,2,0.02977656564086936,0.6466547010637478
Middle Tennessee State University,19520,15812,Tennessee,Midsize City,public,99.65,71.37,100.0,4,1,12,2,0,5,6,1,17,4.552808413360141,1.0936853341239292
Middlebury College,2547,2528,Vermont,Town,NA,93.5,74.05,99.97,2,1,5,1,0,3,3,1,8,5.139069339923766e-05,2.7301811963814253
Midland University,1660,1187,Nebraska,Town,NA,60.01,38.16,86.61,1,0,1,0,0,1,1,0,2,0.0876251734946948,0.8273693513622251
Midway University,1003,760,Kentucky,Rural,private,43.41,21.42,74.46,0,0,1,0,0,0,0,0,1,0.4773736594275777,0.09169360016683836
Midwestern State University,5328,4199,Texas,Midsize City,public,100.0,100.0,100.0,19,7,48,10,4,26,29,11,74,28.487946420129568,0.17708707434965137
Miles College,1654,1555,Alabama,Suburb,private,72.52,45.56,94.79,1,0,2,0,0,1,1,0,3,0.5184633667736851,0.7718161932202422
Millersville University of Pennsylvania,6756,5671,Pennsylvania,Suburb,NA,99.27,95.67,99.98,3,2,6,2,1,3,5,3,9,4.549308502905631,0.37492587087688856
Millikin University,1951,1840,Illinois,Small City,private,54.82,41.64,75.54,1,0,1,0,0,0,1,0,1,0.5953615817693991,0.1987861844377219
Mills College,764,739,California,Large City,private,80.15,59.73,96.09,1,1,2,1,0,1,2,1,3,1.4345125973209745,0.18061616429137026
Millsaps College,808,797,Mississippi,Midsize City,NA,76.53,45.93,96.85,1,0,2,0,0,1,1,0,3,0.5540065699953943,0.893297661579221
Milwaukee School of Engineering,2607,2508,Wisconsin,Large City,private,50.28,35.25,81.18,0,0,1,0,0,1,0,0,2,0.23417580601577803,0.46400928912190387
Minnesota State University - Mankato,12781,10832,Minnesota,Small City,NA,84.6,70.24,96.31,1,1,2,1,0,1,2,1,3,1.2483493489213942,0.6218810736175245
Minnesota State University - Moorhead,5126,4157,Minnesota,Suburb,NA,88.76,52.0,99.94,1,0,5,1,0,3,2,0,8,0.4015318643299555,1.7827591493349602
Minot State University,2959,1952,North Dakota,Town,public,99.06,62.04,100.0,3,1,17,2,0,10,5,1,27,3.181697766252766,1.48363171316316
Misericordia University,2148,1660,Pennsylvania,Suburb,private,80.43,63.11,94.86,1,1,2,1,0,1,2,1,3,1.118494236875868,0.512140130090945
Mississippi College,3246,2793,Mississippi,Suburb,private,99.7,91.71,100.0,4,2,9,2,1,4,6,3,13,3.7991642598028528,2.00306805460784
Mississippi State University,18312,16803,Mississippi,Town,public,100.0,100.0,100.0,19,8,42,9,4,20,28,12,62,22.081381069650863,5.259352655736582
Mississippi University for Women,2577,2113,Mississippi,Town,NA,98.61,84.17,99.99,3,1,7,1,1,3,4,2,10,3.7239514473200344,0.5465092946500119
Mississippi Valley State University,1974,1667,Mississippi,Town,public,96.36,76.36,99.94,2,1,5,1,0,2,3,1,7,2.810390944479947,0.4985660912271972
Missouri Baptist University,4507,1519,Missouri,Suburb,NA,87.67,65.03,99.15,1,1,3,1,0,2,2,1,5,0.8964407919376456,1.1939431529023063
Missouri Southern State University,6025,4358,Missouri,Small City,NA,83.46,58.42,98.4,1,1,3,1,0,1,2,1,4,1.241598351654248,0.5566711429587848
Missouri State University - Springfield,20365,15363,Missouri,Midsize City,NA,99.75,94.8,100.0,4,2,9,2,1,4,6,3,13,4.48971265046101,1.502296576408917
Missouri Valley College,1793,1296,Missouri,Town,NA,69.52,43.96,93.48,1,0,2,0,0,1,1,0,3,0.32723358819447695,0.8589464517520409
Missouri Western State University,5290,3498,Missouri,Small City,NA,73.74,48.92,95.38,1,0,2,0,0,1,1,0,3,1.198483933668595,0.13826280179521624
Mitchell College,706,575,Connecticut,Small City,NA,36.85,24.14,56.78,0,0,1,0,0,0,0,0,1,0.09398621689670478,0.36538592332677733
Molloy College,3534,2800,New York,Suburb,private,92.51,79.57,98.98,2,1,3,1,1,2,3,2,5,2.58023462160637,0.010083937348686046
Monmouth College,1035,1016,Illinois,Town,NA,32.12,24.08,47.78,0,0,0,0,0,0,0,0,0,0.34141088936864655,0.04583933246843974
Monmouth University,4708,4502,New Jersey,Suburb,NA,99.31,91.73,100.0,3,2,7,2,1,3,5,3,10,4.35289962218281,0.6273374156587491
MontaNA State University,14652,12403,MontaNA,Town,NA,100.0,91.09,100.0,35,2,479,22,1,315,57,3,794,51.373733286699114,4.947340400099559
MontaNA State University - Billings,4022,2400,MontaNA,Midsize City,public,100.0,12.02,100.0,13,0,194,8,0,128,21,0,322,21.121410426956057,0.2666221371381683
MontaNA State University - Northern,1164,855,MontaNA,Town,NA,99.78,8.92,100.0,4,0,55,2,0,36,6,0,91,5.922596924894942,0.1613268460941499
MontaNA Tech of the University of MontaNA,1657,1529,MontaNA,Town,NA,99.98,15.08,100.0,5,0,73,3,0,48,8,0,121,7.916169785777146,0.4257958192659761
Montclair State University,16852,14944,New Jersey,Suburb,NA,100.0,99.99,100.0,13,6,27,6,3,13,19,9,40,18.3796564742051,0.37056222327430927
Montreat College,757,543,North CaroliNA,Suburb,NA,37.91,19.61,66.41,0,0,1,0,0,0,0,0,1,0.13715256612518445,0.33877801854705336
Moravian College,2083,1886,Pennsylvania,Small City,private,83.43,63.98,96.85,1,1,2,1,0,1,2,1,3,0.8594971749693968,0.9371228191924148
Morehead State University,9660,5835,Kentucky,Town,NA,99.42,89.09,100.0,3,2,8,2,1,4,5,3,12,4.098992347984537,1.0554918642985032
Morehouse College,2202,2090,Georgia,Large City,private,90.42,65.75,99.64,2,1,4,1,0,2,3,1,6,0.20470462711716947,2.137195421449168
Morgan State University,6436,5825,Maryland,Large City,public,99.31,94.14,99.99,3,2,6,2,1,3,5,3,9,2.911978250375104,2.060312359952027
Morningside College,1322,1252,Iowa,Small City,NA,34.76,18.14,66.36,0,0,1,0,0,0,0,0,1,0.2640286603362783,0.16287075058185985
Morris College,745,731,South CaroliNA,Small City,private,64.79,30.97,91.42,1,0,2,0,0,1,1,0,3,0.9331126500037473,0.11001076459129348
Mount Aloysius College,1689,999,Pennsylvania,Town,NA,71.15,54.69,88.81,1,1,1,0,0,1,1,1,2,1.134277991341082,0.10843901879358799
Mount Holyoke College,2213,2161,Massachusetts,Suburb,NA,93.46,76.63,99.75,2,1,4,1,0,2,3,1,6,0.60170713086918,2.121954495906466
Mount Marty College,875,457,South Dakota,Town,private,28.56,15.92,48.51,0,0,0,0,0,0,0,0,0,0.20263107210164544,0.1334189686891568
Mount Mary University,700,624,Wisconsin,Large City,private,9.07,6.99,12.34,0,0,0,0,0,0,0,0,0,0.0891538882434651,0.005971178106241761
Mount Mercy University,1517,1083,Iowa,Midsize City,NA,45.72,21.61,82.68,0,0,1,0,0,1,0,0,2,0.48770060834136386,0.12305946501939714
University of Mount Olive,3206,1472,North CaroliNA,Town,private,76.43,50.66,95.62,1,0,2,0,0,1,1,0,3,0.7185986199376607,0.7250426340547245
Mount Saint Mary College,2036,1737,New York,Suburb,private,76.83,58.6,92.86,1,1,2,0,0,1,1,1,3,1.1828820279477714,0.27907295456122677
Mount Saint Mary's University,2603,2056,California,Large City,NA,99.77,96.91,100.0,4,2,8,2,1,4,6,3,12,5.974378659023762,0.08850734334606078
Mount St Mary's University,1815,1696,Maryland,Town,private,76.5,54.35,95.48,1,1,2,0,0,1,1,1,3,0.5647394288511682,0.8827724597886542
Mount Vernon Nazarene University,1829,1440,Ohio,Town,NA,47.18,28.29,72.8,0,0,1,0,0,0,0,0,1,0.5046070164378511,0.13354508147934968
Muhlenberg College,2369,2279,Pennsylvania,Midsize City,NA,88.2,69.1,98.5,1,1,3,1,0,1,2,1,4,0.3314588437695003,1.8045314358924809
Murray State University,8559,6584,Kentucky,Town,NA,98.61,85.01,100.0,3,1,7,1,1,3,4,2,10,3.0252963554462142,1.245499199467966
Muskingum University,1559,1363,Ohio,Town,NA,45.76,26.97,72.15,0,0,1,0,0,0,0,0,1,0.43902065671427465,0.1723462739319784
Naropa University,391,368,Colorado,Midsize City,NA,32.54,16.4,78.7,0,0,1,0,0,1,0,0,2,0.013113721298846068,0.3800113533583158
NatioNAl Louis University,1883,1250,Illinois,Large City,NA,48.39,38.91,64.76,0,0,1,0,0,0,0,0,1,0.6613957867090139,0.0
NatioNAl University,7881,2899,California,Large City,private,100.0,100.0,100.0,13,7,27,6,3,14,19,10,41,16.852568915149703,2.222816785696701
Nazareth College,2195,2099,New York,Suburb,NA,81.53,63.47,95.44,1,1,2,1,0,1,2,1,3,1.510809718863985,0.17730491654485642
Nebraska Wesleyan University,1776,1566,Nebraska,Large City,NA,30.89,17.91,54.7,0,0,1,0,0,0,0,0,1,0.12303091702852906,0.24592356243617086
Neumann University,2085,1462,Pennsylvania,Suburb,private,79.2,61.18,94.46,1,1,2,1,0,1,2,1,3,0.991506757769371,0.5779805941548639
Nevada State College,4217,1708,Nevada,Rural,public,100.0,97.72,100.0,11,3,40,6,1,20,17,4,60,16.917208189266216,0.0437819974667813
New College of Florida,836,835,Florida,Small City,NA,96.28,83.1,99.93,2,1,5,1,1,2,3,2,7,3.0935614167266894,0.1897309871297821
New England College,1841,1811,New Hampshire,Rural,NA,70.69,44.44,91.75,1,0,2,0,0,1,1,0,3,0.12692320086531858,1.0995739200021715
New Jersey City University,6508,5210,New Jersey,Large City,NA,99.93,97.11,100.0,5,2,10,2,1,5,7,3,15,7.245869203772518,0.026347486300229164
New Jersey Institute of Technology,8479,6380,New Jersey,Large City,public,99.99,99.02,100.0,6,3,14,3,1,6,9,4,20,9.053134864153694,0.4168764667626925
New Mexico Highlands University,1933,1315,New Mexico,Town,public,93.54,64.7,99.97,2,1,5,1,0,3,3,1,8,0.8155864762151858,1.9193317075313738
New Mexico Institute of Mining and Technology,1471,1294,New Mexico,Town,NA,73.65,35.44,98.86,1,0,3,0,0,1,1,0,4,0.7986515410778272,0.5335304437575763
New Mexico State University - Main Campus,11711,9703,New Mexico,Suburb,public,100.0,99.67,100.0,11,4,32,5,2,16,16,6,48,6.213766400599583,9.941963881877681
New York Institute of Technology,3663,3234,New York,Suburb,NA,94.18,81.78,99.43,2,1,3,1,1,2,3,2,5,2.3760117962366745,0.4668899126707041
New York University,26418,25347,New York,Large City,NA,100.0,100.0,100.0,23,12,48,12,6,24,35,18,72,5.715311184539726,28.996765507544964
Newberry College,1177,1158,South CaroliNA,Town,private,83.81,49.21,98.57,1,0,3,1,0,1,2,0,4,1.4852685652125763,0.33361281933136017
Newman University,2811,1013,Kansas,Large City,private,61.49,30.3,91.5,1,0,2,0,0,1,1,0,3,0.11189824583905998,0.8405987798619706
Niagara University,2998,2827,New York,Suburb,private,90.35,75.13,98.63,2,1,3,1,0,1,3,1,4,1.9646382196855312,0.37201361098460095
Nicholls State University,5684,4662,LouisiaNA,Small City,public,99.78,93.14,100.0,4,2,10,2,1,5,6,3,15,5.60051595840522,0.5285295218928162
Nichols College,1339,1232,Massachusetts,Suburb,private,78.28,55.46,95.2,1,1,2,1,0,1,2,1,3,1.0730013428160698,0.452539084016877
Norfolk State University,4684,4011,Virginia,Midsize City,NA,99.77,87.15,100.0,4,1,8,2,1,4,6,2,12,5.225173313948629,0.8540480459631528
North CaroliNA A & T State University,10339,9347,North CaroliNA,Large City,NA,97.72,84.0,99.97,3,1,5,1,1,3,4,2,8,2.254808393737609,1.523133897287871
North CaroliNA Central University,6355,5363,North CaroliNA,Large City,NA,90.14,68.33,99.17,2,1,3,1,0,2,3,1,5,1.3374269569665778,0.9779339548373366
North CaroliNA State University,24149,21384,North CaroliNA,Large City,NA,99.98,98.59,100.0,6,3,12,3,1,6,9,4,18,5.511360944477946,3.1022018443013266
North CaroliNA Wesleyan College,2090,1754,North CaroliNA,Small City,NA,79.75,49.64,96.64,1,0,2,1,0,1,2,0,3,0.3119399984615153,1.2832563474332022
North Central College,2772,2634,Illinois,Midsize City,NA,63.73,52.1,80.8,1,0,1,0,0,1,1,0,2,0.8932179955395764,0.12067257755014198
North Central University,1081,912,Minnesota,Large City,NA,26.61,15.11,48.52,0,0,0,0,0,0,0,0,0,0.06768159120658161,0.24151198432953713
North Dakota State University - Main Campus,11981,10782,North Dakota,Midsize City,NA,99.92,87.09,100.0,5,1,17,2,1,9,7,2,26,5.531079965499621,1.5982148336130761
North Greenville University,2359,2080,South CaroliNA,Rural,NA,96.14,68.1,99.96,2,1,5,1,0,3,3,1,8,2.8564043434825455,0.3955971762345853
North Park University,2033,1812,Illinois,Large City,NA,66.16,48.58,87.14,1,0,1,0,0,1,1,0,2,0.4446771460295335,0.6379146400368914
Northcentral University,90,14,California,Large City,NA,10.75,5.21,23.96,0,0,0,0,0,0,0,0,0,0.0,0.11347028972955844
Northeastern Illinois University,7113,4164,Illinois,Large City,NA,91.79,84.47,98.06,2,1,3,1,1,1,3,2,4,2.495952448409056,0.0030742394788600587
Northeastern State University,6830,4753,Oklahoma,Town,NA,98.17,80.85,99.99,3,1,7,1,1,3,4,2,10,3.2101357849970134,0.7864754154630125
Northeastern University,13824,13786,Massachusetts,Large City,private,100.0,99.97,100.0,10,5,21,5,3,11,15,8,32,5.63616228807719,9.953960450685816
Northern ArizoNA University,27092,21990,ArizoNA,Small City,NA,100.0,100.0,100.0,33,20,61,16,10,30,49,30,91,32.392295748211446,16.746425061026116
Northern Illinois University,13456,11788,Illinois,Suburb,public,99.3,97.28,99.97,3,2,5,2,1,3,5,3,8,4.585864785593673,0.37100415354968375
Northern Kentucky University,12326,8962,Kentucky,Suburb,public,99.7,92.43,100.0,4,2,9,2,1,4,6,3,13,4.358468879514631,1.4381928110863722
Northern Michigan University,7018,6207,Michigan,Town,NA,98.92,92.36,99.99,3,2,6,1,1,3,4,3,9,3.7860401486373805,0.7381076177104904
Northern State University,3164,1346,South Dakota,Town,NA,80.03,52.28,99.09,1,1,3,1,0,2,2,1,5,0.7576170635416761,0.8519490082233487
Northland College,631,594,Wisconsin,Town,private,23.04,14.03,40.44,0,0,0,0,0,0,0,0,0,0.037071309313534535,0.22460670944314462
Northwest Christian University,604,444,Oregon,Midsize City,NA,42.62,23.85,70.81,0,0,1,0,0,0,0,0,1,0.2257892399251377,0.3291978208537188
Northwest Missouri State University,5478,4806,Missouri,Town,NA,75.1,49.19,96.46,1,0,2,0,0,1,1,0,3,0.9804896854265305,0.4092972176741737
Northwest Nazarene University,1482,1125,Idaho,Suburb,NA,78.87,36.6,99.95,1,0,5,1,0,3,2,0,8,0.6067550086611252,0.9463878808337951
Northwest University,946,929,Washington,Suburb,NA,68.57,37.88,99.79,1,0,4,0,0,2,1,0,6,0.6787244737789568,0.47718190514494585
Northwestern College - 2,1039,997,Iowa,Town,private,45.6,25.18,76.48,0,0,1,0,0,0,0,0,1,0.1713450243892169,0.4368604935382075
University of Northwestern - St Paul,3325,2033,Minnesota,Suburb,NA,56.8,35.55,94.48,1,0,2,0,0,1,1,0,3,0.2593321575524911,0.5791487882476882
Northwestern Oklahoma State University,1881,1329,Oklahoma,Town,NA,81.17,49.34,98.46,1,0,3,1,0,1,2,0,4,0.7253790906261517,0.9418886633526238
Northwestern State University of LouisiaNA,9440,5471,LouisiaNA,Town,public,100.0,99.62,100.0,9,4,21,4,2,11,13,6,32,8.640679378771743,4.572241944995878
Northwestern University,8699,8205,Illinois,Small City,NA,99.99,99.4,100.0,7,3,14,3,2,7,10,5,21,0.8644158423212337,8.928488221728175
Norwich University,3229,2542,Vermont,Town,private,96.36,80.71,99.91,2,1,5,1,1,2,3,2,7,0.00013800887824150113,3.3076981269857426
Notre Dame College,1736,1216,Ohio,Suburb,NA,43.65,25.21,69.72,0,0,1,0,0,0,0,0,1,0.5322223257951464,0.04116606161220522
Notre Dame de Namur University,922,718,California,Suburb,private,86.45,68.09,98.08,1,1,3,1,0,1,2,1,4,1.9118957021954999,0.08490308758517703
Nova Southeastern University,4501,3154,Florida,Suburb,NA,100.0,99.99,100.0,12,6,24,6,3,12,18,9,36,15.869083526828765,1.460622596891649
Nyack College,1397,1131,New York,Suburb,NA,69.14,48.41,89.69,1,0,2,0,0,1,1,0,3,0.6624432149088695,0.5123050787202128
Oakland City University,1112,572,IndiaNA,Town,NA,38.87,28.82,54.52,0,0,1,0,0,0,0,0,1,0.4488389639135686,0.0431516116939846
Oakland University,15902,12549,Michigan,Suburb,NA,100.0,99.81,100.0,7,4,15,4,2,7,11,6,22,10.849681745193164,0.22894773458818382
Oakwood University,1648,1521,Alabama,Midsize City,private,89.29,68.36,99.2,1,1,3,1,0,2,2,1,5,0.1511216091492804,2.07955742795531
Oberlin College,2828,2790,Ohio,Town,NA,95.04,79.03,99.89,2,1,4,1,1,2,3,2,6,0.06401730805554827,2.9364265101253983
Occidental College,1976,1952,California,Large City,private,96.18,83.46,99.87,2,1,4,1,1,2,3,2,6,2.2545716933183026,1.005528744478105
Oglethorpe University,1253,1166,Georgia,Suburb,NA,59.05,31.69,91.53,1,0,2,0,0,1,1,0,3,0.27872036975106285,0.612802887088003
Ohio Christian University,3988,2429,Ohio,Town,NA,90.36,69.49,99.32,2,1,3,1,0,2,3,1,5,0.9687324998405761,1.3680674288206174
Ohio Dominican University,1176,957,Ohio,Large City,NA,40.44,23.7,66.16,0,0,1,0,0,0,0,0,1,0.33420800528999467,0.18361291343468378
Ohio Northern University,2315,2092,Ohio,Town,private,67.66,44.41,90.49,1,0,2,0,0,1,1,0,3,0.577411013834357,0.5506263579849795
Ohio State University - Lima Campus,1007,844,Ohio,Rural,public,27.14,14.99,47.74,0,0,0,0,0,0,0,0,0,0.31475176460644566,0.0018649654584437215
Ohio State University - Main Campus,45943,42003,Ohio,Large City,NA,100.0,100.0,100.0,14,7,29,7,3,14,21,10,43,12.158895185883692,8.6219763082506
Ohio State University - Newark Campus,2605,2218,Ohio,Suburb,NA,56.41,34.61,81.88,1,0,1,0,0,1,1,0,2,0.811513522704156,0.018716724960050085
Ohio University - Main Campus,23167,17695,Ohio,Town,public,99.98,98.75,100.0,6,3,11,3,1,6,9,4,17,6.586251281714937,1.7905724673270293
Ohio Valley University,528,435,West Virginia,Small City,NA,29.79,16.15,54.78,0,0,1,0,0,0,0,0,1,0.004871741250313885,0.348143199402868
Ohio Wesleyan University,1557,1545,Ohio,Suburb,private,67.52,43.45,92.58,1,0,2,0,0,1,1,0,3,0.240064905208306,0.8832749830720631
Oklahoma Baptist University,1962,1835,Oklahoma,Town,NA,95.38,70.27,99.96,2,1,5,1,0,3,3,1,8,0.6108195609969705,2.458040918139896
Oklahoma Christian University,1976,1846,Oklahoma,Large City,NA,97.15,76.05,99.99,2,1,6,1,0,3,3,1,9,0.39009495003040157,3.160372176434015
Oklahoma City University,1715,1579,Oklahoma,Large City,NA,92.03,63.99,99.83,2,1,4,1,0,2,3,1,6,0.4187348324376968,2.1054702194493116
Oklahoma Panhandle State University,1136,852,Oklahoma,Rural,public,85.92,55.61,99.26,1,1,3,1,0,2,2,1,5,0.25726515058966987,1.6990067934435866
Oklahoma State University - Main Campus,20992,18221,Oklahoma,Town,NA,100.0,100.0,100.0,21,9,54,11,4,28,32,13,82,7.260210190249359,25.003235952215675
Oklahoma Wesleyan University,1005,609,Oklahoma,Town,NA,75.81,44.59,97.04,1,0,2,0,0,1,1,0,3,0.2607216881215848,1.15540522803777
Old Dominion University,19543,15036,Virginia,Midsize City,public,100.0,99.98,100.0,18,6,38,9,3,20,27,9,58,26.18948240422398,1.2203592547101731
Olivet College,1178,1032,Michigan,Rural,private,56.28,37.29,81.23,1,0,1,0,0,1,1,0,2,0.7988765473983394,0.028224357958002877
Olivet Nazarene University,3377,3113,Illinois,Suburb,NA,81.04,65.0,95.5,1,1,2,1,0,1,2,1,3,0.7119751777265911,0.9498588600292386
Oral Roberts University,3384,2866,Oklahoma,Large City,private,99.47,88.21,100.0,3,1,10,2,1,5,5,2,15,0.5239123316231089,4.703900696441512
Oregon Institute of Technology,5380,2284,Oregon,Town,NA,96.87,82.74,99.99,2,1,6,1,1,3,3,2,9,2.487824561010003,0.9725138848315804
Oregon State University,25835,18829,Oregon,Small City,NA,100.0,100.0,100.0,13,7,29,7,4,15,20,11,44,10.168801640298174,10.169493586956628
Ottawa University - Online,156,85,Kansas,Town,NA,26.45,11.66,54.21,0,0,1,0,0,0,0,0,1,0.002584943928756605,0.30374897422823355
Ottawa University - Ottawa,669,646,Kansas,Town,NA,28.86,13.08,57.15,0,0,1,0,0,0,0,0,1,0.022667969836788694,0.3170461193106994
Otterbein University,2483,2294,Ohio,Suburb,private,65.53,42.12,89.27,1,0,1,0,0,1,1,0,2,0.7038765782774253,0.3604177841162655
Ouachita Baptist University,1542,1500,Arkansas,Town,private,96.07,70.76,99.98,2,1,5,1,0,3,3,1,8,0.11966494026694008,3.1085071132122635
University of Holy Cross,912,457,LouisiaNA,Large City,private,60.37,33.39,88.73,1,0,1,0,0,1,1,0,2,0.9126615506405882,0.012417770166813566
Our Lady of the Lake University,1344,1221,Texas,Large City,NA,99.93,94.09,100.0,5,2,12,2,1,7,7,3,19,7.270912258098342,0.03516209011496123
Pace University - New York,8670,7878,New York,Large City,NA,99.95,98.75,100.0,5,3,10,3,1,5,8,4,15,3.9153687917652404,3.770087298932889
Pacific Lutheran University,2764,2655,Washington,Suburb,NA,95.77,76.7,100.0,2,1,8,1,0,5,3,1,13,2.0219486569163534,1.138343657508096
Pacific Union College,1227,1077,California,Rural,NA,93.3,78.08,99.55,2,1,4,1,1,2,3,2,6,2.4719937014789775,0.22837944375349717
Pacific University,1876,1818,Oregon,Suburb,NA,78.91,53.04,99.53,1,1,3,1,0,2,2,1,5,0.39927409170247974,1.1557513218746664
Paine College,425,328,Georgia,Midsize City,NA,22.63,10.44,50.72,0,0,0,0,0,0,0,0,0,0.09693275081342519,0.15942560249032178
Palm Beach Atlantic University,3005,2350,Florida,Midsize City,NA,99.99,99.37,100.0,6,3,13,3,2,7,9,5,20,8.272827137038341,1.0769301835118699
Park University,9864,4134,Missouri,Suburb,NA,94.97,78.25,99.88,2,1,5,1,0,2,3,1,7,1.9699413566141237,1.0179645223075044
Paul Quinn College,518,492,Texas,Large City,private,90.7,60.9,99.78,2,1,4,1,0,2,3,1,6,2.20465639678939,0.16452229391962075
Paul Smiths College of Arts and Science,768,760,New York,Rural,private,40.32,25.87,61.6,0,0,1,0,0,0,0,0,1,0.3506191159572911,0.1652580354747496
William Peace University,932,814,North CaroliNA,Large City,NA,25.87,13.83,46.19,0,0,0,0,0,0,0,0,0,0.2177265414362965,0.08154413547043443
Peirce College,1388,307,Pennsylvania,Large City,NA,64.75,47.9,84.84,1,0,1,0,0,1,1,0,2,0.9183275325215592,0.12382736209123972
Pennsylvania State University - Brandywine,1439,1245,Pennsylvania,Suburb,NA,66.23,49.97,85.35,1,0,1,0,0,1,1,0,2,0.9642439091476372,0.12080762639606972
Pennsylvania State University - University Park,40833,39785,Pennsylvania,Small City,NA,100.0,100.0,100.0,23,14,44,12,7,22,35,21,66,18.855129595468046,15.851497458399862
Pennsylvania State University - Abington,3891,3312,Pennsylvania,Suburb,NA,94.8,84.54,99.49,2,1,4,1,1,2,3,2,6,2.567012430751671,0.38803469951928016
Pennsylvania State University - AltooNA,3478,3374,Pennsylvania,Small City,NA,93.41,81.23,99.28,2,1,3,1,1,2,3,2,5,2.0296473355496025,0.6888139138266542
Pennsylvania State University - Beaver,652,563,Pennsylvania,Suburb,NA,40.22,27.32,60.86,0,0,1,0,0,0,0,0,1,0.4103776160955718,0.10377323305715941
Pennsylvania State University - Berks,2718,2411,Pennsylvania,Suburb,public,86.82,72.14,97.28,1,1,2,1,0,1,2,1,3,1.757736292717047,0.2683019551311496
Pennsylvania State University - Erie - Behrend College,4341,4138,Pennsylvania,Suburb,NA,96.37,87.45,99.74,2,1,4,1,1,2,3,2,6,2.7535477107951127,0.5600299909555789
Pennsylvania State University - Greater Allegheny,497,453,Pennsylvania,Suburb,public,32.21,21.4,50.59,0,0,0,0,0,0,0,0,0,0.31926230622819834,0.06929794815771838
Pennsylvania State University - Harrisburg,4288,3960,Pennsylvania,Suburb,public,96.81,87.06,99.83,2,1,4,1,1,2,3,2,6,2.201833747897395,1.242391235965746
Pennsylvania State University - Lehigh Valley,899,739,Pennsylvania,Suburb,public,50.31,35.91,71.15,0,0,1,0,0,0,0,0,1,0.6198710844520525,0.07907189911410087
Pennsylvania State University - New Kensington,597,484,Pennsylvania,Rural,NA,35.8,24.4,54.75,0,0,1,0,0,0,0,0,1,0.41755204994339645,0.02545243873393188
Pennsylvania State University - Schuylkill,733,595,Pennsylvania,Town,NA,43.81,29.85,64.84,0,0,1,0,0,0,0,0,1,0.3960287483999224,0.18013447303569838
Pennsylvania State University - SheNAngo,490,241,Pennsylvania,Suburb,NA,27.92,18.9,43.78,0,0,0,0,0,0,0,0,0,0.3085006554564613,0.018828620016337727
Pennsylvania State University - Wilkes - Barre,456,387,Pennsylvania,Rural,NA,28.96,19.45,45.65,0,0,0,0,0,0,0,0,0,0.30993554222602626,0.031852795635682024
Pennsylvania State University - Worthington Scranton,1030,904,Pennsylvania,Suburb,public,52.32,37.96,72.55,0,0,1,0,0,0,0,0,1,0.7282050355542051,0.012156183547206226
Pennsylvania State University - York,966,793,Pennsylvania,Suburb,NA,50.85,36.03,72.0,0,0,1,0,0,0,0,0,1,0.6134140939890103,0.09653201264976552
Pepperdine University,3603,3300,California,Suburb,NA,99.94,97.85,100.0,5,3,11,2,1,6,7,4,17,4.688752871638902,2.6888732323621967
Peru State College,2046,1105,Nebraska,Rural,public,34.76,23.1,55.67,0,0,1,0,0,0,0,0,1,0.12254590684313406,0.30418477649690456
Pfeiffer University,812,733,North CaroliNA,Rural,NA,42.3,22.64,70.65,0,0,1,0,0,0,0,0,1,0.14978171586046848,0.39949289968655666
Cairn University,770,727,Pennsylvania,Suburb,private,45.66,30.02,68.03,0,0,1,0,0,0,0,0,1,0.315675089304286,0.29384934442640837
Thomas Jefferson University,2690,2279,Pennsylvania,Large City,private,90.29,73.24,98.9,2,1,3,1,0,1,3,1,4,0.8846076934367832,1.446086440821967
Philander Smith College,893,845,Arkansas,Midsize City,private,45.84,23.35,77.31,0,0,1,0,0,1,0,0,2,0.04792336936349878,0.5642189948359517
Piedmont College,1281,1160,Georgia,Town,NA,39.31,16.34,82.33,0,0,1,0,0,1,0,0,2,0.37936939216116883,0.11978111649558569
University of Pikeville,1562,1049,Kentucky,Town,NA,61.67,32.93,89.86,1,0,2,0,0,1,1,0,3,0.6263226623140214,0.332056700406839
Pine Manor College,419,417,Massachusetts,Suburb,NA,38.29,22.27,61.51,0,0,1,0,0,0,0,0,1,0.42093674820461946,0.061426114783092046
Pittsburg State University,5709,5109,Kansas,Town,NA,54.13,26.95,84.73,1,0,1,0,0,1,1,0,2,0.20788914442423315,0.571017518364408
Pitzer College,1070,1046,California,Suburb,NA,77.97,57.28,94.96,1,1,2,1,0,1,2,1,3,1.0091217117892193,0.502221273257945
Platt College - Aurora,236,236,Colorado,Large City,private,5.29,2.4,13.37,0,0,0,0,0,0,0,0,0,0.054295407482941614,0.0
Plymouth State University,4148,3971,New Hampshire,Town,NA,89.01,60.51,99.05,1,1,3,1,0,2,2,1,5,0.4290642796547719,1.7775417534276294
Point Loma Nazarene University,3097,2571,California,Large City,private,99.86,97.61,100.0,4,2,9,2,1,4,6,3,13,5.94365598395758,0.594604229054876
Point Park University,3282,2758,Pennsylvania,Large City,private,94.25,80.59,99.63,2,1,4,1,1,2,3,2,6,1.5310241831257871,1.3227650151665407
PomoNA College,1600,1578,California,Suburb,private,90.79,71.57,99.35,2,1,3,1,0,2,3,1,5,1.2265437199498943,1.1556804160225282
Portland State University,21163,13990,Oregon,Large City,NA,100.0,99.95,100.0,10,5,25,5,3,14,15,8,39,8.656635171074774,6.1752099241847
Post University,7845,2617,Connecticut,Suburb,private,99.95,97.81,100.0,5,3,12,3,1,6,8,4,18,0.886703783900107,6.782860732420055
University of the Potomac - VA Campus,37,37,Virginia,Suburb,NA,5.21,1.61,10.87,0,0,0,0,0,0,0,0,0,0.05349513354070262,0.0
Prairie View A & M University,7977,7341,Texas,Town,NA,100.0,100.0,100.0,27,11,69,14,5,38,41,16,107,40.66366242967097,0.8105835543475661
Pratt Institute - Main,3642,3537,New York,Large City,NA,98.75,89.79,99.99,3,2,6,1,1,3,4,3,9,0.7188057867850938,3.6556685604988286
Presbyterian College,1014,975,South CaroliNA,Town,NA,75.04,40.38,96.33,1,0,2,0,0,1,1,0,3,1.0441607670289867,0.34225953935495024
Prescott College,386,291,ArizoNA,Small City,NA,35.93,20.18,73.16,0,0,1,0,0,0,0,0,1,0.07372257621246779,0.37093468464644963
Presentation College,762,475,South Dakota,Town,private,21.38,10.79,39.9,0,0,0,0,0,0,0,0,0,0.14504497701059166,0.09545445702775321
Princeton University,5397,5260,New Jersey,Suburb,private,99.94,97.56,100.0,5,2,11,2,1,6,7,3,17,0.9456492358101136,6.413040977868778
Principia College,456,441,Illinois,Rural,private,45.77,27.05,73.1,0,0,1,0,0,0,0,0,1,0.012644847754394317,0.598222975163144
Providence Christian College,165,161,California,Midsize City,private,25.15,15.3,43.57,0,0,0,0,0,0,0,0,0,0.24578140052945857,0.0436067506383349
Providence College,4076,3826,Rhode Island,Midsize City,private,97.09,85.24,99.9,2,1,5,1,1,2,3,2,7,0.13329071176098858,3.400261968182637
Purdue University - Main Campus,32130,30277,IndiaNA,Small City,NA,100.0,100.0,100.0,13,8,25,7,4,13,20,12,38,9.76861553261204,10.152390928767336
Queens University of Charlotte,1717,1449,North CaroliNA,Large City,private,67.6,41.93,91.37,1,0,2,0,0,1,1,0,3,0.26470697845155305,0.8611810062080639
Quincy University,992,874,Illinois,Town,NA,61.49,42.8,85.22,1,0,1,0,0,1,1,0,2,0.22058234415998976,0.7319773497126274
Quinnipiac University,7311,6959,Connecticut,Suburb,private,99.74,96.18,100.0,4,2,8,2,1,4,6,3,12,0.4512982484806786,5.5085313783954595
Radford University,8419,8049,Virginia,Small City,NA,100.0,97.45,100.0,8,2,17,4,1,9,12,3,26,11.36410134134926,0.43109007630012697
Ramapo College of New Jersey,5616,4910,New Jersey,Suburb,NA,99.8,95.22,100.0,4,2,9,2,1,4,6,3,13,6.138876970383427,0.0860690811674645
Randolph College,666,645,Virginia,Small City,NA,54.52,24.61,81.51,1,0,1,0,0,1,1,0,2,0.5841090256876719,0.2032265387047425
Randolph - Macon College,1452,1428,Virginia,Suburb,private,83.63,46.48,97.84,1,0,3,1,0,1,2,0,4,1.5166593265999202,0.2914740722114154
Reed College,1446,1408,Oregon,Large City,NA,89.43,68.42,99.54,1,1,3,1,0,2,2,1,5,0.051786522918609565,2.1920814479620874
Regent University,4280,2263,Virginia,Large City,NA,99.66,89.34,100.0,4,2,8,2,1,4,6,3,12,2.7499390268761186,2.9146642261837576
Regis University,4084,2378,Colorado,Large City,NA,90.77,68.33,99.8,2,1,4,1,0,2,3,1,6,0.5972494823123577,1.78313904831804
Reinhardt University,1408,1260,Georgia,Rural,NA,41.79,17.85,84.75,0,0,1,0,0,1,0,0,2,0.4217968262232751,0.11892663099559908
Rensselaer Polytechnic Institute,6366,6340,New York,Small City,NA,99.73,95.79,100.0,4,2,8,2,1,4,6,3,12,1.547408791510884,4.375459232787652
Rhode Island College,7079,5461,Rhode Island,Suburb,public,95.34,86.89,99.33,2,1,3,1,1,2,3,2,5,1.809580091574183,1.2547134892554308
Rhodes College,1984,1979,Tennessee,Large City,NA,93.19,67.08,99.87,2,1,4,1,0,2,3,1,6,0.1300241652700116,2.5521458113812665
Rice University,4004,3916,Texas,Large City,NA,100.0,99.71,100.0,9,4,23,5,2,12,14,6,35,11.758167449543414,2.4396144935618143
Rider University,4092,3711,New Jersey,Suburb,private,98.58,88.46,99.99,3,1,6,1,1,3,4,2,9,3.360192012078828,0.891721661705471
Ripon College,759,739,Wisconsin,Town,NA,22.11,13.7,38.46,0,0,0,0,0,0,0,0,0,0.07205409415870093,0.17755991853788738
Rivier University,1427,908,New Hampshire,Small City,private,61.1,33.91,85.99,1,0,1,0,0,1,1,0,2,0.14288838336410079,0.800851465965462
Roanoke College,2036,1973,Virginia,Suburb,NA,89.7,58.37,99.14,2,1,3,1,0,2,3,1,5,1.4819597805194644,0.7896288734733397
Robert Morris University,4245,3840,Pennsylvania,Suburb,NA,95.18,85.33,99.54,2,1,4,1,1,2,3,2,6,2.6007322698364472,0.4302359590249696
Roberts Wesleyan College,1322,1248,New York,Suburb,NA,62.27,44.58,82.66,1,0,1,0,0,1,1,0,2,0.807375542590589,0.16703931948228426
Rochester College,1152,762,Michigan,Suburb,NA,55.17,36.56,80.13,1,0,1,0,0,1,1,0,2,0.7492054667310851,0.05284585800110193
Rochester Institute of Technology,13510,12447,New York,Suburb,private,100.0,99.83,100.0,8,4,15,4,2,8,12,6,23,5.128994040736407,6.453553845442108
Rockford University,1059,918,Illinois,Midsize City,NA,40.72,26.6,66.14,0,0,1,0,0,0,0,0,1,0.2869677948705599,0.2354119782941499
Rockhurst University,2208,1445,Missouri,Large City,NA,47.76,27.13,77.75,0,0,1,0,0,0,0,0,1,0.36283931540734754,0.28603243947426754
Rocky Mountain College,898,868,MontaNA,Midsize City,private,96.44,18.49,100.0,2,0,27,1,0,18,3,0,45,2.88283422448272,0.4429220311110981
Roger Williams University,4704,4042,Rhode Island,Suburb,private,97.68,86.97,99.93,3,1,5,1,1,2,4,2,7,0.12503938198530834,3.635762329168407
Rollins College,2614,2453,Florida,Suburb,private,99.94,98.08,100.0,5,3,10,2,1,5,7,4,15,6.2851089416754915,1.0467400708365977
Roosevelt University,2576,2117,Illinois,Large City,NA,77.15,58.85,94.45,1,1,2,0,0,1,1,1,3,0.6171388195686337,0.8574003412971403
Rosemont College,634,520,Pennsylvania,Suburb,NA,40.1,26.78,61.01,0,0,1,0,0,0,0,0,1,0.3515472585434094,0.16062507623586053
Rowan University,15399,13634,New Jersey,Suburb,NA,100.0,99.98,100.0,12,6,24,5,3,12,17,9,36,16.716927249155088,0.33930720130020686
Rust College,862,792,Mississippi,Town,NA,57.95,31.04,86.69,1,0,1,0,0,1,1,0,2,0.5466687346312169,0.3186940786247784
Rutgers University - Camden,5489,4493,New Jersey,Small City,NA,99.79,95.11,100.0,4,2,9,2,1,4,6,3,13,5.858767599586592,0.30479127389060456
Rutgers University - New Brunswick,35638,33677,New Jersey,Small City,NA,100.0,100.0,100.0,27,13,57,13,6,28,40,19,85,36.94978732055205,3.22699423331359
Rutgers University - Newark,8549,7162,New Jersey,Large City,NA,99.99,99.1,100.0,7,3,14,3,2,7,10,5,21,9.162937737506054,0.47459461019820504
Sacred Heart University,5605,4982,Connecticut,Suburb,NA,98.53,91.0,99.97,3,2,5,1,1,3,4,3,8,0.4271851665946436,3.787950108047946
SagiNAw Valley State University,7850,6559,Michigan,Suburb,public,99.55,95.23,100.0,4,2,7,2,1,4,6,3,11,5.35067918965589,0.04062989955333784
Saint Ambrose University,2369,2215,Iowa,Midsize City,private,58.11,41.16,83.49,1,0,1,0,0,1,1,0,2,0.2517164430148975,0.6180882834424591
Saint Anselm College,1965,1926,New Hampshire,Suburb,NA,80.74,55.57,96.4,1,1,2,1,0,1,2,1,3,0.08860676286824128,1.5572462370623805
Saint Augustine's University,972,961,North CaroliNA,Large City,private,47.23,25.95,73.5,0,0,1,0,0,0,0,0,1,0.12730182933166292,0.5115336148616485
St. BoNAventure University,1621,1586,New York,Town,NA,72.04,53.1,90.38,1,1,2,0,0,1,1,1,3,0.9296164452312312,0.34410718591461803
Saint Cloud State University,13133,8373,Minnesota,Small City,NA,87.74,72.45,98.75,1,1,3,1,0,1,2,1,4,1.3139799828186853,0.7839543385259733
Saint Edward's University,3941,3528,Texas,Large City,NA,100.0,99.96,100.0,13,5,34,7,3,19,20,8,53,20.175946419102903,0.2882677181720972
Saint Francis University,2119,1526,Pennsylvania,Town,private,79.77,63.07,94.46,1,1,2,1,0,1,2,1,3,1.3244004883084362,0.2728803295759157
St. John Fisher College,2746,2624,New York,Suburb,NA,87.07,71.3,97.39,1,1,2,1,0,1,2,1,3,1.9639062382325931,0.08054962127913767
Saint Johns University,1724,1703,Minnesota,Rural,NA,36.62,21.57,71.47,0,0,1,0,0,0,0,0,1,0.16772273107085542,0.2877860617510537
University of Saint Joseph,808,654,Connecticut,Small City,NA,26.49,19.31,38.86,0,0,0,0,0,0,0,0,0,0.19126058132332344,0.11634128293975673
St. Joseph's College - New York,928,798,New York,Large City,NA,51.31,35.41,72.54,0,0,1,0,0,0,0,0,1,0.6653711407206214,0.053933836485177515
Saint Joseph's College of Maine,1537,960,Maine,Rural,private,51.72,26.66,79.52,0,0,1,0,0,1,0,0,2,0.14357596463129055,0.5841102251862278
Saint Joseph's University,5143,4481,Pennsylvania,Large City,NA,98.71,91.09,99.98,3,2,6,1,1,3,4,3,9,1.3739040818584265,2.9774622349014117
Saint Leo University,9672,6732,Florida,Suburb,private,100.0,100.0,100.0,23,13,47,12,6,24,35,19,71,32.116113471085676,2.2491042422626477
Saint Louis University,9900,6625,Missouri,Large City,NA,99.36,93.47,100.0,3,2,7,2,1,4,5,3,11,0.8264404166688049,4.221499152875636
Saint Martin's University,1318,1121,Washington,Suburb,NA,72.63,51.64,93.53,1,0,2,0,0,1,1,0,3,1.1237563892208478,0.17135000333093042
Saint Mary - of - the - Woods College,662,491,IndiaNA,Rural,private,30.66,20.15,49.51,0,0,0,0,0,0,0,0,0,0.21563594058861268,0.15024007694948055
Saint Mary's College,1533,1486,IndiaNA,Suburb,NA,68.42,47.76,90.13,1,0,2,0,0,1,1,0,3,0.19104202475773222,0.9603857871414405
Saint Mary's College of California,2776,2614,California,Suburb,NA,99.79,96.99,100.0,4,2,8,2,1,4,6,3,12,5.806585587508459,0.3549861703433448
Saint Mary's University of Minnesota,1501,1129,Minnesota,Town,NA,28.84,19.56,46.43,0,0,0,0,0,0,0,0,0,0.11337236237466111,0.22662110252517895
Saint Michael's College,1790,1766,Vermont,Suburb,private,67.58,44.18,89.12,1,0,1,0,0,1,1,0,2,0.00014878434621230904,1.1255679894224337
Saint Norbert College,2068,2021,Wisconsin,Suburb,private,46.83,33.17,68.69,0,0,1,0,0,0,0,0,1,0.18313748932003154,0.4480359574461951
Saint Peter's University,2633,2387,New Jersey,Large City,NA,93.53,75.17,99.65,2,1,4,1,0,2,3,1,6,2.1893348421480594,0.5473936586932003
St. Thomas AquiNAs College,1777,1091,New York,Suburb,NA,77.17,57.14,93.81,1,1,2,0,0,1,1,1,3,0.9647515549722541,0.5116935500957052
St. Thomas University,2907,935,Florida,Suburb,NA,100.0,99.9,100.0,8,5,18,4,2,9,12,7,27,12.346249635986155,0.3024120741796493
Saint Vincent College,1667,1617,Pennsylvania,Suburb,NA,75.94,57.58,92.93,1,1,2,0,0,1,1,1,3,0.9642439091476372,0.45937519146983646
Saint Xavier University,2942,2638,Illinois,Large City,NA,65.54,53.86,82.29,1,1,1,0,0,1,1,1,2,0.9638183955016113,0.10114449594112761
Salem College,817,673,North CaroliNA,Midsize City,private,47.58,24.69,77.98,0,0,1,0,0,1,0,0,2,0.13588965115165605,0.5090536537307413
Salem InterNAtioNAl University,892,892,West Virginia,Rural,private,64.66,39.35,90.22,1,0,2,0,0,1,1,0,3,0.0032769559979689807,1.0350873907618805
Salem State University,7110,5792,Massachusetts,Suburb,NA,99.99,98.95,100.0,6,3,12,3,2,6,9,5,18,8.75445138904086,0.21158357479224962
Salisbury University,7783,7191,Maryland,Suburb,public,99.52,95.57,100.0,4,2,7,2,1,3,6,3,10,4.17128226413518,1.1581137911311568
Salve RegiNA University,2180,2087,Rhode Island,Suburb,NA,79.96,58.84,95.4,1,1,2,1,0,1,2,1,3,0.09774652195805829,1.5088427550780226
Sam Houston State University,18416,14808,Texas,Town,public,100.0,100.0,100.0,67,26,170,35,13,93,102,39,263,101.33068454031235,0.2426891908530003
Samford University,3375,3266,Alabama,Suburb,private,96.29,76.21,99.97,2,1,5,1,0,3,3,1,8,0.6591227106741692,2.629284562022879
San Diego Christian College,656,504,California,Suburb,private,74.95,54.57,93.59,1,1,2,0,0,1,1,1,3,1.2525398296212793,0.13028806517612954
San Diego State University,30267,27060,California,Large City,NA,100.0,100.0,100.0,46,26,92,23,13,46,69,39,138,65.33058688688801,3.8699753612610563
San Francisco State University,26676,22263,California,Large City,public,100.0,100.0,100.0,42,24,82,21,12,41,63,36,123,62.48992108461484,0.12326178223456184
San Jose State University,27777,23097,California,Large City,NA,100.0,100.0,100.0,44,25,85,22,13,43,66,38,128,65.47947369682412,0.05216536528506788
Santa Clara University,5498,5411,California,Midsize City,private,100.0,99.64,100.0,7,4,14,3,2,7,10,6,21,7.964262690233417,2.289116492999851
Sarah Lawrence College,1401,1384,New York,Suburb,NA,83.23,61.3,98.23,1,1,3,1,0,1,2,1,4,0.20202688101088173,1.5817195026672142
SavanNAh State University,4237,3687,Georgia,Midsize City,NA,82.87,47.16,99.73,1,0,4,1,0,2,2,0,6,1.2102657833190595,0.5528934184159598
Schreiner University,1249,1137,Texas,Town,NA,99.89,92.81,100.0,4,2,11,2,1,6,6,3,17,6.75871935783414,0.04050941897594366
Scripps College,1064,1060,California,Suburb,NA,81.22,59.46,97.6,1,1,2,1,0,1,2,1,3,1.0209381252762126,0.6493609682305053
Seattle Pacific University,2898,2783,Washington,Large City,private,96.11,81.48,99.99,2,1,6,1,1,3,3,2,9,1.7110359488679092,1.534114566317653
Seattle University,4563,4325,Washington,Large City,private,99.71,94.95,100.0,4,2,10,2,1,6,6,3,16,1.978258309053337,3.8480645687467354
Seton Hall University,5972,5554,New Jersey,Suburb,NA,99.82,95.97,100.0,4,2,9,2,1,4,6,3,13,4.583709743719401,1.7594200060448795
Seton Hill University,2091,1551,Pennsylvania,Suburb,NA,80.82,63.4,95.21,1,1,2,1,0,1,2,1,3,1.150779189191079,0.49975595341822454
Sewanee - The University of the South,1700,1687,Tennessee,Rural,NA,86.89,56.98,99.25,1,1,3,1,0,2,2,1,5,0.10083006023768823,1.9274352936542654
Shaw University,1545,1466,North CaroliNA,Large City,private,58.66,35.06,84.34,1,0,1,0,0,1,1,0,2,0.25030974775332926,0.6323244596073149
Shawnee State University,3408,2832,Ohio,Town,public,68.26,43.77,90.98,1,0,2,0,0,1,1,0,3,0.9699877411749985,0.17727961311457038
SheNAndoah University,2060,1991,Virginia,Small City,NA,92.23,61.94,99.53,2,1,4,1,0,2,3,1,6,1.830401055744041,0.7226865930704548
Shepherd University,3419,2614,West Virginia,Town,NA,72.49,43.78,92.7,1,0,2,0,0,1,1,0,3,0.04489429717217504,1.2448101179602302
Shippensburg University of Pennsylvania,5573,5160,Pennsylvania,Town,NA,98.27,92.41,99.92,3,2,5,1,1,2,4,3,7,3.7063125257862306,0.34654128629562325
Shorter University,1402,1140,Georgia,Small City,NA,52.57,26.2,89.58,1,0,2,0,0,1,1,0,3,0.3744143633655944,0.3707726889928319
Shorter University - College of Adult & ProfessioNAl Programs,113,56,Georgia,Small City,NA,3.44,1.08,12.67,0,0,0,0,0,0,0,0,0,0.034994890868744556,0.0
SieNA College,3161,3039,New York,Suburb,NA,90.89,75.72,98.76,2,1,3,1,0,1,3,1,4,1.8445932614037028,0.5503066184724027
SieNA Heights University,2301,1290,Michigan,Town,NA,78.53,57.84,95.54,1,1,2,1,0,1,2,1,3,1.459087994600594,0.07884704968137371
Sierra Nevada College,452,410,Nevada,Town,private,57.23,30.64,92.89,1,0,2,0,0,1,1,0,3,0.21506645095493152,0.6330314598197481
Silver Lake College of the Holy Family,393,267,Wisconsin,Town,NA,10.94,6.42,20.68,0,0,0,0,0,0,0,0,0,0.046208603862645165,0.06952124482904264
Simmons College,1743,1553,Massachusetts,Large City,NA,83.33,59.62,97.35,1,1,2,1,0,1,2,1,3,1.3661076061364645,0.424101736534276
Simpson College,1433,1280,Iowa,Town,NA,42.45,20.16,79.17,0,0,1,0,0,1,0,0,2,0.42921757606480476,0.12309190491931177
Simpson University,779,619,California,Small City,NA,80.7,60.37,96.26,1,1,2,1,0,1,2,1,3,1.4297860319261773,0.2131828627669794
Skidmore College,2682,2636,New York,Suburb,private,91.01,73.87,99.06,2,1,3,1,0,2,3,1,5,0.6273081051678465,1.780011250971233
Slippery Rock University of Pennsylvania,7613,7125,Pennsylvania,Town,NA,99.55,96.66,99.99,4,2,6,2,1,3,6,3,9,4.670556434933868,0.7268886852456498
Smith College,2526,2505,Massachusetts,Suburb,private,95.24,79.04,99.88,2,1,4,1,1,2,3,2,6,0.705004492391786,2.3360383517613137
Soka University of America,409,412,California,Suburb,NA,55.47,36.14,80.66,1,0,1,0,0,1,1,0,2,0.6617191552716193,0.14616695677825375
Sonoma State University,8670,7887,California,Suburb,NA,100.0,100.0,100.0,14,8,27,7,4,13,21,12,40,20.378586699668475,0.048468598676818415
South CaroliNA State University,2523,2281,South CaroliNA,Town,NA,97.23,73.81,99.98,2,1,6,1,0,3,3,1,9,2.803964954887294,0.7782207808989793
South College,1410,1410,Tennessee,Midsize City,NA,29.25,5.48,68.97,0,0,1,0,0,0,0,0,1,0.34591334534097423,0.0
South Dakota State University,10886,8425,South Dakota,Town,NA,97.73,85.36,99.96,3,1,5,1,1,3,4,2,8,2.483760263896013,1.2978512372078603
South University - Columbia,806,556,South CaroliNA,Suburb,NA,71.18,34.17,94.79,1,0,2,0,0,1,1,0,3,1.2431219766992072,0.0
South University - SavanNAh,499,396,Georgia,Midsize City,NA,50.96,27.15,84.1,0,0,1,0,0,1,0,0,2,0.02167825098063822,0.6897066058428356
South University - Tampa,543,424,Florida,Large City,private,92.11,75.17,99.51,2,1,4,1,0,2,3,1,6,2.533640798314619,0.0
South University - West Palm Beach,699,535,Florida,Suburb,NA,96.04,82.98,99.88,2,1,4,1,1,2,3,2,6,3.2195435558694054,0.002207957523453027
Southeast Missouri State University,10462,7779,Missouri,Small City,NA,94.02,78.34,99.78,2,1,4,1,1,2,3,2,6,2.1302882369877314,0.6853941402163445
Southeastern LouisiaNA University,13317,8998,LouisiaNA,Small City,NA,100.0,99.78,100.0,9,4,22,5,2,11,14,6,33,13.281573572521312,0.7530871185535011
Southeastern Oklahoma State University,3122,2374,Oklahoma,Town,NA,99.38,86.4,100.0,3,1,8,2,1,4,5,2,12,1.1515207892036663,3.915784044824358
Southeastern University,6241,4288,Florida,Midsize City,private,100.0,100.0,100.0,14,8,31,7,4,16,21,12,47,19.153951154846247,2.1000547214043808
Southern Adventist University,2596,2173,Tennessee,Suburb,NA,97.1,82.01,99.98,2,1,5,1,1,3,3,2,8,0.15185841189082486,3.381545394444213
Southern Arkansas University Main Campus,3478,2924,Arkansas,Town,public,97.8,75.72,100.0,3,1,6,1,0,3,4,1,9,0.38109122463908013,3.4282506532183237
Southern Connecticut State University,7944,6814,Connecticut,Midsize City,NA,93.36,86.55,98.4,2,1,3,1,1,1,3,2,4,2.0137163497780857,0.6978844977406715
Southern Illinois University Carbondale,10990,9455,Illinois,Small City,NA,98.85,95.42,99.95,3,2,5,1,1,3,4,3,8,3.497354141402895,0.9645098758627026
Southern Illinois University Edwardsville,11408,9550,Illinois,Suburb,NA,98.25,94.62,99.87,3,2,4,1,1,2,4,3,6,3.691944298512185,0.3553677582220577
Southern Methodist University,6454,6240,Texas,Suburb,NA,100.0,99.99,100.0,15,6,36,8,3,19,23,9,55,17.676222373248265,4.661621928546822
Southern Nazarene University,1517,1483,Oklahoma,Suburb,NA,93.4,65.92,99.9,2,1,5,1,0,2,3,1,7,0.4656449846565426,2.246965835018107
Southern New Hampshire University,70662,19935,New Hampshire,Suburb,NA,100.0,100.0,100.0,35,17,71,18,8,36,53,25,107,4.65365113361378,48.08740752885036
Southern Oregon University,5522,3640,Oregon,Suburb,public,99.43,92.9,100.0,3,2,9,2,1,5,5,3,14,1.8461895420484309,3.3204327958150266
Southern University and A & M College,5152,4530,LouisiaNA,Midsize City,NA,99.9,94.74,100.0,5,2,11,2,1,6,7,3,17,4.279504720677121,2.62674844296608
Southern University at New Orleans,2108,1520,LouisiaNA,Large City,NA,89.75,63.06,99.55,2,1,4,1,0,2,3,1,6,2.0846251525817463,0.19217794006320343
Southern Utah University,8549,6279,Utah,Town,public,100.0,92.62,100.0,8,2,26,4,1,13,12,3,39,6.634262769750821,4.805509433176635
Southern Virginia University,908,853,Virginia,Town,NA,71.46,37.56,98.02,1,0,3,0,0,1,1,0,4,0.20819727648273453,1.0438956075380643
Southern Wesleyan University,1360,820,South CaroliNA,Suburb,NA,86.15,51.61,99.06,1,0,3,1,0,2,2,0,5,1.4174058270304857,0.5574635187510218
Southwest Baptist University,2827,1835,Missouri,Town,private,80.78,52.16,98.23,1,0,3,1,0,1,2,0,4,0.4805562094580624,1.1661017241205838
Southwest Minnesota State University,6711,1932,Minnesota,Town,public,73.94,53.8,93.09,1,1,2,0,0,1,1,1,3,0.6288462994429695,0.715064770939915
Southwestern Adventist University,802,652,Texas,Town,private,95.8,71.62,99.97,2,1,5,1,0,3,3,1,8,2.9005706634527075,0.2616607240753119
Southwestern Assemblies of God University,1788,1492,Texas,Suburb,private,99.86,92.45,100.0,4,2,11,2,1,6,6,3,17,5.973728065037918,0.5499130833726241
Southwestern Christian University,620,539,Oklahoma,Suburb,NA,39.94,18.73,71.83,0,0,1,0,0,0,0,0,1,0.2710913007173297,0.2381520594895255
Southwestern College - Winfield,1148,577,Kansas,Town,NA,64.87,33.89,93.06,1,0,2,0,0,1,1,0,3,0.030721064384068887,1.0130195786550007
Southwestern Oklahoma State University,4626,3713,Oklahoma,Town,public,97.47,77.5,99.99,2,1,6,1,0,3,3,1,9,2.0828107585167515,1.589499725582758
Southwestern University,1398,1367,Texas,Suburb,NA,99.92,93.68,100.0,5,2,12,2,1,6,7,3,18,7.014815807966241,0.0987796600820805
Spalding University,1250,916,Kentucky,Large City,NA,47.22,24.6,77.64,0,0,1,0,0,0,0,0,1,0.5715852195571658,0.06720440518221875
Spelman College,2139,2086,Georgia,Large City,NA,91.76,68.8,99.7,2,1,4,1,0,2,3,1,6,0.16568377535202067,2.3267033003364235
Spring Arbor University,1958,1380,Michigan,Suburb,NA,73.57,52.55,93.32,1,0,2,0,0,1,1,0,3,1.1700299001619894,0.16019271241834415
Spring Hill College,1376,1363,Alabama,Midsize City,NA,80.66,53.73,97.55,1,1,2,1,0,1,2,1,3,0.3481609380016114,1.2927722222705667
Springfield College,2230,2188,Massachusetts,Midsize City,private,83.87,63.16,97.03,1,1,2,1,0,1,2,1,3,1.057506738587679,0.7660195512021476
St. Andrews University,641,567,North CaroliNA,Town,NA,46.09,23.69,85.08,0,0,1,0,0,1,0,0,2,0.06238799969230306,0.554633356577962
St Catherine University,3157,2124,Minnesota,Large City,private,49.81,33.37,82.94,0,0,1,0,0,1,0,0,2,0.3174426146490511,0.3713869406518312
St. Francis College,2286,2097,New York,Large City,NA,82.15,64.85,95.42,1,1,2,1,0,1,2,1,3,1.5752240867225271,0.14700498736775755
St John's College MD,466,458,Maryland,Suburb,NA,44.36,24.54,72.59,0,0,1,0,0,0,0,0,1,0.05842132022598292,0.5270223883305613
St. John's College,319,309,New Mexico,Rural,NA,32.69,17.64,59.29,0,0,1,0,0,0,0,0,1,0.02167671697581889,0.37361601898523605
St John's University - New York,16760,11526,New York,Large City,NA,100.0,99.99,100.0,11,6,21,5,3,11,16,9,32,8.528315908180373,7.61975075572669
St Lawrence University,2411,2372,New York,Town,private,81.78,61.5,96.07,1,1,2,1,0,1,2,1,3,0.7656525997731243,0.9358520301443407
St Mary's College of Maryland,1574,1516,Maryland,Suburb,NA,67.01,47.31,87.72,1,0,1,0,0,1,1,0,2,0.8776180549503212,0.23086680580555066
St. Mary's University,2323,2228,Texas,Large City,NA,100.0,99.14,100.0,8,3,20,4,2,11,12,5,31,12.025398527942128,0.18955878269304888
St Olaf College,3039,3003,Minnesota,Town,NA,74.75,51.77,97.01,1,0,2,0,0,1,1,0,3,0.17831934383552225,1.1963875906350265
Stanford University,7064,7064,California,Suburb,NA,100.0,99.87,100.0,8,4,19,4,2,10,12,6,29,7.007133197786968,5.735070054225319
SUNY New Paltz,6733,6235,New York,Suburb,NA,99.31,95.15,99.99,3,2,6,2,1,3,5,3,9,4.667113743932544,0.3082952722992406
Stephen F Austin State University,10988,9567,Texas,Town,NA,100.0,100.0,100.0,40,15,101,21,8,55,61,23,156,60.07131949837757,0.20803223113888208
Stephens College,654,542,Missouri,Midsize City,NA,28.93,14.3,66.76,0,0,1,0,0,0,0,0,1,0.108028260795512,0.23296400599485853
Sterling College Kansas,698,599,Kansas,Rural,private,54.57,29.05,85.28,1,0,1,0,0,1,1,0,2,0.01804489704112784,0.7692545581085933
Sterling College Vermont,155,120,Vermont,Rural,private,14.34,8.02,26.86,0,0,0,0,0,0,0,0,0,4.144410758003037e-06,0.1546110466777113
Stetson University,3068,3028,Florida,Suburb,private,100.0,99.9,100.0,8,5,18,4,2,9,12,7,27,12.19693747107627,0.45458327271790416
Stevens Institute of Technology,3125,3113,New Jersey,Suburb,NA,96.62,81.75,99.92,2,1,5,1,1,2,3,2,7,2.32378734013054,1.0606975096833573
Stevenson University,3401,2926,Maryland,Rural,NA,90.0,74.29,98.59,2,1,3,1,0,1,3,1,4,1.8928507753218464,0.4084717106254616
Stillman College,675,552,Alabama,Midsize City,NA,36.82,16.4,68.21,0,0,1,0,0,0,0,0,1,0.2487694181380462,0.21006771807580354
Stonehill College,2494,2482,Massachusetts,Suburb,private,90.68,71.12,99.08,2,1,3,1,0,2,3,1,5,1.704406465122999,0.6667041569395068
Stony Brook University,17369,16212,New York,Suburb,NA,100.0,99.97,100.0,9,5,17,4,3,8,13,8,25,11.31277335515644,2.1202324344696444
Stratford University,1979,471,Virginia,Suburb,NA,91.63,57.95,99.47,2,1,3,1,0,2,3,1,5,2.0270318168666237,0.4514888273634705
Strayer University - District of Columbia,691,107,District of Columbia,Large City,NA,34.6,21.7,53.0,0,0,1,0,0,0,0,0,1,0.2039068959058902,0.2206405296073783
Suffolk University,5028,4762,Massachusetts,Large City,private,99.65,94.48,100.0,4,2,8,2,1,4,6,3,12,4.133185677923273,1.5232347446339496
Sul Ross State University,2292,1378,Texas,Town,NA,100.0,99.19,100.0,8,3,21,4,2,11,12,5,32,12.409543203140279,0.044368643797238524
Sullivan University,2596,1321,Kentucky,Large City,NA,70.67,42.18,94.35,1,0,2,0,0,1,1,0,3,0.960010534504853,0.26625724457416017
Summit Christian College,32,17,Nebraska,Town,NA,0.34,0.2,0.72,0,0,0,0,0,0,0,0,0,0.0006466802471933196,0.0027529547279413437
University at Albany,13510,12740,New York,Small City,public,100.0,99.78,100.0,7,4,12,3,2,6,10,6,18,9.386930152476621,0.7133682300134015
Binghamton University,13739,13345,New York,Suburb,public,100.0,99.83,100.0,7,4,13,4,2,6,11,6,19,8.599318109115357,2.1368119507135592
SUNY Fredonia,4393,4281,New York,Town,NA,96.06,86.21,99.68,2,1,4,1,1,2,3,2,6,3.167283746862628,0.06631085187379858
SUNY Geneseo,5558,5452,New York,Town,NA,98.32,91.76,99.93,3,2,5,1,1,2,4,3,7,3.9819791039825967,0.10107848608724256
Purchase College,4062,3712,New York,Suburb,public,96.35,85.67,99.79,2,1,4,1,1,2,3,2,6,2.350392445383845,0.9584918689249153
The College at Brockport,7182,6419,New York,Town,NA,99.51,96.13,99.99,4,2,6,2,1,3,6,3,9,5.154613391589236,0.1682665950493724
Buffalo State,8527,7665,New York,Large City,NA,99.82,97.9,100.0,4,3,8,2,1,4,6,4,12,6.096673521520413,0.23874685358460374
SUNY Cortland,6345,6196,New York,Town,public,99.1,94.21,99.99,3,2,6,2,1,3,5,3,9,4.4423954378805846,0.2668816155819968
SUNY Old Westbury,4634,4056,New York,Suburb,public,96.53,87.27,99.74,2,1,4,1,1,2,3,2,6,3.3400313697559905,0.019045747519427093
SUNY Oneonta,5940,5828,New York,Town,NA,98.71,93.04,99.96,3,2,5,1,1,3,4,3,8,4.293071221481237,0.05772667241861886
SUNY Oswego,7123,6836,New York,Town,NA,99.47,95.89,99.99,4,2,6,2,1,3,6,3,9,5.132653948001097,0.09671660183202445
SUNY Plattsburgh,5353,4894,New York,Town,public,97.87,90.42,99.89,3,2,5,1,1,2,4,3,7,3.7287135212660565,0.11680965845626028
SUNY Potsdam,3323,3196,New York,Town,public,91.19,77.28,98.67,2,1,3,1,0,1,3,1,4,2.348928482477969,0.07995689739564797
SUNY College of Environmental Science and Forestry,1791,1737,New York,Midsize City,NA,76.8,57.37,93.45,1,1,2,0,0,1,1,1,3,1.1060239753892838,0.354117045520207
SUNY Empire State College,9810,3772,New York,Suburb,NA,99.94,98.8,100.0,5,3,9,2,1,4,7,4,13,6.7400852186528954,0.6237170556898343
SUNY Polytechnic Institute,2179,1859,New York,Suburb,NA,79.72,62.42,94.05,1,1,2,1,0,1,2,1,3,1.5949875859518525,0.0
SUNY Maritime College,1640,1581,New York,Large City,public,76.55,56.34,93.64,1,1,2,0,0,1,1,1,3,0.8827696322432006,0.5664554069975286
SusquehanNA University,2354,2283,Pennsylvania,Town,NA,86.22,67.2,97.82,1,1,3,1,0,1,2,1,4,0.8049714777259293,1.1759962709730356
Swarthmore College,1581,1573,Pennsylvania,Suburb,NA,84.36,61.1,98.65,1,1,3,1,0,1,2,1,4,0.15066311080431832,1.7023992761152986
Sweet Briar College,320,314,Virginia,Suburb,NA,33.13,13.79,69.17,0,0,1,0,0,0,0,0,1,0.22988449278301937,0.1720748786206655
Syracuse University,15248,14675,New York,Midsize City,NA,100.0,99.97,100.0,10,6,20,5,3,10,15,9,30,4.65393807777966,10.492924174865687
Tabor College,712,554,Kansas,Town,private,59.44,33.69,88.22,1,0,1,0,0,1,1,0,2,0.01565879495304482,0.884897253152273
Talladega College,782,762,Alabama,Town,NA,50.48,28.23,79.82,0,0,1,0,0,1,0,0,2,0.25923168338684255,0.4426628395232035
Tarleton State University,11290,8429,Texas,Town,NA,100.0,100.0,100.0,41,16,104,21,8,57,62,24,161,61.98647556023502,0.1307156969943707
Taylor University,2111,1840,IndiaNA,Town,NA,69.81,50.45,90.11,1,0,2,0,0,1,1,0,3,0.33333539492211206,0.8635029490180826
Temple University,29583,26643,Pennsylvania,Large City,NA,100.0,100.0,100.0,15,9,28,8,5,14,23,14,42,16.12597495975554,6.777756714069433
Tennessee State University,6504,5431,Tennessee,Large City,NA,92.8,59.84,99.93,2,1,5,1,0,2,3,1,7,1.155988427834518,1.472451312258143
Tennessee Technological University,9365,8259,Tennessee,Town,NA,91.77,38.61,99.97,2,0,6,1,0,2,3,0,8,2.2423035293734075,0.25409167302061214
Tennessee Wesleyan University,931,863,Tennessee,Town,NA,30.46,10.43,65.35,0,0,1,0,0,0,0,0,1,0.20632136413599952,0.15664829897716212
Texas A&M InterNAtioNAl University,6800,5191,Texas,Large City,public,100.0,100.0,100.0,25,10,63,13,5,34,38,15,97,37.590505028085765,0.03356691587554378
Texas A&M University - College Station,53069,46724,Texas,Midsize City,public,100.0,100.0,100.0,189,74,482,98,37,262,287,111,744,285.29144544716036,1.8531233086521874
Texas A&M University - Commerce,8490,6068,Texas,Town,NA,100.0,100.0,100.0,31,12,78,16,6,43,47,18,121,46.080659081378236,0.3030488003442755
Texas A&M University - Corpus Christi,10174,8355,Texas,Large City,NA,100.0,100.0,100.0,37,14,94,19,7,51,56,21,145,55.739949102665086,0.12426840028016624
Texas A&M University - Kingsville,6782,5020,Texas,Town,NA,100.0,100.0,100.0,25,10,63,13,5,34,38,15,97,37.38451440515342,0.1008894989991444
Texas A&M University - TexarkaNA,1611,1166,Texas,Rural,NA,99.93,93.84,100.0,5,2,12,2,1,7,7,3,19,7.187402546098744,0.051169224390916944
Texas Christian University,9009,8738,Texas,Large City,NA,100.0,100.0,100.0,24,10,60,12,5,32,36,15,92,32.65229739184286,3.5236873660972146
Texas College,993,940,Texas,Midsize City,NA,98.79,82.66,100.0,3,1,7,2,1,4,5,2,11,4.025168118380629,0.3788538167245954
Texas Lutheran University,1359,1305,Texas,Town,private,99.94,94.43,100.0,5,2,13,3,1,7,8,3,20,7.432364367964231,0.04537399091800655
Texas Southern University,7971,6695,Texas,Large City,NA,100.0,100.0,100.0,25,10,63,13,5,34,38,15,97,35.94258004462703,2.1564294525932244
Texas State University,34177,28019,Texas,Suburb,NA,100.0,100.0,100.0,124,48,316,64,24,172,188,72,488,188.0137655958952,0.3243727084269207
Texas Tech University,30737,27318,Texas,Large City,public,100.0,100.0,100.0,108,42,275,56,21,149,164,63,424,162.19256264561946,1.4418241579979019
Texas Wesleyan University,1675,1497,Texas,Large City,NA,99.99,97.07,100.0,6,2,15,3,1,8,9,3,23,9.013481581823289,0.0972242029548771
Texas Woman's University,10311,6968,Texas,Midsize City,NA,100.0,100.0,100.0,37,15,95,19,7,52,56,22,147,56.563911594394455,0.1150077321824237
The College of Idaho,938,896,Idaho,Suburb,NA,61.2,17.41,96.84,1,0,2,0,0,1,1,0,3,0.6959577100800096,0.25007430715984114
The College of New Jersey,6956,6728,New Jersey,Suburb,NA,99.95,97.67,100.0,5,3,11,2,1,5,7,4,16,7.353431202158502,0.31136468409106605
The College of Saint Rose,2504,2426,New York,Small City,NA,83.96,67.11,96.17,1,1,2,1,0,1,2,1,3,1.681361397398534,0.14804023797941485
The College of Saint Scholastica,2678,2179,Minnesota,Small City,NA,37.84,24.66,72.03,0,0,1,0,0,0,0,0,1,0.25317928562462005,0.22194584931681988
The College of Wooster,1979,1962,Ohio,Town,NA,77.58,54.1,95.83,1,1,2,0,0,1,1,1,3,0.22688487119686962,1.2666145256205286
The Evergreen State College,3615,3330,Washington,Suburb,NA,98.37,89.48,99.98,3,1,6,1,1,3,4,2,9,2.113393571048249,1.9967898754759439
The King's College,555,542,New York,Large City,NA,64.61,39.05,92.91,1,0,2,0,0,1,1,0,3,0.04611483153509257,0.9907191651559182
The Master's College and SemiNAry,1353,975,California,Suburb,NA,92.69,76.29,99.53,2,1,4,1,0,2,3,1,6,2.138770841145769,0.4738358110020047
The New School,7124,6224,New York,Large City,private,99.99,99.32,100.0,6,3,14,3,2,7,9,5,21,1.2326567667475539,8.370974063002967
Stockton University,8276,7809,New Jersey,Suburb,NA,99.99,98.91,100.0,6,3,13,3,1,6,9,4,19,9.066580113951943,0.17800938210393943
The University of Alabama,33303,29923,Alabama,Midsize City,NA,100.0,100.0,100.0,23,10,55,11,5,27,34,15,82,11.075470239767455,23.695327542881977
The University of Findlay,3563,2499,Ohio,Town,private,76.24,53.28,94.56,1,1,2,0,0,1,1,1,3,0.8827484684326338,0.5539399666076879
The University of MontaNA,9322,7444,MontaNA,Small City,NA,100.0,75.23,100.0,25,1,356,16,0,234,41,1,590,38.26729946369804,2.797576735320572
The University of MontaNA - Western,1540,1230,MontaNA,Town,public,99.89,16.84,100.0,4,0,59,3,0,39,7,0,98,6.317824197606283,0.4813771798240838
The University of Tampa,7970,7728,Florida,Large City,NA,100.0,99.99,100.0,11,6,23,6,3,12,17,9,35,12.024295280399214,4.426415097325218
The University of Tennessee - Knoxville,22315,20965,Tennessee,Midsize City,NA,99.94,85.35,100.0,5,1,15,2,1,7,7,2,22,4.905100302657758,2.4477067198435996
The University of Tennessee - Chattanooga,10172,8962,Tennessee,Midsize City,NA,93.41,41.54,99.99,2,0,6,1,0,3,3,0,9,2.4115802728381395,0.3070400344537004
The University of Tennessee - Martin,6327,4950,Tennessee,Town,NA,81.75,28.65,99.6,1,0,4,0,0,2,1,0,6,1.5031284162440774,0.1974096931095238
The University of Texas at Arlington,33305,17819,Texas,Large City,public,100.0,100.0,100.0,120,47,306,63,24,166,183,71,472,181.9899317036575,0.7528539590496531
The University of Texas at Austin,40489,37740,Texas,Large City,NA,100.0,100.0,100.0,139,55,353,72,27,192,211,82,545,207.34904758086878,3.720339653970465
The University of Texas at Dallas,18474,15294,Texas,Midsize City,NA,100.0,100.0,100.0,66,26,168,34,13,91,100,39,259,98.84209512272432,0.8789016658729303
The University of Texas at El Paso,21335,14025,Texas,Large City,NA,100.0,100.0,100.0,77,30,196,40,15,107,117,45,303,116.59625989383888,0.5328553094954304
The University of Texas at San Antonio,26437,21510,Texas,Large City,NA,100.0,100.0,100.0,96,37,244,50,19,132,146,56,376,144.92275420410255,0.4367983918123351
The University of Texas at Tyler,7440,4842,Texas,Midsize City,NA,100.0,100.0,100.0,27,10,68,14,5,37,41,15,105,40.47994106327186,0.12745393289160398
The University of Texas of the Permian Basin,6066,2192,Texas,Midsize City,public,100.0,100.0,100.0,22,9,55,11,4,30,33,13,85,32.96963429744133,0.13101123667062534
The University of Texas Rio Grande Valley,24216,18647,Texas,Small City,public,100.0,100.0,100.0,88,34,225,46,17,122,134,51,347,133.85493370708915,0.2968353791502149
The University of Virginia's College at Wise,2093,1210,Virginia,Town,NA,94.97,59.84,99.84,2,1,4,1,0,2,3,1,6,2.9234367572783975,0.06458050996888147
The University of West Florida,10000,6906,Florida,Small City,public,100.0,100.0,100.0,29,16,61,15,8,31,44,24,92,43.071893571348525,0.6710986933257849
Thiel College,764,751,Pennsylvania,Town,NA,41.14,27.33,62.8,0,0,1,0,0,0,0,0,1,0.32858907023037043,0.20110121911345083
Thomas AquiNAs College,364,369,California,Rural,private,46.66,25.44,91.16,0,0,1,0,0,1,0,0,2,0.37339866618898515,0.2542800387602937
Thomas College,1660,774,Maine,Rural,NA,49.25,23.94,78.48,0,0,1,0,0,1,0,0,2,0.20334203603283255,0.4744357238592673
Thomas More College,1878,1356,Kentucky,Suburb,NA,57.92,32.61,86.21,1,0,1,0,0,1,1,0,2,0.5300058159245543,0.33535898410731796
Thomas More College of Liberal Arts,90,90,New Hampshire,Suburb,private,5.37,2.22,12.34,0,0,0,0,0,0,0,0,0,0.0,0.055199909480684935
Thomas University,1118,438,Georgia,Town,NA,84.39,61.8,98.66,1,1,3,1,0,1,2,1,4,0.23908013938646722,1.6144377830881367
Tiffin University,2243,1772,Ohio,Town,private,90.46,66.67,99.61,2,1,4,1,0,2,3,1,6,0.2689354559000239,2.076910335355075
Toccoa Falls College,1420,872,Georgia,Town,NA,62.0,35.15,91.98,1,0,2,0,0,1,1,0,3,0.26292621546516926,0.7037166188705251
Tougaloo College,794,766,Mississippi,Midsize City,private,72.55,43.09,94.5,1,0,2,0,0,1,1,0,3,1.1557090698579418,0.13567268045629985
Touro College,6428,4232,New York,Large City,NA,99.62,95.82,100.0,4,2,8,2,1,4,6,3,12,4.24110053832264,1.3271251240273518
Towson University,19592,17106,Maryland,Small City,NA,100.0,99.97,100.0,10,6,18,5,3,9,15,9,27,9.11112945213218,5.1332975160663254
Transylvania University,962,963,Kentucky,Large City,private,40.99,20.28,71.51,0,0,1,0,0,0,0,0,1,0.40474128346175,0.12239276880278452
Trevecca Nazarene University,2216,1317,Tennessee,Large City,NA,74.95,43.57,96.73,1,0,2,0,0,1,1,0,3,0.33045764267680305,1.0524842509194723
Trident University InterNAtioNAl,4368,1862,California,Suburb,private,99.06,86.77,100.0,3,1,7,2,1,4,5,2,11,0.3497658392149987,4.3092367485373755
Trine University,4099,1938,IndiaNA,Town,NA,89.53,74.72,98.49,2,1,3,1,0,1,3,1,4,1.049194016428097,1.2059682017583084
Trine University - RegioNAl/Non - TraditioNAl Campuses,368,210,IndiaNA,Large City,NA,10.91,5.75,21.08,0,0,0,0,0,0,0,0,0,0.0,0.11548220276687139
Trinity Christian College,1109,907,Illinois,Suburb,private,40.52,28.53,61.81,0,0,1,0,0,0,0,0,1,0.24868200583642158,0.27054362838816404
Trinity College,2218,2117,Connecticut,Midsize City,NA,88.4,68.82,98.97,1,1,3,1,0,2,2,1,5,0.0983704136032566,2.0536483338567155
Trinity InterNAtioNAl University - Florida,156,64,Florida,Suburb,NA,51.79,32.99,78.27,0,0,1,0,0,1,0,0,2,0.7278968039356917,0.0
Trinity InterNAtioNAl University - Illinois,936,592,Illinois,Suburb,NA,49.05,32.75,73.66,0,0,1,0,0,0,0,0,1,0.15700685961706276,0.5163979604725552
Trinity University,2389,2353,Texas,Large City,NA,100.0,98.13,100.0,7,3,17,3,1,9,10,4,26,9.230606833022245,0.7575419726580528
Trinity Washington University,1530,1075,District of Columbia,Large City,NA,61.17,42.03,81.28,1,0,1,0,0,1,1,0,2,0.48926263570714995,0.45651529526158463
Troy University,14006,9491,Alabama,Town,public,100.0,99.35,100.0,8,3,19,4,2,9,12,5,28,5.6513669452248205,5.880246426938442
Truett McConnell University,2574,780,Georgia,Town,NA,56.96,24.61,95.56,1,0,2,0,0,1,1,0,3,0.765861638215976,0.07697653433744155
Truman State University,5895,5134,Missouri,Town,NA,80.86,57.49,97.59,1,1,3,1,0,1,2,1,4,1.1650581489381453,0.4878905690144203
Tufts University,5543,5483,Massachusetts,Suburb,NA,99.87,96.91,100.0,4,2,9,2,1,5,6,3,14,1.5378394696677968,5.092502993369314
Tulane University of LouisiaNA,7872,6716,LouisiaNA,Large City,private,100.0,99.49,100.0,7,4,17,4,2,9,11,6,26,1.0831475449996242,9.926068508699915
Tusculum College,1485,1376,Tennessee,Town,NA,57.67,25.97,89.65,1,0,2,0,0,1,1,0,3,0.23870474114664392,0.620129703919531
Tuskegee University,2830,2722,Alabama,Town,NA,94.2,74.62,99.85,2,1,4,1,0,2,3,1,6,0.44929616873997597,2.394235295780659
Union College Kentucky,1096,918,Kentucky,Town,private,47.35,24.34,78.57,0,0,1,0,0,0,0,0,1,0.44526804396442193,0.19579885046144233
Union College Nebraska,779,707,Nebraska,Large City,private,51.18,27.61,82.25,0,0,1,0,0,1,0,0,2,0.005739287193840712,0.7101667434465666
Union College New York,2265,2176,New York,Small City,NA,85.88,66.4,97.67,1,1,3,1,0,1,2,1,4,0.675618881061753,1.280602418984423
Union Institute & University,814,434,Ohio,Large City,NA,88.37,69.16,98.88,1,1,3,1,0,2,2,1,5,0.0806492557366466,2.0661462299847364
Union University,2179,1599,Tennessee,Small City,NA,65.57,32.13,94.19,1,0,2,0,0,1,1,0,3,0.3662756202794855,0.6986743365921203
United States Air Force Academy,4279,4276,Colorado,Town,NA,99.92,96.05,100.0,5,2,12,2,1,6,7,3,18,0.07753200136335306,7.03330622198938
United States Coast Guard Academy,1047,1044,Connecticut,Small City,NA,80.02,53.35,97.28,1,1,2,1,0,1,2,1,3,0.009864442589741609,1.5976681645994022
United States Merchant Marine Academy,952,954,New York,Suburb,public,78.31,49.54,99.1,1,0,3,1,0,2,2,0,5,0.11052919939363458,1.4152101476167815
United States Military Academy,4487,4491,New York,Town,public,99.9,96.09,100.0,5,2,11,2,1,6,7,3,17,0.23057415767546285,6.686287377226854
United States Naval Academy,4495,4495,Maryland,Suburb,NA,99.85,95.4,100.0,4,2,10,2,1,5,6,3,15,0.2596503121154796,6.242120388992728
Unity College,706,694,Maine,Rural,private,40.25,22.32,67.23,0,0,1,0,0,0,0,0,1,0.04121798027692552,0.4732644596593857
Polytechnic University of Puerto Rico - Orlando,124,53,Florida,Suburb,NA,44.01,27.25,70.28,0,0,1,0,0,0,0,0,1,0.5785846390258061,0.0
University at Buffalo,21016,19401,New York,Suburb,NA,100.0,99.99,100.0,11,7,19,5,3,10,16,10,29,14.44638595518392,1.6574231699140978
University of Advancing Technology,775,508,ArizoNA,Midsize City,NA,68.87,42.89,93.44,1,0,2,0,0,1,1,0,3,0.1790405422302789,0.9859518896113446
University of Akron Main Campus,16874,13563,Ohio,Midsize City,public,99.61,94.32,100.0,4,2,8,2,1,4,6,3,12,5.125150368447129,0.4235276918366242
University of Alabama at Birmingham,13130,9677,Alabama,Midsize City,NA,99.98,96.63,100.0,6,2,14,3,1,7,9,3,21,6.9027701163725155,1.5289872799106798
University of Alabama in Huntsville,7089,5903,Alabama,Midsize City,NA,98.66,80.68,100.0,3,1,8,1,1,4,4,2,12,3.4205794993981353,0.8913817791077585
University of Alaska Anchorage,14954,6974,Alaska,Large City,NA,60.71,33.2,97.41,1,0,2,0,0,1,1,0,3,0.006557341180616994,0.9261190224439045
University of Alaska Fairbanks,6633,3022,Alaska,Suburb,public,50.47,29.13,79.37,0,0,1,0,0,1,0,0,2,0.002794316318616522,0.6988520559516888
University of Alaska Southeast,2060,629,Alaska,Town,NA,25.23,14.12,45.74,0,0,0,0,0,0,0,0,0,0.0008509421783651821,0.28955096897738447
University of ArizoNA,34099,29325,ArizoNA,Large City,NA,100.0,100.0,100.0,40,25,72,20,12,36,60,37,108,39.18705985579389,20.075706257361404
University of Arkansas,23037,20464,Arkansas,Small City,NA,100.0,100.0,100.0,19,7,49,10,4,26,29,11,75,2.032295220552685,27.05442350838499
University of Arkansas at Little Rock,8794,4603,Arkansas,Midsize City,NA,82.86,34.8,99.27,1,0,3,1,0,2,2,0,5,1.2273547950160737,0.535154787156995
University of Arkansas at Pine Bluff,2517,2341,Arkansas,Small City,public,79.98,47.96,98.14,1,0,3,1,0,1,2,0,4,0.19972853339518057,1.4059245027406067
University of Baltimore,2950,1716,Maryland,Large City,NA,85.13,68.06,96.99,1,1,2,1,0,1,2,1,3,1.8045696692025834,0.10056612090046332
University of Bridgeport,3124,2300,Connecticut,Midsize City,private,87.58,71.52,97.81,1,1,3,1,0,1,2,1,4,0.2852467982200282,1.799412802155792
University of California - Berkeley,30577,29351,California,Midsize City,public,100.0,100.0,100.0,46,26,92,23,13,46,69,39,138,60.6465605806439,7.814900851179217
University of California - Davis,30067,29284,California,Suburb,NA,100.0,100.0,100.0,47,27,92,23,13,46,70,40,138,69.99098036615813,0.5480769396764827
University of California - Irvine,29310,28855,California,Large City,public,100.0,100.0,100.0,46,26,90,23,13,45,69,39,135,68.49974898409958,0.45389708553237224
University of California - Los Angeles,31001,30458,California,Large City,NA,100.0,100.0,100.0,48,27,94,24,14,47,72,41,141,68.05308855429124,3.413502333797478
University of California - Riverside,20077,19719,California,Large City,public,100.0,100.0,100.0,32,18,62,16,9,31,48,27,93,47.31055631922337,0.07422353574613774
University of California - San Diego,28582,27880,California,Large City,NA,100.0,100.0,100.0,45,26,88,22,13,44,67,39,132,65.34949314846719,1.431657930266207
University of California - Santa Barbara,22182,21777,California,Suburb,NA,100.0,100.0,100.0,34,20,67,17,10,34,51,30,101,50.522257504988126,0.9779428955623507
University of California - Santa Cruz,17573,17082,California,Small City,NA,100.0,100.0,100.0,28,16,54,14,8,27,42,24,81,41.07148999809097,0.30888954506062777
University of Central Arkansas,9549,8070,Arkansas,Small City,NA,98.17,73.05,100.0,3,1,7,1,0,4,4,1,11,1.2604994007734636,2.7323409892187676
University of Central Florida,56854,39962,Florida,Suburb,NA,100.0,100.0,100.0,168,92,350,85,46,179,253,138,529,249.83191393031242,3.2929894352306115
University of Central Missouri,9800,7701,Missouri,Town,NA,91.54,71.01,99.66,2,1,4,1,0,2,3,1,6,2.204648497221413,0.2640525493080104
University of Central Oklahoma,14340,10448,Oklahoma,Suburb,public,99.97,96.41,100.0,5,2,13,3,1,6,8,3,19,6.866658702687043,1.1680169368052968
University of Charleston,1833,1220,West Virginia,Small City,NA,63.94,39.55,88.41,1,0,1,0,0,1,1,0,2,0.021562370466635894,0.9968971872714529
University of Chicago,6305,6288,Illinois,Large City,private,99.94,97.79,100.0,5,3,11,2,1,6,7,4,17,0.43203229827513917,7.007408097014688
University of CincinNAti - Main Campus,26558,22622,Ohio,Large City,NA,100.0,99.44,100.0,7,4,15,3,2,7,10,6,22,7.416279614101825,2.8511471641650394
University of Colorado at Colorado Springs,10804,8171,Colorado,Large City,public,98.08,82.99,100.0,3,1,7,1,1,4,4,2,11,2.2330136653789463,1.7170800946212814
University of Colorado Boulder,29057,26977,Colorado,Midsize City,NA,100.0,100.0,100.0,16,8,37,8,4,19,24,12,56,3.9373373036570456,20.155463713582893
University of Colorado Denver/Anschutz Medical Campus,15589,8671,Colorado,Large City,NA,99.54,90.88,100.0,4,2,9,2,1,5,6,3,14,3.3265139694739525,2.045424322755626
University of Connecticut,19243,18555,Connecticut,Suburb,NA,99.99,99.77,100.0,6,4,11,3,2,6,9,6,17,3.542430938893876,6.144729542919135
University of Dallas,1456,1421,Texas,Midsize City,private,99.0,83.06,100.0,3,1,9,2,1,5,5,2,14,3.574215673582799,1.021860459794752
University of Dayton,8498,8079,Ohio,Midsize City,NA,98.02,88.27,99.96,3,1,5,1,1,3,4,2,8,1.454824706595695,2.4626174269196404
University of Delaware,19752,18195,Delaware,Suburb,NA,100.0,99.93,100.0,8,5,16,4,2,8,12,7,24,2.4913574888920116,9.89204132974714
University of Denver,5768,5494,Colorado,Large City,NA,99.34,89.66,100.0,3,2,10,2,1,6,5,3,16,0.6156547051879312,4.397571892986705
University of Detroit Mercy,2839,2338,Michigan,Large City,private,86.33,67.44,98.19,1,1,3,1,0,1,2,1,4,1.8412793652903003,0.14782935362772742
University of Dubuque,1953,1709,Iowa,Small City,NA,67.4,44.72,91.82,1,0,2,0,0,1,1,0,3,0.2202518876380353,0.899357285005792
University of Evansville,2346,2024,IndiaNA,Midsize City,NA,81.61,59.8,97.2,1,1,2,1,0,1,2,1,3,0.5656600641102508,1.1256991285340254
University of Florida,35251,31384,Florida,Midsize City,NA,100.0,100.0,100.0,106,58,220,53,29,112,159,87,332,157.46834191808796,1.5121314872689626
University of Georgia,28844,27142,Georgia,Midsize City,NA,100.0,99.34,100.0,9,3,30,4,2,15,13,5,45,7.8967674536470565,5.865383577346835
University of Providence,930,469,MontaNA,Small City,private,97.71,16.87,100.0,2,0,32,1,0,21,3,0,53,3.371056149596729,0.3974055971427379
University of Hartford,5073,4460,Connecticut,Midsize City,NA,97.25,87.4,99.88,2,1,4,1,1,2,3,2,6,0.48363169919149834,3.1076482274890416
University of Hawaii at Hilo,2972,2340,Hawaii,Town,public,60.69,34.3,97.85,1,0,2,0,0,1,1,0,3,0.00017276996815563544,0.9322418251409714
University of Hawaii at Manoa,12877,10702,Hawaii,Large City,NA,99.79,95.96,100.0,4,2,10,2,1,5,6,3,15,0.0006724198379424541,6.1457152220163955
University of Hawaii - West Oahu,3083,1611,Hawaii,Suburb,NA,3.64,2.08,6.34,0,0,0,0,0,0,0,0,0,0.000221359234930452,0.036790490288964355
University of Houston,37217,27159,Texas,Large City,public,100.0,100.0,100.0,134,52,340,69,26,185,203,78,525,202.11577229556065,0.8915474384490479
University of Houston - Downtown,12402,6320,Texas,Large City,public,100.0,100.0,100.0,45,18,115,23,9,62,68,27,177,68.1828961906052,0.1748133273889913
University of Houston - Victoria,3273,1722,Texas,Small City,public,100.0,99.91,100.0,12,5,31,6,2,17,18,7,48,18.221819158312307,0.0
University of Idaho,9889,7166,Idaho,Town,NA,100.0,92.75,100.0,7,2,24,3,1,13,10,3,37,5.691308989537541,4.222219988090666
University of Illinois at Chicago,19446,17961,Illinois,Large City,public,99.92,99.45,100.0,5,3,8,2,2,4,7,5,12,6.71617038643816,0.38352350187173995
University of Illinois at Springfield,2932,1903,Illinois,Midsize City,public,66.14,54.39,82.92,1,1,1,0,0,1,1,1,2,1.008777854183902,0.07380019242513593
University of Illinois at UrbaNA - Champaign,33955,32613,Illinois,Small City,NA,100.0,99.99,100.0,10,7,16,5,3,8,15,10,24,10.953248121473122,3.4012980871935268
University of IndiaNApolis,4486,3828,IndiaNA,Large City,NA,86.85,75.26,96.14,1,1,2,1,0,1,2,1,3,1.785254783080877,0.2429108548143248
University of Iowa,24506,21222,Iowa,Small City,public,99.99,99.43,100.0,7,3,15,3,2,7,10,5,22,4.216250420499533,5.494892893560463
University of Kansas,19344,17151,Kansas,Small City,public,99.92,95.32,100.0,5,2,11,2,1,6,7,3,17,0.6979348607642835,6.427289648383881
University of Kentucky,22420,20657,Kentucky,Large City,NA,100.0,99.62,100.0,9,4,20,4,2,10,13,6,30,9.03904655679076,3.6802787833327586
University of La Verne,5169,3759,California,Suburb,NA,100.0,99.89,100.0,8,5,16,4,2,8,12,7,24,11.601354761529924,0.24215271242011344
University of LouisiaNA at Lafayette,15665,12767,LouisiaNA,Midsize City,NA,100.0,99.94,100.0,12,5,28,6,2,13,18,7,41,15.472369643745811,1.78596862853283
University of LouisiaNA at Monroe,7946,5212,LouisiaNA,Small City,NA,99.99,98.07,100.0,6,3,15,3,1,7,9,4,22,7.581011940779651,1.5802623582541504
University of Louisville,15543,12025,Kentucky,Large City,NA,99.98,97.99,100.0,6,3,14,3,1,7,9,4,21,6.850075168081503,1.9230277056240352
University of Maine,9277,8204,Maine,Suburb,NA,93.29,61.93,99.84,2,1,4,1,0,2,3,1,6,1.2976794123852051,1.4021265942223566
University of Maine at Augusta,4013,1317,Maine,Town,public,49.91,12.84,85.09,0,0,1,0,0,1,0,0,2,0.6855924052728611,0.005761450901946667
University of Maine at Farmington,1810,1673,Maine,Town,public,38.56,14.75,69.98,0,0,1,0,0,0,0,0,1,0.26156243317398986,0.2253190276156776
University of Maine at Fort Kent,1762,582,Maine,Rural,NA,30.97,9.75,61.5,0,0,1,0,0,0,0,0,1,0.28612147975565794,0.08436636301045845
University of Maine at Machias,698,367,Maine,Rural,public,24.73,11.49,47.21,0,0,0,0,0,0,0,0,0,0.09188174770064647,0.19187304318473816
University of Maine at Presque Isle,1413,716,Maine,Rural,NA,24.7,6.96,52.56,0,0,1,0,0,0,0,0,1,0.22927501529039818,0.05433005606082273
University of Mary,2234,1794,North Dakota,Rural,NA,97.04,49.05,100.0,2,0,15,1,0,9,3,0,24,1.9196329484755297,1.595073522740701
University of Mary Hardin - Baylor,3329,3045,Texas,Suburb,NA,100.0,99.91,100.0,12,5,31,6,2,17,18,7,48,18.160578702845935,0.08206338793677848
University of Mary Washington,4399,3905,Virginia,Suburb,NA,99.73,85.87,100.0,4,1,8,2,1,4,6,2,12,5.222281685108591,0.6827599074823268
University of Maryland - Baltimore County,11238,9543,Maryland,Suburb,public,99.95,98.88,100.0,5,3,9,3,1,5,8,4,14,6.728837838472654,0.8725042493544396
University of Maryland - College Park,29870,27708,Maryland,Suburb,public,100.0,100.0,100.0,15,9,30,8,4,15,23,13,45,13.0331474166365,9.924342517122062
University of Maryland Eastern Shore,2860,2573,Maryland,Town,public,86.14,67.82,97.55,1,1,2,1,0,1,2,1,3,1.4124976979082091,0.5625793655704031
University of Maryland - University College,45609,9714,Maryland,Suburb,NA,100.0,100.0,100.0,26,14,57,13,7,30,39,21,87,19.909985933014976,19.85666155491379
University of Massachusetts Amherst,23386,21577,Massachusetts,Suburb,NA,100.0,100.0,100.0,18,9,36,9,5,18,27,14,54,22.31352130590193,4.791527027647238
University of Massachusetts - Boston,12658,9574,Massachusetts,Large City,NA,100.0,99.97,100.0,11,5,21,5,3,11,16,8,32,15.251855428812776,0.8294322540495865
University of Massachusetts - Dartmouth,6764,5790,Massachusetts,Suburb,NA,99.98,98.7,100.0,6,3,11,3,1,6,9,4,17,8.367086283331087,0.14006316708087266
University of Massachusetts - Lowell,14015,10495,Massachusetts,Suburb,NA,100.0,99.98,100.0,11,6,23,6,3,12,17,9,35,16.213812107992045,0.7985894320368583
University of Memphis,17392,12400,Tennessee,Large City,NA,99.67,76.11,100.0,4,1,12,2,0,5,6,1,17,3.889685170483083,1.8199587031362943
University of Miami,10834,10216,Florida,Suburb,NA,100.0,100.0,100.0,18,10,37,9,5,19,27,15,56,20.80105097400842,6.147475342291463
University of Michigan - Ann Arbor,29819,28702,Michigan,Midsize City,NA,100.0,100.0,100.0,17,9,36,9,5,18,26,14,54,13.14903885441481,12.562012685673231
University of Michigan - Dearborn,7132,5137,Michigan,Small City,NA,99.28,93.81,100.0,3,2,7,2,1,3,5,3,10,4.9036394636506015,0.023908326100108214
University of Michigan - Flint,6432,3809,Michigan,Small City,public,98.84,91.88,99.99,3,2,6,1,1,3,4,3,9,4.381403240524053,0.07568533185095322
University of Minnesota - Crookston,2832,1195,Minnesota,Town,public,65.66,40.95,91.26,1,0,2,0,0,1,1,0,3,0.23870864238684927,0.8291458496298985
University of Minnesota - Duluth,10124,8906,Minnesota,Small City,NA,73.92,59.53,89.86,1,1,2,0,0,1,1,1,3,1.0318594107185237,0.3119723192746472
University of Minnesota - Morris,1627,1526,Minnesota,Town,NA,25.72,16.04,43.91,0,0,0,0,0,0,0,0,0,0.1641905268159665,0.13291713890979198
University of Minnesota - Twin Cities,35429,29991,Minnesota,Large City,NA,99.92,98.65,100.0,5,3,10,2,1,5,7,4,15,2.7625255535413653,4.390564719677134
University of Mississippi,18734,17511,Mississippi,Town,NA,100.0,100.0,100.0,22,9,50,10,4,25,32,13,75,17.733713616375752,14.378795058625187
University of Missouri - Columbia,23800,22197,Missouri,Midsize City,NA,100.0,99.52,100.0,7,4,17,4,2,8,11,6,25,4.138984126622667,6.737993311746562
University of Missouri - Kansas City,11369,6760,Missouri,Large City,public,97.08,81.82,99.97,2,1,6,1,1,3,3,2,9,2.197139806448631,1.332311991758388
University of Missouri - St Louis,13791,5492,Missouri,Suburb,public,98.01,86.23,99.99,3,1,6,1,1,3,4,2,9,3.0962449725314576,0.8200420185088951
University of Mobile,1442,1152,Alabama,Rural,NA,78.9,50.01,97.18,1,0,2,1,0,1,2,0,3,0.6079738583467204,0.9456593642365712
University of Montevallo,2352,2101,Alabama,Suburb,NA,80.93,49.4,97.83,1,0,3,1,0,1,2,0,4,1.2705839907704883,0.38515614701483486
University of Mount Union,2093,2046,Ohio,Town,NA,63.47,42.18,86.78,1,0,1,0,0,1,1,0,2,0.5494818941434559,0.4568068677861384
University of Nebraska at Kearney,4846,4063,Nebraska,Town,NA,53.35,36.46,84.56,1,0,1,0,0,1,1,0,2,0.3539766003074433,0.4077860247394421
University of Nebraska at Omaha,12620,9820,Nebraska,Large City,NA,72.39,59.28,88.79,1,1,1,0,0,1,1,1,2,0.947790737292709,0.33910912802246934
University of Nebraska - Lincoln,20955,19534,Nebraska,Large City,public,99.28,92.66,100.0,3,2,8,2,1,4,5,3,12,1.3891500060021496,3.537546763740473
University of Nevada - Las Vegas,25281,18958,Nevada,Midsize City,NA,100.0,100.0,100.0,64,15,223,31,7,113,95,22,336,90.7255794424596,4.386443615258897
University of Nevada - Reno,18354,15572,Nevada,Midsize City,NA,100.0,100.0,100.0,45,12,151,22,5,77,67,17,228,59.08646400669355,7.613668549492408
University of New England,4427,2361,Maine,Suburb,NA,91.27,67.2,99.43,2,1,3,1,0,2,3,1,5,0.28474754707976047,2.152127626894587
University of New Hampshire at Manchester,737,575,New Hampshire,Midsize City,NA,14.0,0.31,32.4,0,0,0,0,0,0,0,0,0,0.14568229030138768,0.005123870170565841
University of New Hampshire - Main Campus,13010,12677,New Hampshire,Suburb,NA,99.91,94.55,100.0,5,2,10,2,1,5,7,3,15,1.4334738236094078,5.564411366494816
University of New Haven,5214,4831,Connecticut,Suburb,NA,97.85,88.43,99.94,3,1,5,1,1,2,4,2,7,0.5261036047862192,3.3111461503832964
University of New Mexico - Main Campus,20359,15093,New Mexico,Large City,public,100.0,99.69,100.0,12,4,40,6,2,19,18,6,59,12.237861527660751,5.788037546038519
University of New Orleans,6468,4737,LouisiaNA,Large City,NA,99.89,94.87,100.0,5,2,11,2,1,5,7,3,16,6.307981791284334,0.45767997194541404
University of North Alabama,6061,5141,Alabama,Small City,public,97.86,78.52,99.99,3,1,6,1,0,3,4,1,9,3.1346109159310354,0.7063906151812613
University of North CaroliNA at Asheville,3820,3285,North CaroliNA,Small City,NA,77.61,52.87,95.75,1,1,2,0,0,1,1,1,3,0.814074991936408,0.6815254014036212
University of North CaroliNA at Chapel Hill,18863,18303,North CaroliNA,Small City,public,99.99,99.0,100.0,6,3,13,3,2,6,9,5,19,3.94054730040332,5.186989418853198
University of North CaroliNA at Charlotte,23915,20597,North CaroliNA,Large City,public,99.96,98.06,100.0,5,3,11,3,1,5,8,4,16,5.472968329282683,2.308223928681907
University of North CaroliNA at Greensboro,16441,14136,North CaroliNA,Large City,NA,99.57,93.6,100.0,4,2,8,2,1,4,6,3,12,3.8319366126798773,1.620280560482556
University of North CaroliNA at Pembroke,5478,4483,North CaroliNA,Town,NA,80.75,56.77,96.79,1,1,2,1,0,1,2,1,3,1.3247978072312938,0.32244612855709653
University of North CaroliNA at Wilmington,14499,12346,North CaroliNA,Midsize City,NA,99.63,93.76,100.0,4,2,8,2,1,4,6,3,12,3.0261968595687567,2.575775584125371
University of North Dakota,10999,8525,North Dakota,Small City,public,99.96,89.85,100.0,5,2,19,3,1,10,8,3,29,5.257956194678086,2.470169223565984
University of North Florida,14251,10223,Florida,Large City,NA,100.0,100.0,100.0,43,24,90,22,12,46,65,36,136,64.90413168426583,0.28067816589832245
University of North Texas,31444,25592,Texas,Midsize City,NA,100.0,100.0,100.0,112,44,286,58,22,155,170,66,441,169.3855325058515,0.8918545838566142
University of Northern Colorado,10103,8328,Colorado,Midsize City,NA,96.37,77.17,100.0,2,1,7,1,0,3,3,1,10,2.109238541540715,1.203646635947551
University of Northern Iowa,9959,9100,Iowa,Small City,NA,96.71,73.61,100.0,2,1,7,1,0,3,3,1,10,3.213830726917108,0.20060624508181862
University of Notre Dame,8577,8557,IndiaNA,Suburb,private,100.0,99.33,100.0,7,3,15,3,2,8,10,5,23,0.24769586658243903,9.660508300797565
University of Oklahoma Norman Campus,22028,19065,Oklahoma,Suburb,NA,100.0,100.0,100.0,27,11,68,14,5,36,41,16,104,6.9708486197204795,33.43445579258311
University of Oregon,19336,17801,Oregon,Midsize City,NA,100.0,100.0,100.0,15,8,34,8,4,18,23,12,52,5.321583095116319,17.720322400577448
University of Pennsylvania,11719,10496,Pennsylvania,Large City,NA,100.0,99.97,100.0,10,5,22,5,3,11,15,8,33,1.5231323058931798,13.674357195177986
University of Phoenix - New Mexico,216,217,New Mexico,Large City,private,62.14,30.93,92.25,1,0,2,0,0,1,1,0,3,0.031837678058233995,0.9367545888155179
University of Phoenix - Hawaii,661,661,Hawaii,Large City,NA,1.81,1.09,3.29,0,0,0,0,0,0,0,0,0,4.632079197057062e-05,0.018175521848083576
University of Phoenix - New Jersey,111,111,New Jersey,Large City,NA,10.73,5.62,20.84,0,0,0,0,0,0,0,0,0,0.09299631110454909,0.020495480682263364
University of Phoenix - Kentucky,18,18,Kentucky,Suburb,NA,0.92,0.42,2.1,0,0,0,0,0,0,0,0,0,0.00789482347454649,0.0013175312052257394
University of Phoenix - Utah,122,122,Utah,Suburb,NA,11.2,2.08,34.44,0,0,0,0,0,0,0,0,0,0.11874707422382631,0.0
University of Pittsburgh - Bradford,1337,1229,Pennsylvania,Town,NA,63.95,46.82,84.2,1,0,1,0,0,1,1,0,2,0.7475760069433318,0.27210964110155544
University of Pittsburgh - Greensburg,1524,1436,Pennsylvania,Suburb,NA,66.49,50.48,85.2,1,0,1,0,0,1,1,0,2,1.0654034264019652,0.027382679675878912
University of Pittsburgh - Johnstown,2785,2713,Pennsylvania,Suburb,NA,86.81,72.83,97.11,1,1,2,1,0,1,2,1,3,1.9593378838409206,0.06582092763163154
University of Pittsburgh - Pittsburgh Campus,19329,18390,Pennsylvania,Large City,public,100.0,99.99,100.0,10,6,19,5,3,10,15,9,29,9.565672649304648,5.778782537176808
University of Portland,3888,3792,Oregon,Large City,private,98.68,89.36,100.0,3,1,8,1,1,4,4,2,12,0.6136702965855233,3.711399224223527
University of Puget Sound,2415,2390,Washington,Midsize City,NA,95.73,80.4,99.98,2,1,5,1,1,3,3,2,8,0.45112824305068394,2.699758569306816
University of Redlands,3133,2518,California,Small City,private,99.79,96.71,100.0,4,2,8,2,1,4,6,3,12,5.1283234533550495,1.0248773388509331
University of Rhode Island,15100,12629,Rhode Island,Suburb,NA,99.98,99.41,100.0,6,3,10,3,2,5,9,5,15,2.72547769667469,5.808385398903491
University of Richmond,3265,3035,Virginia,Midsize City,NA,96.89,80.22,99.93,2,1,5,1,1,2,3,2,7,0.9209837855520965,2.5450126062716336
University of Rio Grande,1755,1269,Ohio,Rural,NA,42.47,24.64,67.88,0,0,1,0,0,0,0,0,1,0.5290842224590901,0.0236321272874499
University of Rochester,6542,6250,New York,Midsize City,private,99.78,96.29,100.0,4,2,9,2,1,4,6,3,13,2.158613304714095,3.9519568201146926
University of Saint Francis - Fort Wayne,1906,1523,IndiaNA,Large City,NA,55.93,42.99,73.25,1,0,1,0,0,0,1,0,1,0.718054506848028,0.10114677071589392
University of Saint Mary,750,641,Kansas,Town,NA,56.3,28.52,91.96,1,0,2,0,0,1,1,0,3,0.017746634280117465,0.8081643648371306
University of San Diego,5776,5605,California,Large City,NA,100.0,99.77,100.0,8,4,16,4,2,8,12,6,24,7.987895517207404,3.334340236088179
University of San Francisco,6847,6586,California,Large City,NA,100.0,99.96,100.0,9,5,19,5,3,9,14,8,28,12.033835495153875,1.8925486479334297
University of Science and Arts of Oklahoma,881,727,Oklahoma,Town,public,40.61,19.62,72.03,0,0,1,0,0,0,0,0,1,0.4187348324376968,0.10199344712354026
University of Scranton,3809,3630,Pennsylvania,Small City,private,96.15,84.22,99.81,2,1,4,1,1,2,3,2,6,1.0546417756302282,2.2016543923110743
University of Sioux Falls,1214,1036,South Dakota,Midsize City,private,45.14,22.3,84.98,0,0,1,0,0,1,0,0,2,0.21198881255394167,0.38773296398701246
University of South Alabama,10986,9090,Alabama,Midsize City,public,100.0,98.8,100.0,7,3,15,3,1,7,10,4,22,5.149178213282597,4.89271446462573
University of South CaroliNA - Aiken,3352,2716,South CaroliNA,Suburb,public,99.33,82.34,100.0,3,1,8,2,1,4,5,2,12,4.667105584977421,0.3300330635577522
University of South CaroliNA - Beaufort,2078,1797,South CaroliNA,Town,NA,94.98,64.02,99.94,2,1,5,1,0,2,3,1,7,2.7900839402591386,0.19892052576954614
University of South CaroliNA - Columbia,26363,25243,South CaroliNA,Midsize City,NA,100.0,100.0,100.0,22,8,51,10,4,25,32,12,76,23.4697110662926,9.140371803793371
University of South CaroliNA - Upstate,5776,4583,South CaroliNA,Suburb,public,99.99,95.26,100.0,6,2,14,3,1,7,9,3,21,8.330151111851636,0.5143857859173456
University of South Dakota,7652,4908,South Dakota,Town,public,94.13,76.03,99.67,2,1,4,1,0,2,3,1,6,1.8956622677786261,0.9377147751220904
University of South Florida - Main Campus,31773,24672,Florida,Large City,NA,100.0,100.0,100.0,94,52,196,48,26,100,142,78,296,139.64886823712382,1.7558613767322535
University of South Florida - St. Petersburg,4251,2845,Florida,Large City,NA,100.0,100.0,100.0,13,7,26,6,3,13,19,10,39,18.948646928095155,0.11493957623060751
University of Southern California,19174,18631,California,Large City,private,100.0,100.0,100.0,25,14,53,13,7,27,38,21,80,27.16357132389997,10.979942245097057
University of Southern IndiaNA,9689,6588,IndiaNA,Suburb,NA,98.68,94.93,99.9,3,2,5,1,1,2,4,3,7,3.9534719698140353,0.36983411670698246
University of Southern Maine,6110,3901,Maine,Small City,NA,77.63,37.15,97.48,1,0,2,0,0,1,1,0,3,0.8844691601090268,0.6126908551913101
University of Southern Mississippi,11809,10384,Mississippi,Small City,NA,100.0,99.98,100.0,14,6,31,6,3,15,20,9,46,17.10082531621545,3.1722446065924226
University of St Francis,1600,1291,Illinois,Suburb,NA,54.95,40.56,77.13,1,0,1,0,0,0,1,0,1,0.49876899475666475,0.29788962814747905
University of St Thomas Minnesota,6197,5945,Minnesota,Large City,NA,68.8,50.35,92.08,1,0,2,0,0,1,1,0,3,0.548631080235169,0.6153885616498784
University of St. Thomas - Houston,1815,1434,Texas,Large City,NA,99.99,97.62,100.0,6,2,16,3,1,9,9,3,25,9.547943738620717,0.09539321190485021
University of the Cumberlands,3317,1828,Kentucky,Town,NA,84.04,54.2,98.93,1,1,3,1,0,1,2,1,4,1.050011522114683,0.7838296228206407
University of the District of Columbia,3858,1830,District of Columbia,Large City,public,94.17,78.33,99.67,2,1,4,1,0,2,3,1,6,1.505379681227005,1.3347830879792262
University of the IncarNAte Word,5996,4461,Texas,Large City,NA,100.0,100.0,100.0,21,8,54,11,4,29,32,12,83,32.14010449157866,0.2729865597847772
University of the Ozarks,756,747,Arkansas,Town,NA,63.46,31.43,92.78,1,0,2,0,0,1,1,0,3,0.07188505404524817,0.9325361976578201
University of the Pacific,3552,3452,California,Large City,private,99.97,98.93,100.0,5,3,11,3,2,5,8,5,16,7.597953872136628,0.40238520805053013
University of the Southwest,509,417,New Mexico,Rural,NA,58.69,31.31,89.99,1,0,2,0,0,1,1,0,3,0.19576785018786436,0.6866906486907469
University of the West,185,148,California,Suburb,NA,35.45,22.28,57.57,0,0,1,0,0,0,0,0,1,0.43720729901874844,0.0
University of Toledo,16191,13056,Ohio,Large City,public,99.72,95.41,100.0,4,2,8,2,1,4,6,3,12,4.5270278725948,1.3511742039786105
University of Tulsa,3347,3203,Oklahoma,Large City,private,98.75,83.32,100.0,3,1,7,1,1,4,4,2,11,0.8626530097507741,3.5090252961569646
University of Utah,24637,18066,Utah,Midsize City,NA,100.0,99.86,100.0,18,5,62,9,2,32,27,7,94,19.063772096293953,7.961034393644118
University of Vermont,11341,10395,Vermont,Small City,NA,99.92,97.73,100.0,5,3,10,2,1,5,7,4,15,0.0011629216586956522,7.133802864628744
University of Virginia - Main Campus,16658,15766,Virginia,Suburb,public,100.0,99.97,100.0,15,6,33,8,3,17,23,9,50,17.46110075056934,5.781538356554141
University of Washington - Bothell Campus,5365,4641,Washington,Suburb,NA,99.63,95.98,99.99,4,2,6,2,1,3,6,3,9,5.364768295737862,0.2250142425077604
University of Washington - Seattle Campus,31328,28759,Washington,Large City,public,100.0,100.0,100.0,24,13,45,12,7,24,36,20,69,26.425548074914836,9.15852489161244
University of Washington - Tacoma Campus,4436,3945,Washington,Midsize City,NA,98.94,92.81,99.96,3,2,5,2,1,3,5,3,8,4.446254936013047,0.1003325827565627
University of West Alabama,2111,1843,Alabama,Rural,NA,76.28,43.86,96.38,1,0,2,0,0,1,1,0,3,1.1305058838282707,0.307820045080237
University of West Georgia,11230,8938,Georgia,Town,public,97.7,71.39,100.0,3,1,9,1,0,5,4,1,14,3.4034854039602007,0.36763348545958274
University of Wisconsin - Eau Claire,10184,9476,Wisconsin,Small City,public,73.18,62.45,85.04,1,1,1,0,0,1,1,1,2,0.9754714595071957,0.34029923212846536
University of Wisconsin - Green Bay,6812,4095,Wisconsin,Midsize City,public,63.05,51.91,76.58,1,0,1,0,0,0,1,0,1,0.8382815084912634,0.15715156627868923
University of Wisconsin - La Crosse,9701,9094,Wisconsin,Small City,NA,75.64,63.84,91.82,1,1,2,0,0,1,1,1,3,1.0545743237466392,0.357381637222999
University of Wisconsin - Madison,31358,28977,Wisconsin,Large City,NA,99.99,99.76,100.0,6,4,11,3,2,6,9,6,17,2.546172392499312,7.020182841778718
University of Wisconsin - Milwaukee,20356,17076,Wisconsin,Large City,NA,94.13,88.17,98.18,2,1,3,1,1,1,3,2,4,2.511711738771238,0.3238528461420095
University of Wisconsin - Oshkosh,12410,7994,Wisconsin,Small City,NA,81.86,72.29,90.95,1,1,2,1,0,1,2,1,3,1.578793965307043,0.12795799794646207
University of Wisconsin - Parkside,4135,3275,Wisconsin,Suburb,NA,49.03,39.11,63.17,0,0,1,0,0,0,0,0,1,0.4872788650261423,0.1864830747612442
University of Wisconsin - Platteville,7614,6723,Wisconsin,Town,NA,77.65,63.75,94.66,1,1,2,1,0,1,2,1,3,0.7696212665936607,0.7281649971577546
University of Wisconsin - River Falls,5680,5014,Wisconsin,Town,NA,52.5,41.63,67.87,0,0,1,0,0,0,0,0,1,0.34969731567239093,0.39452596407056195
University of Wisconsin - Stevens Point,7896,7224,Wisconsin,Town,NA,68.82,57.16,82.52,1,1,1,0,0,1,1,1,2,0.9470153136256798,0.21804523180143723
University of Wisconsin - Stout,8129,6605,Wisconsin,Town,public,67.46,55.6,81.82,1,1,1,0,0,1,1,1,2,0.6779872555440084,0.44445871420062094
University of Wisconsin - Superior,2373,1829,Wisconsin,Suburb,NA,31.02,21.6,47.9,0,0,0,0,0,0,0,0,0,0.17347806365382887,0.19780776608993889
University of Wisconsin - Whitewater,11128,9830,Wisconsin,Town,NA,84.45,74.52,93.78,1,1,2,1,0,1,2,1,3,1.2665595572860056,0.5938665197928442
University of Wyoming,9796,8281,Wyoming,Town,NA,94.12,64.55,100.0,2,1,9,1,0,5,3,1,14,0.000646809820522609,2.827850887358468
Upper Iowa University,4275,2107,Iowa,Rural,private,92.26,72.65,99.75,2,1,4,1,0,2,3,1,6,0.7305248944019307,1.824784755267425
Ursinus College,1507,1489,Pennsylvania,Suburb,private,74.58,53.76,93.06,1,1,2,0,0,1,1,1,3,0.5796942549042343,0.7888023822367808
Ursuline College,620,455,Ohio,Suburb,private,19.44,10.49,35.58,0,0,0,0,0,0,0,0,0,0.17855807982160277,0.03755655477952409
Utah State University,24621,17188,Utah,Small City,public,100.0,99.58,100.0,17,4,60,8,2,31,25,6,91,18.48658344863224,7.05591322606297
Utah Valley University,36870,18404,Utah,Small City,NA,100.0,99.98,100.0,26,6,86,12,3,44,38,9,130,32.04321664362775,6.308066125065918
Utica College,3686,2901,New York,Small City,NA,93.67,80.57,99.36,2,1,3,1,1,2,3,2,5,2.201068228984498,0.557077225757372
Valdosta State University,8774,7166,Georgia,Small City,NA,96.18,67.97,100.0,2,1,8,1,0,4,3,1,12,2.657443880926522,0.6059583474280411
Valley City State University,1373,834,North Dakota,Town,NA,79.44,37.17,99.1,1,0,3,1,0,2,2,0,5,1.2258209050615823,0.35474769857366106
University of Valley Forge,700,589,Pennsylvania,Suburb,NA,46.68,27.61,71.45,0,0,1,0,0,0,0,0,1,0.20590625143256835,0.42252961166502695
Valparaiso University,3228,3153,IndiaNA,Suburb,NA,82.06,64.65,96.22,1,1,2,1,0,1,2,1,3,0.539309440005736,1.177268537695418
Vanderbilt University,6888,6805,Tennessee,Large City,NA,99.97,97.88,100.0,5,3,12,3,1,6,8,4,18,0.23257152580371884,7.9734370211859735
Vanguard University of Southern California,1842,1524,California,Midsize City,NA,98.51,89.79,99.99,3,2,6,1,1,3,4,3,9,3.566193590374548,0.6334787115116542
Vassar College,2352,2334,New York,Suburb,private,92.78,75.33,99.67,2,1,4,1,0,2,3,1,6,0.44284877902747627,2.1829999363007846
Villanova University,6948,6525,Pennsylvania,Suburb,NA,99.9,97.64,100.0,5,3,9,2,1,5,7,4,14,0.7805784026433253,6.1518396071125565
Virginia Commonwealth University,23666,20036,Virginia,Midsize City,NA,100.0,100.0,100.0,22,7,46,11,3,24,33,10,70,31.161638194669287,1.8377447652553065
Virginia Military Institute,1724,1722,Virginia,Town,public,90.17,57.81,99.35,2,1,3,1,0,2,3,1,5,1.4978637391396734,0.8195407735484616
Virginia Tech,27189,26603,Virginia,Small City,public,100.0,100.0,100.0,23,8,49,12,4,26,35,12,75,27.554331216721906,7.350500950071602
Virginia State University,4299,3976,Virginia,Suburb,public,99.47,85.26,100.0,3,1,7,2,1,4,5,2,11,3.8603245014507026,1.3675194001535818
Virginia Union University,1298,1201,Virginia,Midsize City,NA,76.61,44.74,95.07,1,0,2,0,0,1,1,0,3,0.8631512087513369,0.5885966170421596
Virginia Wesleyan University,1438,1354,Virginia,Large City,NA,83.94,46.69,97.98,1,0,3,1,0,1,2,0,4,1.5079844400798064,0.31953953751534986
Viterbo University,1770,1394,Wisconsin,Small City,NA,32.44,20.18,55.77,0,0,1,0,0,0,0,0,1,0.15428974510069657,0.2375637669146411
Voorhees College,475,464,South CaroliNA,Town,private,44.16,19.22,75.29,0,0,1,0,0,0,0,0,1,0.47041216239858336,0.11172989956495628
Wabash College,865,864,IndiaNA,Town,NA,44.35,28.98,68.13,0,0,1,0,0,0,0,0,1,0.2604320015662878,0.32500557250320844
Wagner College,1797,1736,New York,Large City,NA,82.41,61.01,97.71,1,1,2,1,0,1,2,1,3,0.6163283833737769,1.119953978055341
Wake Forest University,5099,5046,North CaroliNA,Midsize City,NA,99.74,94.65,100.0,4,2,9,2,1,4,6,3,13,0.2912281928956495,5.664907287603889
Walden University,7443,453,Minnesota,Large City,NA,100.0,99.27,100.0,7,3,18,4,2,9,11,5,27,0.006266814000609408,11.000749220060548
Waldorf University,2124,1482,Iowa,Town,private,97.73,84.89,99.98,3,1,6,1,1,3,4,2,9,0.1354343905351894,3.6439291995659437
Walla Walla University,1650,1556,Washington,Suburb,NA,86.82,65.83,99.48,1,1,3,1,0,2,2,1,5,0.7213987670405081,1.3035103288841672
Walsh University,2012,1744,Ohio,Suburb,private,51.58,31.33,77.41,0,0,1,0,0,0,0,0,1,0.6072229955268916,0.117726736035169
Warner Pacific College,404,396,Oregon,Large City,NA,26.38,14.09,60.39,0,0,1,0,0,0,0,0,1,0.1294663072965239,0.17660238264296615
Warner University,1003,869,Florida,Rural,NA,98.68,90.65,99.99,3,2,6,1,1,3,4,3,9,4.264728710238604,0.04910554454719833
Warren Wilson College,589,579,North CaroliNA,Suburb,private,43.42,23.18,77.37,0,0,1,0,0,1,0,0,2,0.02677379743880212,0.5419713165708023
Wartburg College,1525,1474,Iowa,Town,NA,43.77,22.53,78.81,0,0,1,0,0,1,0,0,2,0.3676564894579005,0.20776600519320748
Washburn University,5877,3944,Kansas,Midsize City,NA,38.22,15.67,68.25,0,0,1,0,0,0,0,0,1,0.2761416062354412,0.20522036869113514
Washington Adventist University,875,655,Maryland,Suburb,NA,59.04,38.0,83.59,1,0,1,0,0,1,1,0,2,0.29794873315251286,0.5937476055687637
Washington & Jefferson College,1411,1398,Pennsylvania,Suburb,NA,66.5,47.9,87.31,1,0,1,0,0,1,1,0,2,0.7124212810889908,0.3804766834127676
Washington and Lee University,1824,1823,Virginia,Town,private,89.52,64.17,99.33,2,1,3,1,0,2,3,1,5,0.3961531510852032,1.8567080321635852
Washington College,1489,1456,Maryland,Town,NA,68.51,47.36,89.13,1,0,1,0,0,1,1,0,2,0.5244936304732688,0.6302614008875024
Washington State University,25279,22166,Washington,Town,NA,100.0,100.0,100.0,17,10,32,9,5,17,26,15,49,23.287971465589358,2.9826051968458316
Washington University in St Louis,7673,7074,Missouri,Suburb,NA,99.99,99.16,100.0,6,3,15,3,2,8,9,5,23,0.15550256374600607,9.51091140815052
Wayland Baptist University,3563,990,Texas,Town,NA,100.0,99.91,100.0,12,5,30,6,2,16,18,7,46,17.793135970047704,0.27666381544456314
Wayne State College,2756,2404,Nebraska,Town,public,31.11,20.3,52.88,0,0,1,0,0,0,0,0,1,0.19553993974508002,0.1768925851456918
Wayne State University,17300,12389,Michigan,Large City,public,100.0,99.88,100.0,8,5,16,4,2,8,12,7,24,11.787223392787588,0.1937420849921648
Waynesburg University,1374,1330,Pennsylvania,Town,private,62.1,45.66,82.13,1,0,1,0,0,1,1,0,2,0.8221901189607085,0.1476498090730154
Webber InterNAtioNAl University,626,584,Florida,Town,NA,94.04,78.73,99.73,2,1,4,1,1,2,3,2,6,2.7902710817534846,0.024041159763845216
Weber State University,27106,11311,Utah,Small City,NA,100.0,99.64,100.0,19,4,63,9,2,32,28,6,95,23.965495586385668,3.4664222470770354
Webster University,3080,2297,Missouri,Suburb,private,88.05,62.26,99.65,1,1,4,1,0,2,2,1,6,0.4933936485212062,1.6275048535617145
Wellesley College,2513,2374,Massachusetts,Suburb,private,94.81,78.89,99.85,2,1,4,1,1,2,3,2,6,0.3938211908049354,2.5611985399287733
Wells College,486,481,New York,Rural,NA,34.07,20.8,55.68,0,0,1,0,0,0,0,0,1,0.2481417125459743,0.16818003810762847
Wentworth Institute of Technology,4263,3904,Massachusetts,Large City,private,98.63,88.67,99.99,3,1,6,1,1,3,4,2,9,3.6050779171389498,0.6842874601111884
Wesley College,1447,1303,Delaware,Small City,private,66.23,45.57,87.72,1,0,1,0,0,1,1,0,2,0.12356715453114413,0.9615207295627975
Wesleyan College,565,431,Georgia,Midsize City,NA,35.5,17.76,69.4,0,0,1,0,0,0,0,0,1,0.13161795238244633,0.30616668662232127
Wesleyan University,2975,2896,Connecticut,Small City,private,96.79,83.75,99.92,2,1,5,1,1,2,3,2,7,0.05863863095013068,3.376497676322181
West Chester University of Pennsylvania,14450,13020,Pennsylvania,Suburb,NA,100.0,99.89,100.0,7,5,14,4,2,7,11,7,21,8.658106767554825,2.476892719296135
West Liberty University,2174,1869,West Virginia,Rural,NA,30.82,17.08,52.58,0,0,1,0,0,0,0,0,1,0.03355602941920236,0.33469214128428054
West Texas A&M University,7393,5615,Texas,Town,public,100.0,100.0,100.0,25,10,64,13,5,35,38,15,99,37.67958205421866,0.4136846960013836
West Virginia State University,3754,1786,West Virginia,Suburb,NA,56.65,34.5,82.95,1,0,1,0,0,1,1,0,2,0.06831360937099334,0.7664129443174077
West Virginia University,22507,20712,West Virginia,Small City,public,100.0,99.65,100.0,8,4,16,4,2,8,12,6,24,0.2244496394875554,11.147838852612017
West Virginia University Institute of Technology,1621,1111,West Virginia,Small City,public,21.84,10.94,41.22,0,0,0,0,0,0,0,0,0,0.03200493691349705,0.21411255234052362
West Virginia Wesleyan College,1322,1289,West Virginia,Town,private,36.64,21.32,59.74,0,0,1,0,0,0,0,0,1,0.018372799961946084,0.4375395856703112
Western CaroliNA University,9408,8040,North CaroliNA,Town,NA,95.86,80.0,99.89,2,1,5,1,1,2,3,2,7,2.1974720539394195,0.9847779962858728
Western Connecticut State University,5082,4089,Connecticut,Small City,NA,80.47,70.87,91.04,1,1,2,1,0,1,2,1,3,1.2711430326058701,0.3615209566165056
Western Governors University,72383,72385,Utah,Suburb,NA,100.0,100.0,100.0,71,31,171,36,15,89,107,46,260,6.431808741565937,100.26865032261067
Western Illinois University,7596,6668,Illinois,Town,NA,93.5,86.37,98.82,2,1,3,1,1,1,3,2,4,2.5742802553321096,0.15776073952823993
Western InterNAtioNAl University,593,597,ArizoNA,Midsize City,NA,61.9,38.54,87.98,1,0,1,0,0,1,1,0,2,0.2896244065489806,0.673807995701553
Western Kentucky University,17655,12919,Kentucky,Small City,NA,99.99,98.17,100.0,6,3,16,3,1,7,9,4,23,7.64429440962088,1.844188182302841
Western Michigan University,17938,15063,Michigan,Small City,NA,100.0,99.91,100.0,8,5,17,4,2,8,12,7,25,11.00628362451909,1.2468885255659665
Western New England University,2737,2613,Massachusetts,Midsize City,private,89.6,71.1,98.72,2,1,3,1,0,1,3,1,4,1.4577840144877774,0.8040278930736382
Western New Mexico University,2170,1266,New Mexico,Town,public,88.87,56.0,99.85,1,1,4,1,0,2,2,1,6,1.2132187532403635,0.9800378762860728
Western Oregon University,4758,4065,Oregon,Town,public,93.8,78.39,99.58,2,1,4,1,1,2,3,2,6,2.173998232123229,0.6052447395745975
Western Colorado University,2427,1832,Colorado,Town,NA,77.75,46.75,98.93,1,0,3,1,0,2,2,0,5,0.40054366282966675,1.1001544591138261
Western Washington University,14961,13728,Washington,Small City,NA,100.0,99.98,100.0,10,6,22,5,3,12,15,9,34,13.72994582960336,1.658572543739722
Westfield State University,5585,4800,Massachusetts,Suburb,NA,99.9,97.03,100.0,5,2,9,2,1,5,7,3,14,6.742735273388107,0.12756917873019424
Westminster College Missouri,765,760,Missouri,Town,NA,35.3,18.45,63.78,0,0,1,0,0,0,0,0,1,0.14024296636906156,0.2944444403381256
Westminster College Pennsylvania,1193,1170,Pennsylvania,Town,private,54.69,37.98,76.86,1,0,1,0,0,0,1,0,1,0.5926082358303187,0.19856747948972756
Westminster College Utah,2033,1906,Utah,Midsize City,NA,90.78,51.46,99.97,2,0,5,1,0,3,3,0,8,1.1212838484085894,1.2599425559739854
Westmont College,1295,1294,California,Suburb,private,92.93,76.03,99.76,2,1,4,1,0,2,3,1,6,2.148223971935364,0.49718567590226986
Wheaton College Illinois,2386,2310,Illinois,Suburb,private,89.72,69.49,99.2,2,1,3,1,0,2,3,1,5,0.183701538209673,2.088263477390105
Wheaton College Massachusetts,1686,1675,Massachusetts,Suburb,private,78.1,54.41,96.51,1,1,2,1,0,1,2,1,3,0.7850599475718056,0.7324713498490235
Wheeling Jesuit University,721,670,West Virginia,Small City,NA,23.8,13.56,42.03,0,0,0,0,0,0,0,0,0,0.004959126743593057,0.2666839048051328
Boston University Wheelock College of Education and Human Development,613,593,Massachusetts,Large City,NA,46.04,27.44,70.65,0,0,1,0,0,0,0,0,1,0.4803327310801179,0.13621331443408433
Whitman College,1512,1455,Washington,Small City,NA,84.01,62.15,98.19,1,1,3,1,0,1,2,1,4,0.5730547952265445,1.2585304449328518
Whittier College,1684,1640,California,Suburb,NA,96.97,85.56,99.92,2,1,5,1,1,2,3,2,7,2.9777361987222863,0.514759013264867
Whitworth University,2252,2211,Washington,Suburb,private,93.22,72.71,99.99,2,1,6,1,0,3,3,1,9,1.3391599647315346,1.3494712046284996
Wichita State University,12403,8749,Kansas,Large City,NA,73.83,36.95,98.3,1,0,3,0,0,1,1,0,4,0.5851915371023607,0.7538598645612845
Widener University,3438,2919,Pennsylvania,Suburb,private,94.37,80.77,99.59,2,1,4,1,1,2,3,2,6,1.3566854406236473,1.5184997534599218
Wilberforce University,613,489,Ohio,Rural,private,35.74,21.21,60.22,0,0,1,0,0,0,0,0,1,0.059623963385069464,0.38230935508706704
Wiley College,1325,1188,Texas,Town,NA,99.48,87.73,100.0,3,1,9,2,1,5,5,2,14,4.676543871977494,0.5673143462429312
Wilkes University,2489,2233,Pennsylvania,Small City,NA,85.98,69.64,97.26,1,1,2,1,0,1,2,1,3,1.3609901009323422,0.602515541606363
Willamette University,1950,1901,Oregon,Midsize City,private,90.81,71.9,99.62,2,1,4,1,0,2,3,1,6,0.2812008194480499,2.103871872668292
William Carey University,3099,1676,Mississippi,Small City,private,99.58,90.52,100.0,4,2,8,2,1,4,6,3,12,4.852143634562311,0.6191767347728272
William Jewell College,922,909,Missouri,Suburb,NA,32.45,15.48,62.32,0,0,1,0,0,0,0,0,1,0.1329764914276594,0.258714718010227
William Paterson University of New Jersey,8839,7285,New Jersey,Suburb,NA,99.99,99.2,100.0,7,3,14,3,2,7,10,5,21,9.71979516665016,0.17309584476555184
William Penn University,1284,1068,Iowa,Town,NA,69.87,40.54,96.64,1,0,2,0,0,1,1,0,3,0.20520362202301423,0.9924266616126476
William Woods University,959,794,Missouri,Town,NA,34.45,20.81,58.59,0,0,1,0,0,0,0,0,1,0.15211154210668507,0.27005039150175486
Williams Baptist College,492,447,Arkansas,Rural,NA,15.57,5.29,36.39,0,0,0,0,0,0,0,0,0,0.059115054424435626,0.1098544913110436
Williams College,2073,2047,Massachusetts,Town,private,92.14,73.44,99.71,2,1,4,1,0,2,3,1,6,0.3641231993671862,2.175837020282674
Wilmington College,1168,1098,Ohio,Town,NA,35.5,20.64,59.03,0,0,1,0,0,0,0,0,1,0.3326389536219665,0.10559049348704241
Wilmington University,8441,3035,Delaware,Suburb,private,96.26,88.96,99.54,2,1,4,1,1,2,3,2,6,2.078886846302136,1.207299808489251
Wilson College,827,565,Pennsylvania,Small City,NA,45.36,30.58,66.5,0,0,1,0,0,0,0,0,1,0.416834606558614,0.18734211606052784
Wingate University,2588,2537,North CaroliNA,Suburb,NA,70.15,45.7,92.2,1,0,2,0,0,1,1,0,3,0.5506309284583832,0.6572958770319649
WinoNA State University,7463,6522,Minnesota,Town,public,64.92,52.3,81.26,1,0,1,0,0,1,1,0,2,0.5237917083782081,0.5237038697149736
Winston - Salem State University,4688,4072,North CaroliNA,Midsize City,NA,80.93,54.96,96.95,1,1,2,1,0,1,2,1,3,1.0474616790444566,0.6091618459508784
Winthrop University,5014,4488,South CaroliNA,Small City,public,99.94,92.3,100.0,5,2,12,2,1,6,7,3,18,7.11170649449137,0.3384039815781847
Wisconsin Lutheran College,992,921,Wisconsin,Large City,NA,36.68,24.43,57.6,0,0,1,0,0,0,0,0,1,0.09920491224748679,0.35710737766658773
Wittenberg University,1860,1775,Ohio,Small City,NA,57.35,35.5,87.53,1,0,1,0,0,1,1,0,2,0.4223887090331763,0.42929462739101365
Wofford College,1679,1663,South CaroliNA,Small City,private,87.96,54.12,99.33,1,1,3,1,0,2,2,1,5,1.5438772936425638,0.5711903709952302
Woodbury University,1023,923,California,Large City,private,89.75,72.98,98.85,2,1,3,1,0,1,3,1,4,2.2191224528573232,0.05637589315053777
Worcester Polytechnic Institute,4435,4301,Massachusetts,Midsize City,NA,98.88,89.85,99.99,3,2,6,1,1,3,4,3,9,2.687022616606789,1.7988002488704888
Worcester State University,5496,4153,Massachusetts,Midsize City,NA,99.9,97.09,100.0,5,2,9,2,1,5,7,3,14,6.822790728568127,0.12464301843555961
Wright State University - Main Campus,12120,9423,Ohio,Suburb,public,98.22,87.43,99.97,3,1,6,1,1,3,4,2,9,3.691037143869406,0.33837620344642233
Xavier University,4629,4370,Ohio,Large City,private,91.76,72.76,99.46,2,1,3,1,0,2,3,1,5,0.7707181793354243,1.7234934618188473
Xavier University of LouisiaNA,2289,2155,LouisiaNA,Large City,NA,96.41,76.68,99.97,2,1,5,1,0,3,3,1,8,1.088251916088218,2.2338320565320875
Yale University,5751,5743,Connecticut,Midsize City,NA,99.95,98.07,100.0,5,3,11,3,1,6,8,4,17,0.11234504060539055,7.5765376593443285
Yeshiva University,2755,2646,New York,Large City,NA,95.39,81.31,99.8,2,1,4,1,1,2,3,2,6,0.8344588563492942,2.2401102998423763
York College,431,398,Nebraska,Town,NA,28.95,12.51,74.74,0,0,1,0,0,0,0,0,1,0.011155234264084763,0.32986046649770095
York College of Pennsylvania,4169,3814,Pennsylvania,Suburb,NA,95.7,84.71,99.7,2,1,4,1,1,2,3,2,6,1.4334518827953713,1.7118040201788471
Youngstown State University,11272,8834,Ohio,Small City,NA,98.41,88.97,99.98,3,1,6,1,1,3,4,2,9,3.1707396107512733,0.9674580693419463
